DIA,MES,ANO,HORA,ES10,ES53,ESSUMA,FECHAH,FECHA,TIPO
1,11,2018,1,304,387,691,2018-11-01 00:00:00,2018-01-11 00:00:00,FESTIVO
1,11,2018,2,297,383,680,2018-11-01 01:00:00,2018-01-11 00:00:00,FESTIVO
1,11,2018,3,165,340,505,2018-11-01 02:00:00,2018-01-11 00:00:00,FESTIVO
1,11,2018,4,145,269,414,2018-11-01 03:00:00,2018-01-11 00:00:00,FESTIVO
1,11,2018,5,144,297,441,2018-11-01 04:00:00,2018-01-11 00:00:00,FESTIVO
1,11,2018,6,164,235,399,2018-11-01 05:00:00,2018-01-11 00:00:00,FESTIVO
1,11,2018,7,189,291,480,2018-11-01 06:00:00,2018-01-11 00:00:00,FESTIVO
1,11,2018,8,258,292,550,2018-11-01 07:00:00,2018-01-11 00:00:00,FESTIVO
1,11,2018,9,328,374,702,2018-11-01 08:00:00,2018-01-11 00:00:00,FESTIVO
1,11,2018,10,417,494,911,2018-11-01 09:00:00,2018-01-11 00:00:00,FESTIVO
1,11,2018,11,539,551,1090,2018-11-01 10:00:00,2018-01-11 00:00:00,FESTIVO
1,11,2018,12,614,613,1227,2018-11-01 11:00:00,2018-01-11 00:00:00,FESTIVO
1,11,2018,13,614,708,1322,2018-11-01 12:00:00,2018-01-11 00:00:00,FESTIVO
1,11,2018,14,579,631,1210,2018-11-01 13:00:00,2018-01-11 00:00:00,FESTIVO
1,11,2018,15,511,709,1220,2018-11-01 14:00:00,2018-01-11 00:00:00,FESTIVO
1,11,2018,16,437,595,1032,2018-11-01 15:00:00,2018-01-11 00:00:00,FESTIVO
1,11,2018,17,501,615,1116,2018-11-01 16:00:00,2018-01-11 00:00:00,FESTIVO
1,11,2018,18,535,733,1268,2018-11-01 17:00:00,2018-01-11 00:00:00,FESTIVO
1,11,2018,19,602,733,1335,2018-11-01 18:00:00,2018-01-11 00:00:00,FESTIVO
1,11,2018,20,573,685,1258,2018-11-01 19:00:00,2018-01-11 00:00:00,FESTIVO
1,11,2018,21,534,592,1126,2018-11-01 20:00:00,2018-01-11 00:00:00,FESTIVO
1,11,2018,22,500,581,1081,2018-11-01 21:00:00,2018-01-11 00:00:00,FESTIVO
1,11,2018,23,444,499,943,2018-11-01 22:00:00,2018-01-11 00:00:00,FESTIVO
1,11,2018,24,303,408,711,2018-11-01 23:00:00,2018-01-11 00:00:00,FESTIVO
2,11,2018,1,217,273,490,2018-11-02 00:00:00,2018-02-11 00:00:00,LABORABLE
2,11,2018,2,124,239,363,2018-11-02 01:00:00,2018-02-11 00:00:00,LABORABLE
2,11,2018,3,91,183,274,2018-11-02 02:00:00,2018-02-11 00:00:00,LABORABLE
2,11,2018,4,73,146,219,2018-11-02 03:00:00,2018-02-11 00:00:00,LABORABLE
2,11,2018,5,83,141,224,2018-11-02 04:00:00,2018-02-11 00:00:00,LABORABLE
2,11,2018,6,140,183,323,2018-11-02 05:00:00,2018-02-11 00:00:00,LABORABLE
2,11,2018,7,330,330,660,2018-11-02 06:00:00,2018-02-11 00:00:00,LABORABLE
2,11,2018,8,506,537,1043,2018-11-02 07:00:00,2018-02-11 00:00:00,LABORABLE
2,11,2018,9,521,584,1105,2018-11-02 08:00:00,2018-02-11 00:00:00,LABORABLE
2,11,2018,10,529,661,1190,2018-11-02 09:00:00,2018-02-11 00:00:00,LABORABLE
2,11,2018,11,588,651,1239,2018-11-02 10:00:00,2018-02-11 00:00:00,LABORABLE
2,11,2018,12,545,564,1109,2018-11-02 11:00:00,2018-02-11 00:00:00,LABORABLE
2,11,2018,13,635,771,1406,2018-11-02 12:00:00,2018-02-11 00:00:00,LABORABLE
2,11,2018,14,696,742,1438,2018-11-02 13:00:00,2018-02-11 00:00:00,LABORABLE
2,11,2018,15,634,748,1382,2018-11-02 14:00:00,2018-02-11 00:00:00,LABORABLE
2,11,2018,16,587,801,1388,2018-11-02 15:00:00,2018-02-11 00:00:00,LABORABLE
2,11,2018,17,649,803,1452,2018-11-02 16:00:00,2018-02-11 00:00:00,LABORABLE
2,11,2018,18,653,811,1464,2018-11-02 17:00:00,2018-02-11 00:00:00,LABORABLE
2,11,2018,19,666,772,1438,2018-11-02 18:00:00,2018-02-11 00:00:00,LABORABLE
2,11,2018,20,661,787,1448,2018-11-02 19:00:00,2018-02-11 00:00:00,LABORABLE
2,11,2018,21,689,838,1527,2018-11-02 20:00:00,2018-02-11 00:00:00,LABORABLE
2,11,2018,22,541,724,1265,2018-11-02 21:00:00,2018-02-11 00:00:00,LABORABLE
2,11,2018,23,481,587,1068,2018-11-02 22:00:00,2018-02-11 00:00:00,LABORABLE
2,11,2018,24,346,526,872,2018-11-02 23:00:00,2018-02-11 00:00:00,LABORABLE
3,11,2018,1,283,430,713,2018-11-03 00:00:00,2018-03-11 00:00:00,SÁBADO
3,11,2018,2,227,340,567,2018-11-03 01:00:00,2018-03-11 00:00:00,SÁBADO
3,11,2018,3,167,320,487,2018-11-03 02:00:00,2018-03-11 00:00:00,SÁBADO
3,11,2018,4,136,220,356,2018-11-03 03:00:00,2018-03-11 00:00:00,SÁBADO
3,11,2018,5,119,218,337,2018-11-03 04:00:00,2018-03-11 00:00:00,SÁBADO
3,11,2018,6,130,215,345,2018-11-03 05:00:00,2018-03-11 00:00:00,SÁBADO
3,11,2018,7,212,259,471,2018-11-03 06:00:00,2018-03-11 00:00:00,SÁBADO
3,11,2018,8,265,316,581,2018-11-03 07:00:00,2018-03-11 00:00:00,SÁBADO
3,11,2018,9,346,363,709,2018-11-03 08:00:00,2018-03-11 00:00:00,SÁBADO
3,11,2018,10,463,481,944,2018-11-03 09:00:00,2018-03-11 00:00:00,SÁBADO
3,11,2018,11,534,622,1156,2018-11-03 10:00:00,2018-03-11 00:00:00,SÁBADO
3,11,2018,12,638,711,1349,2018-11-03 11:00:00,2018-03-11 00:00:00,SÁBADO
3,11,2018,13,603,816,1419,2018-11-03 12:00:00,2018-03-11 00:00:00,SÁBADO
3,11,2018,14,665,828,1493,2018-11-03 13:00:00,2018-03-11 00:00:00,SÁBADO
3,11,2018,15,629,832,1461,2018-11-03 14:00:00,2018-03-11 00:00:00,SÁBADO
3,11,2018,16,514,672,1186,2018-11-03 15:00:00,2018-03-11 00:00:00,SÁBADO
3,11,2018,17,523,706,1229,2018-11-03 16:00:00,2018-03-11 00:00:00,SÁBADO
3,11,2018,18,615,706,1321,2018-11-03 17:00:00,2018-03-11 00:00:00,SÁBADO
3,11,2018,19,659,798,1457,2018-11-03 18:00:00,2018-03-11 00:00:00,SÁBADO
3,11,2018,20,624,783,1407,2018-11-03 19:00:00,2018-03-11 00:00:00,SÁBADO
3,11,2018,21,576,725,1301,2018-11-03 20:00:00,2018-03-11 00:00:00,SÁBADO
3,11,2018,22,577,696,1273,2018-11-03 21:00:00,2018-03-11 00:00:00,SÁBADO
3,11,2018,23,518,614,1132,2018-11-03 22:00:00,2018-03-11 00:00:00,SÁBADO
3,11,2018,24,401,527,928,2018-11-03 23:00:00,2018-03-11 00:00:00,SÁBADO
4,11,2018,1,340,457,797,2018-11-04 00:00:00,2018-04-11 00:00:00,DOMINGO
4,11,2018,2,315,452,767,2018-11-04 01:00:00,2018-04-11 00:00:00,DOMINGO
4,11,2018,3,247,376,623,2018-11-04 02:00:00,2018-04-11 00:00:00,DOMINGO
4,11,2018,4,171,256,427,2018-11-04 03:00:00,2018-04-11 00:00:00,DOMINGO
4,11,2018,5,179,260,439,2018-11-04 04:00:00,2018-04-11 00:00:00,DOMINGO
4,11,2018,6,147,300,447,2018-11-04 05:00:00,2018-04-11 00:00:00,DOMINGO
4,11,2018,7,189,292,481,2018-11-04 06:00:00,2018-04-11 00:00:00,DOMINGO
4,11,2018,8,168,247,415,2018-11-04 07:00:00,2018-04-11 00:00:00,DOMINGO
4,11,2018,9,217,286,503,2018-11-04 08:00:00,2018-04-11 00:00:00,DOMINGO
4,11,2018,10,325,410,735,2018-11-04 09:00:00,2018-04-11 00:00:00,DOMINGO
4,11,2018,11,449,491,940,2018-11-04 10:00:00,2018-04-11 00:00:00,DOMINGO
4,11,2018,12,485,580,1065,2018-11-04 11:00:00,2018-04-11 00:00:00,DOMINGO
4,11,2018,13,592,650,1242,2018-11-04 12:00:00,2018-04-11 00:00:00,DOMINGO
4,11,2018,14,578,693,1271,2018-11-04 13:00:00,2018-04-11 00:00:00,DOMINGO
4,11,2018,15,572,670,1242,2018-11-04 14:00:00,2018-04-11 00:00:00,DOMINGO
4,11,2018,16,525,647,1172,2018-11-04 15:00:00,2018-04-11 00:00:00,DOMINGO
4,11,2018,17,471,655,1126,2018-11-04 16:00:00,2018-04-11 00:00:00,DOMINGO
4,11,2018,18,566,747,1313,2018-11-04 17:00:00,2018-04-11 00:00:00,DOMINGO
4,11,2018,19,627,719,1346,2018-11-04 18:00:00,2018-04-11 00:00:00,DOMINGO
4,11,2018,20,572,729,1301,2018-11-04 19:00:00,2018-04-11 00:00:00,DOMINGO
4,11,2018,21,480,626,1106,2018-11-04 20:00:00,2018-04-11 00:00:00,DOMINGO
4,11,2018,22,444,546,990,2018-11-04 21:00:00,2018-04-11 00:00:00,DOMINGO
4,11,2018,23,421,439,860,2018-11-04 22:00:00,2018-04-11 00:00:00,DOMINGO
4,11,2018,24,214,352,566,2018-11-04 23:00:00,2018-04-11 00:00:00,DOMINGO
5,11,2018,1,175,289,464,2018-11-05 00:00:00,2018-05-11 00:00:00,LABORABLE
5,11,2018,2,108,199,307,2018-11-05 01:00:00,2018-05-11 00:00:00,LABORABLE
5,11,2018,3,82,153,235,2018-11-05 02:00:00,2018-05-11 00:00:00,LABORABLE
5,11,2018,4,84,110,194,2018-11-05 03:00:00,2018-05-11 00:00:00,LABORABLE
5,11,2018,5,63,100,163,2018-11-05 04:00:00,2018-05-11 00:00:00,LABORABLE
5,11,2018,6,143,164,307,2018-11-05 05:00:00,2018-05-11 00:00:00,LABORABLE
5,11,2018,7,475,424,899,2018-11-05 06:00:00,2018-05-11 00:00:00,LABORABLE
5,11,2018,8,624,706,1330,2018-11-05 07:00:00,2018-05-11 00:00:00,LABORABLE
5,11,2018,9,645,719,1364,2018-11-05 08:00:00,2018-05-11 00:00:00,LABORABLE
5,11,2018,10,646,860,1506,2018-11-05 09:00:00,2018-05-11 00:00:00,LABORABLE
5,11,2018,11,580,675,1255,2018-11-05 10:00:00,2018-05-11 00:00:00,LABORABLE
5,11,2018,12,586,686,1272,2018-11-05 11:00:00,2018-05-11 00:00:00,LABORABLE
5,11,2018,13,599,637,1236,2018-11-05 12:00:00,2018-05-11 00:00:00,LABORABLE
5,11,2018,14,659,785,1444,2018-11-05 13:00:00,2018-05-11 00:00:00,LABORABLE
5,11,2018,15,661,752,1413,2018-11-05 14:00:00,2018-05-11 00:00:00,LABORABLE
5,11,2018,16,674,677,1351,2018-11-05 15:00:00,2018-05-11 00:00:00,LABORABLE
5,11,2018,18,717,0,717,2018-11-05 17:00:00,2018-05-11 00:00:00,LABORABLE
5,11,2018,19,686,0,686,2018-11-05 18:00:00,2018-05-11 00:00:00,LABORABLE
5,11,2018,20,584,0,584,2018-11-05 19:00:00,2018-05-11 00:00:00,LABORABLE
5,11,2018,21,651,0,651,2018-11-05 20:00:00,2018-05-11 00:00:00,LABORABLE
5,11,2018,22,463,623,1086,2018-11-05 21:00:00,2018-05-11 00:00:00,LABORABLE
5,11,2018,23,365,432,797,2018-11-05 22:00:00,2018-05-11 00:00:00,LABORABLE
5,11,2018,24,231,331,562,2018-11-05 23:00:00,2018-05-11 00:00:00,LABORABLE
6,11,2018,1,126,204,330,2018-11-06 00:00:00,2018-06-11 00:00:00,LABORABLE
6,11,2018,2,93,150,243,2018-11-06 01:00:00,2018-06-11 00:00:00,LABORABLE
6,11,2018,3,54,134,188,2018-11-06 02:00:00,2018-06-11 00:00:00,LABORABLE
6,11,2018,4,56,96,152,2018-11-06 03:00:00,2018-06-11 00:00:00,LABORABLE
6,11,2018,5,71,90,161,2018-11-06 04:00:00,2018-06-11 00:00:00,LABORABLE
6,11,2018,6,146,164,310,2018-11-06 05:00:00,2018-06-11 00:00:00,LABORABLE
6,11,2018,7,444,383,827,2018-11-06 06:00:00,2018-06-11 00:00:00,LABORABLE
6,11,2018,8,651,656,1307,2018-11-06 07:00:00,2018-06-11 00:00:00,LABORABLE
6,11,2018,9,719,779,1498,2018-11-06 08:00:00,2018-06-11 00:00:00,LABORABLE
6,11,2018,10,638,775,1413,2018-11-06 09:00:00,2018-06-11 00:00:00,LABORABLE
6,11,2018,11,595,664,1259,2018-11-06 10:00:00,2018-06-11 00:00:00,LABORABLE
6,11,2018,12,607,742,1349,2018-11-06 11:00:00,2018-06-11 00:00:00,LABORABLE
6,11,2018,13,624,748,1372,2018-11-06 12:00:00,2018-06-11 00:00:00,LABORABLE
6,11,2018,14,661,756,1417,2018-11-06 13:00:00,2018-06-11 00:00:00,LABORABLE
6,11,2018,15,673,721,1394,2018-11-06 14:00:00,2018-06-11 00:00:00,LABORABLE
6,11,2018,16,649,698,1347,2018-11-06 15:00:00,2018-06-11 00:00:00,LABORABLE
6,11,2018,17,640,785,1425,2018-11-06 16:00:00,2018-06-11 00:00:00,LABORABLE
6,11,2018,18,725,853,1578,2018-11-06 17:00:00,2018-06-11 00:00:00,LABORABLE
6,11,2018,19,696,783,1479,2018-11-06 18:00:00,2018-06-11 00:00:00,LABORABLE
6,11,2018,20,673,784,1457,2018-11-06 19:00:00,2018-06-11 00:00:00,LABORABLE
6,11,2018,21,618,723,1341,2018-11-06 20:00:00,2018-06-11 00:00:00,LABORABLE
6,11,2018,22,508,607,1115,2018-11-06 21:00:00,2018-06-11 00:00:00,LABORABLE
6,11,2018,23,374,428,802,2018-11-06 22:00:00,2018-06-11 00:00:00,LABORABLE
6,11,2018,24,232,347,579,2018-11-06 23:00:00,2018-06-11 00:00:00,LABORABLE
7,11,2018,1,169,258,427,2018-11-07 00:00:00,2018-07-11 00:00:00,LABORABLE
7,11,2018,2,121,189,310,2018-11-07 01:00:00,2018-07-11 00:00:00,LABORABLE
7,11,2018,3,68,117,185,2018-11-07 02:00:00,2018-07-11 00:00:00,LABORABLE
7,11,2018,4,69,116,185,2018-11-07 03:00:00,2018-07-11 00:00:00,LABORABLE
7,11,2018,5,78,84,162,2018-11-07 04:00:00,2018-07-11 00:00:00,LABORABLE
7,11,2018,6,155,167,322,2018-11-07 05:00:00,2018-07-11 00:00:00,LABORABLE
7,11,2018,7,435,399,834,2018-11-07 06:00:00,2018-07-11 00:00:00,LABORABLE
7,11,2018,8,610,700,1310,2018-11-07 07:00:00,2018-07-11 00:00:00,LABORABLE
7,11,2018,9,696,669,1365,2018-11-07 08:00:00,2018-07-11 00:00:00,LABORABLE
7,11,2018,10,601,732,1333,2018-11-07 09:00:00,2018-07-11 00:00:00,LABORABLE
7,11,2018,11,592,688,1280,2018-11-07 10:00:00,2018-07-11 00:00:00,LABORABLE
7,11,2018,12,563,703,1266,2018-11-07 11:00:00,2018-07-11 00:00:00,LABORABLE
7,11,2018,13,610,690,1300,2018-11-07 12:00:00,2018-07-11 00:00:00,LABORABLE
7,11,2018,14,624,748,1372,2018-11-07 13:00:00,2018-07-11 00:00:00,LABORABLE
7,11,2018,15,458,824,1282,2018-11-07 14:00:00,2018-07-11 00:00:00,LABORABLE
7,11,2018,16,661,702,1363,2018-11-07 15:00:00,2018-07-11 00:00:00,LABORABLE
7,11,2018,17,652,745,1397,2018-11-07 16:00:00,2018-07-11 00:00:00,LABORABLE
7,11,2018,18,667,758,1425,2018-11-07 17:00:00,2018-07-11 00:00:00,LABORABLE
7,11,2018,19,741,783,1524,2018-11-07 18:00:00,2018-07-11 00:00:00,LABORABLE
7,11,2018,20,659,807,1466,2018-11-07 19:00:00,2018-07-11 00:00:00,LABORABLE
7,11,2018,21,657,734,1391,2018-11-07 20:00:00,2018-07-11 00:00:00,LABORABLE
7,11,2018,22,508,566,1074,2018-11-07 21:00:00,2018-07-11 00:00:00,LABORABLE
7,11,2018,23,348,468,816,2018-11-07 22:00:00,2018-07-11 00:00:00,LABORABLE
7,11,2018,24,265,334,599,2018-11-07 23:00:00,2018-07-11 00:00:00,LABORABLE
8,11,2018,1,167,249,416,2018-11-08 00:00:00,2018-08-11 00:00:00,LABORABLE
8,11,2018,2,126,208,334,2018-11-08 01:00:00,2018-08-11 00:00:00,LABORABLE
8,11,2018,3,75,136,211,2018-11-08 02:00:00,2018-08-11 00:00:00,LABORABLE
8,11,2018,4,64,115,179,2018-11-08 03:00:00,2018-08-11 00:00:00,LABORABLE
8,11,2018,5,74,103,177,2018-11-08 04:00:00,2018-08-11 00:00:00,LABORABLE
8,11,2018,6,165,182,347,2018-11-08 05:00:00,2018-08-11 00:00:00,LABORABLE
8,11,2018,7,427,393,820,2018-11-08 06:00:00,2018-08-11 00:00:00,LABORABLE
8,11,2018,8,703,683,1386,2018-11-08 07:00:00,2018-08-11 00:00:00,LABORABLE
8,11,2018,9,697,764,1461,2018-11-08 08:00:00,2018-08-11 00:00:00,LABORABLE
8,11,2018,10,701,706,1407,2018-11-08 09:00:00,2018-08-11 00:00:00,LABORABLE
8,11,2018,11,669,760,1429,2018-11-08 10:00:00,2018-08-11 00:00:00,LABORABLE
8,11,2018,12,623,798,1421,2018-11-08 11:00:00,2018-08-11 00:00:00,LABORABLE
8,11,2018,13,673,801,1474,2018-11-08 12:00:00,2018-08-11 00:00:00,LABORABLE
8,11,2018,14,660,773,1433,2018-11-08 13:00:00,2018-08-11 00:00:00,LABORABLE
8,11,2018,15,699,752,1451,2018-11-08 14:00:00,2018-08-11 00:00:00,LABORABLE
8,11,2018,16,694,704,1398,2018-11-08 15:00:00,2018-08-11 00:00:00,LABORABLE
8,11,2018,17,665,778,1443,2018-11-08 16:00:00,2018-08-11 00:00:00,LABORABLE
8,11,2018,18,689,815,1504,2018-11-08 17:00:00,2018-08-11 00:00:00,LABORABLE
8,11,2018,19,717,805,1522,2018-11-08 18:00:00,2018-08-11 00:00:00,LABORABLE
8,11,2018,20,721,785,1506,2018-11-08 19:00:00,2018-08-11 00:00:00,LABORABLE
8,11,2018,21,681,751,1432,2018-11-08 20:00:00,2018-08-11 00:00:00,LABORABLE
8,11,2018,22,611,709,1320,2018-11-08 21:00:00,2018-08-11 00:00:00,LABORABLE
8,11,2018,23,448,552,1000,2018-11-08 22:00:00,2018-08-11 00:00:00,LABORABLE
8,11,2018,24,305,457,762,2018-11-08 23:00:00,2018-08-11 00:00:00,LABORABLE
9,11,2018,1,254,363,617,2018-11-09 00:00:00,2018-09-11 00:00:00,FESTIVO
9,11,2018,2,163,288,451,2018-11-09 01:00:00,2018-09-11 00:00:00,FESTIVO
9,11,2018,3,136,274,410,2018-11-09 02:00:00,2018-09-11 00:00:00,FESTIVO
9,11,2018,4,94,182,276,2018-11-09 03:00:00,2018-09-11 00:00:00,FESTIVO
9,11,2018,5,97,158,255,2018-11-09 04:00:00,2018-09-11 00:00:00,FESTIVO
9,11,2018,6,138,169,307,2018-11-09 05:00:00,2018-09-11 00:00:00,FESTIVO
9,11,2018,7,262,240,502,2018-11-09 06:00:00,2018-09-11 00:00:00,FESTIVO
9,11,2018,8,350,312,662,2018-11-09 07:00:00,2018-09-11 00:00:00,FESTIVO
9,11,2018,9,410,380,790,2018-11-09 08:00:00,2018-09-11 00:00:00,FESTIVO
9,11,2018,10,434,487,921,2018-11-09 09:00:00,2018-09-11 00:00:00,FESTIVO
9,11,2018,11,448,498,946,2018-11-09 10:00:00,2018-09-11 00:00:00,FESTIVO
9,11,2018,12,565,612,1177,2018-11-09 11:00:00,2018-09-11 00:00:00,FESTIVO
9,11,2018,13,538,653,1191,2018-11-09 12:00:00,2018-09-11 00:00:00,FESTIVO
9,11,2018,14,577,645,1222,2018-11-09 13:00:00,2018-09-11 00:00:00,FESTIVO
9,11,2018,15,504,695,1199,2018-11-09 14:00:00,2018-09-11 00:00:00,FESTIVO
9,11,2018,16,439,563,1002,2018-11-09 15:00:00,2018-09-11 00:00:00,FESTIVO
9,11,2018,17,464,658,1122,2018-11-09 16:00:00,2018-09-11 00:00:00,FESTIVO
9,11,2018,18,572,663,1235,2018-11-09 17:00:00,2018-09-11 00:00:00,FESTIVO
9,11,2018,19,647,726,1373,2018-11-09 18:00:00,2018-09-11 00:00:00,FESTIVO
9,11,2018,20,590,749,1339,2018-11-09 19:00:00,2018-09-11 00:00:00,FESTIVO
9,11,2018,21,526,683,1209,2018-11-09 20:00:00,2018-09-11 00:00:00,FESTIVO
9,11,2018,22,540,704,1244,2018-11-09 21:00:00,2018-09-11 00:00:00,FESTIVO
9,11,2018,23,443,536,979,2018-11-09 22:00:00,2018-09-11 00:00:00,FESTIVO
9,11,2018,24,368,439,807,2018-11-09 23:00:00,2018-09-11 00:00:00,FESTIVO
10,11,2018,1,270,409,679,2018-11-10 00:00:00,2018-10-11 00:00:00,SÁBADO
10,11,2018,2,249,342,591,2018-11-10 01:00:00,2018-10-11 00:00:00,SÁBADO
10,11,2018,3,168,267,435,2018-11-10 02:00:00,2018-10-11 00:00:00,SÁBADO
10,11,2018,4,145,249,394,2018-11-10 03:00:00,2018-10-11 00:00:00,SÁBADO
10,11,2018,5,130,202,332,2018-11-10 04:00:00,2018-10-11 00:00:00,SÁBADO
10,11,2018,6,132,196,328,2018-11-10 05:00:00,2018-10-11 00:00:00,SÁBADO
10,11,2018,7,203,296,499,2018-11-10 06:00:00,2018-10-11 00:00:00,SÁBADO
10,11,2018,8,265,301,566,2018-11-10 07:00:00,2018-10-11 00:00:00,SÁBADO
10,11,2018,9,325,356,681,2018-11-10 08:00:00,2018-10-11 00:00:00,SÁBADO
10,11,2018,10,411,473,884,2018-11-10 09:00:00,2018-10-11 00:00:00,SÁBADO
10,11,2018,11,558,606,1164,2018-11-10 10:00:00,2018-10-11 00:00:00,SÁBADO
10,11,2018,12,560,686,1246,2018-11-10 11:00:00,2018-10-11 00:00:00,SÁBADO
10,11,2018,13,685,776,1461,2018-11-10 12:00:00,2018-10-11 00:00:00,SÁBADO
10,11,2018,14,682,791,1473,2018-11-10 13:00:00,2018-10-11 00:00:00,SÁBADO
10,11,2018,15,630,806,1436,2018-11-10 14:00:00,2018-10-11 00:00:00,SÁBADO
10,11,2018,16,538,732,1270,2018-11-10 15:00:00,2018-10-11 00:00:00,SÁBADO
10,11,2018,17,516,694,1210,2018-11-10 16:00:00,2018-10-11 00:00:00,SÁBADO
10,11,2018,18,594,787,1381,2018-11-10 17:00:00,2018-10-11 00:00:00,SÁBADO
10,11,2018,19,622,776,1398,2018-11-10 18:00:00,2018-10-11 00:00:00,SÁBADO
10,11,2018,20,673,775,1448,2018-11-10 19:00:00,2018-10-11 00:00:00,SÁBADO
10,11,2018,21,577,707,1284,2018-11-10 20:00:00,2018-10-11 00:00:00,SÁBADO
10,11,2018,22,587,658,1245,2018-11-10 21:00:00,2018-10-11 00:00:00,SÁBADO
10,11,2018,23,516,601,1117,2018-11-10 22:00:00,2018-10-11 00:00:00,SÁBADO
10,11,2018,24,373,479,852,2018-11-10 23:00:00,2018-10-11 00:00:00,SÁBADO
11,11,2018,1,344,463,807,2018-11-11 00:00:00,2018-11-11 00:00:00,DOMINGO
11,11,2018,2,237,407,644,2018-11-11 01:00:00,2018-11-11 00:00:00,DOMINGO
11,11,2018,3,238,353,591,2018-11-11 02:00:00,2018-11-11 00:00:00,DOMINGO
11,11,2018,4,164,346,510,2018-11-11 03:00:00,2018-11-11 00:00:00,DOMINGO
11,11,2018,5,151,243,394,2018-11-11 04:00:00,2018-11-11 00:00:00,DOMINGO
11,11,2018,6,126,273,399,2018-11-11 05:00:00,2018-11-11 00:00:00,DOMINGO
11,11,2018,7,196,241,437,2018-11-11 06:00:00,2018-11-11 00:00:00,DOMINGO
11,11,2018,8,185,240,425,2018-11-11 07:00:00,2018-11-11 00:00:00,DOMINGO
11,11,2018,9,221,270,491,2018-11-11 08:00:00,2018-11-11 00:00:00,DOMINGO
11,11,2018,10,292,385,677,2018-11-11 09:00:00,2018-11-11 00:00:00,DOMINGO
11,11,2018,11,401,497,898,2018-11-11 10:00:00,2018-11-11 00:00:00,DOMINGO
11,11,2018,12,471,570,1041,2018-11-11 11:00:00,2018-11-11 00:00:00,DOMINGO
11,11,2018,13,557,604,1161,2018-11-11 12:00:00,2018-11-11 00:00:00,DOMINGO
11,11,2018,14,570,675,1245,2018-11-11 13:00:00,2018-11-11 00:00:00,DOMINGO
11,11,2018,15,528,782,1310,2018-11-11 14:00:00,2018-11-11 00:00:00,DOMINGO
11,11,2018,16,471,681,1152,2018-11-11 15:00:00,2018-11-11 00:00:00,DOMINGO
11,11,2018,17,493,665,1158,2018-11-11 16:00:00,2018-11-11 00:00:00,DOMINGO
11,11,2018,18,495,702,1197,2018-11-11 17:00:00,2018-11-11 00:00:00,DOMINGO
11,11,2018,19,604,633,1237,2018-11-11 18:00:00,2018-11-11 00:00:00,DOMINGO
11,11,2018,20,553,533,1086,2018-11-11 19:00:00,2018-11-11 00:00:00,DOMINGO
11,11,2018,21,488,613,1101,2018-11-11 20:00:00,2018-11-11 00:00:00,DOMINGO
11,11,2018,22,478,591,1069,2018-11-11 21:00:00,2018-11-11 00:00:00,DOMINGO
11,11,2018,23,376,451,827,2018-11-11 22:00:00,2018-11-11 00:00:00,DOMINGO
11,11,2018,24,240,381,621,2018-11-11 23:00:00,2018-11-11 00:00:00,DOMINGO
12,11,2018,1,171,238,409,2018-11-12 00:00:00,2018-12-11 00:00:00,LABORABLE
12,11,2018,2,108,202,310,2018-11-12 01:00:00,2018-12-11 00:00:00,LABORABLE
12,11,2018,3,76,157,233,2018-11-12 02:00:00,2018-12-11 00:00:00,LABORABLE
12,11,2018,4,66,102,168,2018-11-12 03:00:00,2018-12-11 00:00:00,LABORABLE
12,11,2018,5,75,108,183,2018-11-12 04:00:00,2018-12-11 00:00:00,LABORABLE
12,11,2018,6,143,172,315,2018-11-12 05:00:00,2018-12-11 00:00:00,LABORABLE
12,11,2018,7,427,449,876,2018-11-12 06:00:00,2018-12-11 00:00:00,LABORABLE
12,11,2018,8,656,692,1348,2018-11-12 07:00:00,2018-12-11 00:00:00,LABORABLE
12,11,2018,9,674,661,1335,2018-11-12 08:00:00,2018-12-11 00:00:00,LABORABLE
12,11,2018,10,641,741,1382,2018-11-12 09:00:00,2018-12-11 00:00:00,LABORABLE
12,11,2018,11,548,642,1190,2018-11-12 10:00:00,2018-12-11 00:00:00,LABORABLE
12,11,2018,12,514,600,1114,2018-11-12 11:00:00,2018-12-11 00:00:00,LABORABLE
12,11,2018,13,606,701,1307,2018-11-12 12:00:00,2018-12-11 00:00:00,LABORABLE
12,11,2018,14,601,728,1329,2018-11-12 13:00:00,2018-12-11 00:00:00,LABORABLE
12,11,2018,15,713,721,1434,2018-11-12 14:00:00,2018-12-11 00:00:00,LABORABLE
12,11,2018,16,634,686,1320,2018-11-12 15:00:00,2018-12-11 00:00:00,LABORABLE
12,11,2018,17,675,774,1449,2018-11-12 16:00:00,2018-12-11 00:00:00,LABORABLE
12,11,2018,18,679,799,1478,2018-11-12 17:00:00,2018-12-11 00:00:00,LABORABLE
12,11,2018,19,737,786,1523,2018-11-12 18:00:00,2018-12-11 00:00:00,LABORABLE
12,11,2018,20,671,752,1423,2018-11-12 19:00:00,2018-12-11 00:00:00,LABORABLE
12,11,2018,21,664,760,1424,2018-11-12 20:00:00,2018-12-11 00:00:00,LABORABLE
12,11,2018,22,457,589,1046,2018-11-12 21:00:00,2018-12-11 00:00:00,LABORABLE
12,11,2018,23,378,426,804,2018-11-12 22:00:00,2018-12-11 00:00:00,LABORABLE
12,11,2018,24,210,327,537,2018-11-12 23:00:00,2018-12-11 00:00:00,LABORABLE
13,11,2018,1,142,209,351,2018-11-13 00:00:00,2018-11-13 00:00:00,LABORABLE
13,11,2018,2,80,155,235,2018-11-13 01:00:00,2018-11-13 00:00:00,LABORABLE
13,11,2018,3,63,132,195,2018-11-13 02:00:00,2018-11-13 00:00:00,LABORABLE
13,11,2018,4,58,106,164,2018-11-13 03:00:00,2018-11-13 00:00:00,LABORABLE
13,11,2018,5,77,102,179,2018-11-13 04:00:00,2018-11-13 00:00:00,LABORABLE
13,11,2018,6,148,139,287,2018-11-13 05:00:00,2018-11-13 00:00:00,LABORABLE
13,11,2018,7,436,402,838,2018-11-13 06:00:00,2018-11-13 00:00:00,LABORABLE
13,11,2018,8,667,678,1345,2018-11-13 07:00:00,2018-11-13 00:00:00,LABORABLE
13,11,2018,9,713,666,1379,2018-11-13 08:00:00,2018-11-13 00:00:00,LABORABLE
13,11,2018,10,707,632,1339,2018-11-13 09:00:00,2018-11-13 00:00:00,LABORABLE
13,11,2018,11,525,754,1279,2018-11-13 10:00:00,2018-11-13 00:00:00,LABORABLE
13,11,2018,12,596,711,1307,2018-11-13 11:00:00,2018-11-13 00:00:00,LABORABLE
13,11,2018,13,552,731,1283,2018-11-13 12:00:00,2018-11-13 00:00:00,LABORABLE
13,11,2018,14,616,729,1345,2018-11-13 13:00:00,2018-11-13 00:00:00,LABORABLE
13,11,2018,15,641,755,1396,2018-11-13 14:00:00,2018-11-13 00:00:00,LABORABLE
13,11,2018,16,608,686,1294,2018-11-13 15:00:00,2018-11-13 00:00:00,LABORABLE
13,11,2018,17,597,783,1380,2018-11-13 16:00:00,2018-11-13 00:00:00,LABORABLE
13,11,2018,18,679,808,1487,2018-11-13 17:00:00,2018-11-13 00:00:00,LABORABLE
13,11,2018,19,736,796,1532,2018-11-13 18:00:00,2018-11-13 00:00:00,LABORABLE
13,11,2018,20,629,767,1396,2018-11-13 19:00:00,2018-11-13 00:00:00,LABORABLE
13,11,2018,21,625,727,1352,2018-11-13 20:00:00,2018-11-13 00:00:00,LABORABLE
13,11,2018,22,464,638,1102,2018-11-13 21:00:00,2018-11-13 00:00:00,LABORABLE
13,11,2018,23,406,497,903,2018-11-13 22:00:00,2018-11-13 00:00:00,LABORABLE
13,11,2018,24,234,383,617,2018-11-13 23:00:00,2018-11-13 00:00:00,LABORABLE
14,11,2018,1,115,191,306,2018-11-14 00:00:00,2018-11-14 00:00:00,LABORABLE
14,11,2018,2,102,192,294,2018-11-14 01:00:00,2018-11-14 00:00:00,LABORABLE
14,11,2018,3,70,135,205,2018-11-14 02:00:00,2018-11-14 00:00:00,LABORABLE
14,11,2018,4,56,106,162,2018-11-14 03:00:00,2018-11-14 00:00:00,LABORABLE
14,11,2018,5,62,101,163,2018-11-14 04:00:00,2018-11-14 00:00:00,LABORABLE
14,11,2018,6,120,135,255,2018-11-14 05:00:00,2018-11-14 00:00:00,LABORABLE
14,11,2018,7,312,397,709,2018-11-14 06:00:00,2018-11-14 00:00:00,LABORABLE
14,11,2018,8,541,664,1205,2018-11-14 07:00:00,2018-11-14 00:00:00,LABORABLE
14,11,2018,9,624,769,1393,2018-11-14 08:00:00,2018-11-14 00:00:00,LABORABLE
14,11,2018,10,642,828,1470,2018-11-14 09:00:00,2018-11-14 00:00:00,LABORABLE
14,11,2018,11,558,768,1326,2018-11-14 10:00:00,2018-11-14 00:00:00,LABORABLE
14,11,2018,12,511,824,1335,2018-11-14 11:00:00,2018-11-14 00:00:00,LABORABLE
14,11,2018,13,570,739,1309,2018-11-14 12:00:00,2018-11-14 00:00:00,LABORABLE
14,11,2018,14,667,782,1449,2018-11-14 13:00:00,2018-11-14 00:00:00,LABORABLE
14,11,2018,15,667,707,1374,2018-11-14 14:00:00,2018-11-14 00:00:00,LABORABLE
14,11,2018,16,678,725,1403,2018-11-14 15:00:00,2018-11-14 00:00:00,LABORABLE
14,11,2018,17,669,707,1376,2018-11-14 16:00:00,2018-11-14 00:00:00,LABORABLE
14,11,2018,18,698,733,1431,2018-11-14 17:00:00,2018-11-14 00:00:00,LABORABLE
14,11,2018,19,722,801,1523,2018-11-14 18:00:00,2018-11-14 00:00:00,LABORABLE
14,11,2018,20,641,786,1427,2018-11-14 19:00:00,2018-11-14 00:00:00,LABORABLE
14,11,2018,21,704,756,1460,2018-11-14 20:00:00,2018-11-14 00:00:00,LABORABLE
14,11,2018,22,493,604,1097,2018-11-14 21:00:00,2018-11-14 00:00:00,LABORABLE
14,11,2018,23,383,490,873,2018-11-14 22:00:00,2018-11-14 00:00:00,LABORABLE
14,11,2018,24,251,322,573,2018-11-14 23:00:00,2018-11-14 00:00:00,LABORABLE
15,11,2018,1,191,227,418,2018-11-15 00:00:00,2018-11-15 00:00:00,LABORABLE
15,11,2018,2,114,211,325,2018-11-15 01:00:00,2018-11-15 00:00:00,LABORABLE
15,11,2018,3,88,149,237,2018-11-15 02:00:00,2018-11-15 00:00:00,LABORABLE
15,11,2018,4,76,114,190,2018-11-15 03:00:00,2018-11-15 00:00:00,LABORABLE
15,11,2018,5,72,103,175,2018-11-15 04:00:00,2018-11-15 00:00:00,LABORABLE
15,11,2018,6,169,176,345,2018-11-15 05:00:00,2018-11-15 00:00:00,LABORABLE
15,11,2018,7,435,434,869,2018-11-15 06:00:00,2018-11-15 00:00:00,LABORABLE
15,11,2018,8,674,666,1340,2018-11-15 07:00:00,2018-11-15 00:00:00,LABORABLE
15,11,2018,9,698,785,1483,2018-11-15 08:00:00,2018-11-15 00:00:00,LABORABLE
15,11,2018,10,711,755,1466,2018-11-15 09:00:00,2018-11-15 00:00:00,LABORABLE
15,11,2018,11,408,797,1205,2018-11-15 10:00:00,2018-11-15 00:00:00,LABORABLE
15,11,2018,12,593,746,1339,2018-11-15 11:00:00,2018-11-15 00:00:00,LABORABLE
15,11,2018,13,629,957,1586,2018-11-15 12:00:00,2018-11-15 00:00:00,LABORABLE
15,11,2018,14,674,858,1532,2018-11-15 13:00:00,2018-11-15 00:00:00,LABORABLE
15,11,2018,15,648,791,1439,2018-11-15 14:00:00,2018-11-15 00:00:00,LABORABLE
15,11,2018,16,667,819,1486,2018-11-15 15:00:00,2018-11-15 00:00:00,LABORABLE
15,11,2018,17,665,728,1393,2018-11-15 16:00:00,2018-11-15 00:00:00,LABORABLE
15,11,2018,18,677,753,1430,2018-11-15 17:00:00,2018-11-15 00:00:00,LABORABLE
15,11,2018,19,750,720,1470,2018-11-15 18:00:00,2018-11-15 00:00:00,LABORABLE
15,11,2018,20,661,773,1434,2018-11-15 19:00:00,2018-11-15 00:00:00,LABORABLE
15,11,2018,21,669,739,1408,2018-11-15 20:00:00,2018-11-15 00:00:00,LABORABLE
15,11,2018,22,574,627,1201,2018-11-15 21:00:00,2018-11-15 00:00:00,LABORABLE
15,11,2018,23,422,514,936,2018-11-15 22:00:00,2018-11-15 00:00:00,LABORABLE
15,11,2018,24,286,335,621,2018-11-15 23:00:00,2018-11-15 00:00:00,LABORABLE
16,11,2018,1,241,274,515,2018-11-16 00:00:00,2018-11-16 00:00:00,LABORABLE
16,11,2018,2,143,211,354,2018-11-16 01:00:00,2018-11-16 00:00:00,LABORABLE
16,11,2018,3,89,170,259,2018-11-16 02:00:00,2018-11-16 00:00:00,LABORABLE
16,11,2018,4,76,109,185,2018-11-16 03:00:00,2018-11-16 00:00:00,LABORABLE
16,11,2018,5,90,114,204,2018-11-16 04:00:00,2018-11-16 00:00:00,LABORABLE
16,11,2018,6,167,199,366,2018-11-16 05:00:00,2018-11-16 00:00:00,LABORABLE
16,11,2018,7,446,460,906,2018-11-16 06:00:00,2018-11-16 00:00:00,LABORABLE
16,11,2018,8,673,643,1316,2018-11-16 07:00:00,2018-11-16 00:00:00,LABORABLE
16,11,2018,9,680,701,1381,2018-11-16 08:00:00,2018-11-16 00:00:00,LABORABLE
16,11,2018,10,618,716,1334,2018-11-16 09:00:00,2018-11-16 00:00:00,LABORABLE
16,11,2018,11,610,683,1293,2018-11-16 10:00:00,2018-11-16 00:00:00,LABORABLE
16,11,2018,12,587,737,1324,2018-11-16 11:00:00,2018-11-16 00:00:00,LABORABLE
16,11,2018,13,644,758,1402,2018-11-16 12:00:00,2018-11-16 00:00:00,LABORABLE
16,11,2018,14,670,708,1378,2018-11-16 13:00:00,2018-11-16 00:00:00,LABORABLE
16,11,2018,15,735,766,1501,2018-11-16 14:00:00,2018-11-16 00:00:00,LABORABLE
16,11,2018,16,665,716,1381,2018-11-16 15:00:00,2018-11-16 00:00:00,LABORABLE
16,11,2018,17,654,834,1488,2018-11-16 16:00:00,2018-11-16 00:00:00,LABORABLE
16,11,2018,18,728,837,1565,2018-11-16 17:00:00,2018-11-16 00:00:00,LABORABLE
16,11,2018,19,697,773,1470,2018-11-16 18:00:00,2018-11-16 00:00:00,LABORABLE
16,11,2018,20,702,815,1517,2018-11-16 19:00:00,2018-11-16 00:00:00,LABORABLE
16,11,2018,21,698,831,1529,2018-11-16 20:00:00,2018-11-16 00:00:00,LABORABLE
16,11,2018,22,621,762,1383,2018-11-16 21:00:00,2018-11-16 00:00:00,LABORABLE
16,11,2018,23,474,562,1036,2018-11-16 22:00:00,2018-11-16 00:00:00,LABORABLE
16,11,2018,24,355,497,852,2018-11-16 23:00:00,2018-11-16 00:00:00,LABORABLE
17,11,2018,1,286,417,703,2018-11-17 00:00:00,2018-11-17 00:00:00,SÁBADO
17,11,2018,2,249,371,620,2018-11-17 01:00:00,2018-11-17 00:00:00,SÁBADO
17,11,2018,3,207,313,520,2018-11-17 02:00:00,2018-11-17 00:00:00,SÁBADO
17,11,2018,4,158,262,420,2018-11-17 03:00:00,2018-11-17 00:00:00,SÁBADO
17,11,2018,5,131,224,355,2018-11-17 04:00:00,2018-11-17 00:00:00,SÁBADO
17,11,2018,6,136,217,353,2018-11-17 05:00:00,2018-11-17 00:00:00,SÁBADO
17,11,2018,7,234,250,484,2018-11-17 06:00:00,2018-11-17 00:00:00,SÁBADO
17,11,2018,8,300,296,596,2018-11-17 07:00:00,2018-11-17 00:00:00,SÁBADO
17,11,2018,9,356,391,747,2018-11-17 08:00:00,2018-11-17 00:00:00,SÁBADO
17,11,2018,10,471,537,1008,2018-11-17 09:00:00,2018-11-17 00:00:00,SÁBADO
17,11,2018,11,569,682,1251,2018-11-17 10:00:00,2018-11-17 00:00:00,SÁBADO
17,11,2018,12,633,705,1338,2018-11-17 11:00:00,2018-11-17 00:00:00,SÁBADO
17,11,2018,13,663,747,1410,2018-11-17 12:00:00,2018-11-17 00:00:00,SÁBADO
17,11,2018,14,692,797,1489,2018-11-17 13:00:00,2018-11-17 00:00:00,SÁBADO
17,11,2018,15,600,791,1391,2018-11-17 14:00:00,2018-11-17 00:00:00,SÁBADO
17,11,2018,16,565,742,1307,2018-11-17 15:00:00,2018-11-17 00:00:00,SÁBADO
17,11,2018,17,571,763,1334,2018-11-17 16:00:00,2018-11-17 00:00:00,SÁBADO
17,11,2018,18,645,822,1467,2018-11-17 17:00:00,2018-11-17 00:00:00,SÁBADO
17,11,2018,19,707,809,1516,2018-11-17 18:00:00,2018-11-17 00:00:00,SÁBADO
17,11,2018,20,721,755,1476,2018-11-17 19:00:00,2018-11-17 00:00:00,SÁBADO
17,11,2018,21,677,744,1421,2018-11-17 20:00:00,2018-11-17 00:00:00,SÁBADO
17,11,2018,22,623,662,1285,2018-11-17 21:00:00,2018-11-17 00:00:00,SÁBADO
17,11,2018,23,550,604,1154,2018-11-17 22:00:00,2018-11-17 00:00:00,SÁBADO
17,11,2018,24,507,506,1013,2018-11-17 23:00:00,2018-11-17 00:00:00,SÁBADO
18,11,2018,1,412,480,892,2018-11-18 00:00:00,2018-11-18 00:00:00,DOMINGO
18,11,2018,2,352,462,814,2018-11-18 01:00:00,2018-11-18 00:00:00,DOMINGO
18,11,2018,3,241,374,615,2018-11-18 02:00:00,2018-11-18 00:00:00,DOMINGO
18,11,2018,4,208,323,531,2018-11-18 03:00:00,2018-11-18 00:00:00,DOMINGO
18,11,2018,5,167,293,460,2018-11-18 04:00:00,2018-11-18 00:00:00,DOMINGO
18,11,2018,6,145,283,428,2018-11-18 05:00:00,2018-11-18 00:00:00,DOMINGO
18,11,2018,7,202,295,497,2018-11-18 06:00:00,2018-11-18 00:00:00,DOMINGO
18,11,2018,8,214,262,476,2018-11-18 07:00:00,2018-11-18 00:00:00,DOMINGO
18,11,2018,9,242,287,529,2018-11-18 08:00:00,2018-11-18 00:00:00,DOMINGO
18,11,2018,10,323,380,703,2018-11-18 09:00:00,2018-11-18 00:00:00,DOMINGO
18,11,2018,11,420,506,926,2018-11-18 10:00:00,2018-11-18 00:00:00,DOMINGO
18,11,2018,12,503,566,1069,2018-11-18 11:00:00,2018-11-18 00:00:00,DOMINGO
18,11,2018,13,568,634,1202,2018-11-18 12:00:00,2018-11-18 00:00:00,DOMINGO
18,11,2018,14,594,687,1281,2018-11-18 13:00:00,2018-11-18 00:00:00,DOMINGO
18,11,2018,15,608,621,1229,2018-11-18 14:00:00,2018-11-18 00:00:00,DOMINGO
18,11,2018,16,467,657,1124,2018-11-18 15:00:00,2018-11-18 00:00:00,DOMINGO
18,11,2018,17,451,662,1113,2018-11-18 16:00:00,2018-11-18 00:00:00,DOMINGO
18,11,2018,18,522,696,1218,2018-11-18 17:00:00,2018-11-18 00:00:00,DOMINGO
18,11,2018,19,594,736,1330,2018-11-18 18:00:00,2018-11-18 00:00:00,DOMINGO
18,11,2018,20,557,703,1260,2018-11-18 19:00:00,2018-11-18 00:00:00,DOMINGO
18,11,2018,21,513,642,1155,2018-11-18 20:00:00,2018-11-18 00:00:00,DOMINGO
18,11,2018,22,442,564,1006,2018-11-18 21:00:00,2018-11-18 00:00:00,DOMINGO
18,11,2018,23,361,393,754,2018-11-18 22:00:00,2018-11-18 00:00:00,DOMINGO
18,11,2018,24,243,345,588,2018-11-18 23:00:00,2018-11-18 00:00:00,DOMINGO
19,11,2018,1,162,268,430,2018-11-19 00:00:00,2018-11-19 00:00:00,LABORABLE
19,11,2018,2,79,190,269,2018-11-19 01:00:00,2018-11-19 00:00:00,LABORABLE
19,11,2018,3,76,137,213,2018-11-19 02:00:00,2018-11-19 00:00:00,LABORABLE
19,11,2018,4,63,108,171,2018-11-19 03:00:00,2018-11-19 00:00:00,LABORABLE
19,11,2018,5,72,109,181,2018-11-19 04:00:00,2018-11-19 00:00:00,LABORABLE
19,11,2018,6,147,156,303,2018-11-19 05:00:00,2018-11-19 00:00:00,LABORABLE
19,11,2018,7,451,413,864,2018-11-19 06:00:00,2018-11-19 00:00:00,LABORABLE
19,11,2018,8,686,703,1389,2018-11-19 07:00:00,2018-11-19 00:00:00,LABORABLE
19,11,2018,9,694,712,1406,2018-11-19 08:00:00,2018-11-19 00:00:00,LABORABLE
19,11,2018,10,629,704,1333,2018-11-19 09:00:00,2018-11-19 00:00:00,LABORABLE
19,11,2018,11,584,641,1225,2018-11-19 10:00:00,2018-11-19 00:00:00,LABORABLE
19,11,2018,12,611,703,1314,2018-11-19 11:00:00,2018-11-19 00:00:00,LABORABLE
19,11,2018,13,597,801,1398,2018-11-19 12:00:00,2018-11-19 00:00:00,LABORABLE
19,11,2018,14,645,682,1327,2018-11-19 13:00:00,2018-11-19 00:00:00,LABORABLE
19,11,2018,15,684,729,1413,2018-11-19 14:00:00,2018-11-19 00:00:00,LABORABLE
19,11,2018,16,652,646,1298,2018-11-19 15:00:00,2018-11-19 00:00:00,LABORABLE
19,11,2018,17,631,696,1327,2018-11-19 16:00:00,2018-11-19 00:00:00,LABORABLE
19,11,2018,18,680,798,1478,2018-11-19 17:00:00,2018-11-19 00:00:00,LABORABLE
19,11,2018,19,685,749,1434,2018-11-19 18:00:00,2018-11-19 00:00:00,LABORABLE
19,11,2018,20,573,726,1299,2018-11-19 19:00:00,2018-11-19 00:00:00,LABORABLE
19,11,2018,21,553,709,1262,2018-11-19 20:00:00,2018-11-19 00:00:00,LABORABLE
19,11,2018,22,458,572,1030,2018-11-19 21:00:00,2018-11-19 00:00:00,LABORABLE
19,11,2018,23,360,433,793,2018-11-19 22:00:00,2018-11-19 00:00:00,LABORABLE
19,11,2018,24,189,264,453,2018-11-19 23:00:00,2018-11-19 00:00:00,LABORABLE
20,11,2018,1,129,224,353,2018-11-20 00:00:00,2018-11-20 00:00:00,LABORABLE
20,11,2018,2,100,145,245,2018-11-20 01:00:00,2018-11-20 00:00:00,LABORABLE
20,11,2018,3,52,119,171,2018-11-20 02:00:00,2018-11-20 00:00:00,LABORABLE
20,11,2018,4,48,86,134,2018-11-20 03:00:00,2018-11-20 00:00:00,LABORABLE
20,11,2018,5,63,86,149,2018-11-20 04:00:00,2018-11-20 00:00:00,LABORABLE
20,11,2018,6,156,185,341,2018-11-20 05:00:00,2018-11-20 00:00:00,LABORABLE
20,11,2018,7,416,404,820,2018-11-20 06:00:00,2018-11-20 00:00:00,LABORABLE
20,11,2018,8,647,664,1311,2018-11-20 07:00:00,2018-11-20 00:00:00,LABORABLE
20,11,2018,9,685,689,1374,2018-11-20 08:00:00,2018-11-20 00:00:00,LABORABLE
20,11,2018,10,661,714,1375,2018-11-20 09:00:00,2018-11-20 00:00:00,LABORABLE
20,11,2018,11,437,564,1001,2018-11-20 10:00:00,2018-11-20 00:00:00,LABORABLE
20,11,2018,12,547,716,1263,2018-11-20 11:00:00,2018-11-20 00:00:00,LABORABLE
20,11,2018,13,553,719,1272,2018-11-20 12:00:00,2018-11-20 00:00:00,LABORABLE
20,11,2018,14,596,736,1332,2018-11-20 13:00:00,2018-11-20 00:00:00,LABORABLE
20,11,2018,15,633,684,1317,2018-11-20 14:00:00,2018-11-20 00:00:00,LABORABLE
20,11,2018,16,618,703,1321,2018-11-20 15:00:00,2018-11-20 00:00:00,LABORABLE
20,11,2018,17,626,831,1457,2018-11-20 16:00:00,2018-11-20 00:00:00,LABORABLE
20,11,2018,18,687,757,1444,2018-11-20 17:00:00,2018-11-20 00:00:00,LABORABLE
20,11,2018,19,671,771,1442,2018-11-20 18:00:00,2018-11-20 00:00:00,LABORABLE
20,11,2018,20,608,816,1424,2018-11-20 19:00:00,2018-11-20 00:00:00,LABORABLE
20,11,2018,21,599,742,1341,2018-11-20 20:00:00,2018-11-20 00:00:00,LABORABLE
20,11,2018,22,482,608,1090,2018-11-20 21:00:00,2018-11-20 00:00:00,LABORABLE
20,11,2018,23,367,417,784,2018-11-20 22:00:00,2018-11-20 00:00:00,LABORABLE
20,11,2018,24,197,315,512,2018-11-20 23:00:00,2018-11-20 00:00:00,LABORABLE
21,11,2018,1,152,267,419,2018-11-21 00:00:00,2018-11-21 00:00:00,LABORABLE
21,11,2018,2,101,198,299,2018-11-21 01:00:00,2018-11-21 00:00:00,LABORABLE
21,11,2018,3,76,123,199,2018-11-21 02:00:00,2018-11-21 00:00:00,LABORABLE
21,11,2018,4,61,93,154,2018-11-21 03:00:00,2018-11-21 00:00:00,LABORABLE
21,11,2018,5,72,104,176,2018-11-21 04:00:00,2018-11-21 00:00:00,LABORABLE
21,11,2018,6,161,173,334,2018-11-21 05:00:00,2018-11-21 00:00:00,LABORABLE
21,11,2018,7,457,418,875,2018-11-21 06:00:00,2018-11-21 00:00:00,LABORABLE
21,11,2018,8,682,671,1353,2018-11-21 07:00:00,2018-11-21 00:00:00,LABORABLE
21,11,2018,9,708,733,1441,2018-11-21 08:00:00,2018-11-21 00:00:00,LABORABLE
21,11,2018,10,616,727,1343,2018-11-21 09:00:00,2018-11-21 00:00:00,LABORABLE
21,11,2018,11,459,560,1019,2018-11-21 10:00:00,2018-11-21 00:00:00,LABORABLE
21,11,2018,12,546,654,1200,2018-11-21 11:00:00,2018-11-21 00:00:00,LABORABLE
21,11,2018,13,602,732,1334,2018-11-21 12:00:00,2018-11-21 00:00:00,LABORABLE
21,11,2018,14,599,721,1320,2018-11-21 13:00:00,2018-11-21 00:00:00,LABORABLE
21,11,2018,15,652,754,1406,2018-11-21 14:00:00,2018-11-21 00:00:00,LABORABLE
21,11,2018,16,678,686,1364,2018-11-21 15:00:00,2018-11-21 00:00:00,LABORABLE
21,11,2018,17,636,778,1414,2018-11-21 16:00:00,2018-11-21 00:00:00,LABORABLE
21,11,2018,18,686,770,1456,2018-11-21 17:00:00,2018-11-21 00:00:00,LABORABLE
21,11,2018,19,698,772,1470,2018-11-21 18:00:00,2018-11-21 00:00:00,LABORABLE
21,11,2018,20,606,775,1381,2018-11-21 19:00:00,2018-11-21 00:00:00,LABORABLE
21,11,2018,21,604,763,1367,2018-11-21 20:00:00,2018-11-21 00:00:00,LABORABLE
21,11,2018,22,508,592,1100,2018-11-21 21:00:00,2018-11-21 00:00:00,LABORABLE
21,11,2018,23,404,453,857,2018-11-21 22:00:00,2018-11-21 00:00:00,LABORABLE
21,11,2018,24,225,321,546,2018-11-21 23:00:00,2018-11-21 00:00:00,LABORABLE
22,11,2018,1,164,264,428,2018-11-22 00:00:00,2018-11-22 00:00:00,LABORABLE
22,11,2018,2,117,175,292,2018-11-22 01:00:00,2018-11-22 00:00:00,LABORABLE
22,11,2018,3,86,146,232,2018-11-22 02:00:00,2018-11-22 00:00:00,LABORABLE
22,11,2018,4,66,120,186,2018-11-22 03:00:00,2018-11-22 00:00:00,LABORABLE
22,11,2018,5,71,101,172,2018-11-22 04:00:00,2018-11-22 00:00:00,LABORABLE
22,11,2018,6,154,174,328,2018-11-22 05:00:00,2018-11-22 00:00:00,LABORABLE
22,11,2018,7,468,413,881,2018-11-22 06:00:00,2018-11-22 00:00:00,LABORABLE
22,11,2018,8,670,688,1358,2018-11-22 07:00:00,2018-11-22 00:00:00,LABORABLE
22,11,2018,9,683,696,1379,2018-11-22 08:00:00,2018-11-22 00:00:00,LABORABLE
22,11,2018,10,682,718,1400,2018-11-22 09:00:00,2018-11-22 00:00:00,LABORABLE
22,11,2018,11,602,684,1286,2018-11-22 10:00:00,2018-11-22 00:00:00,LABORABLE
22,11,2018,12,612,713,1325,2018-11-22 11:00:00,2018-11-22 00:00:00,LABORABLE
22,11,2018,13,603,782,1385,2018-11-22 12:00:00,2018-11-22 00:00:00,LABORABLE
22,11,2018,14,632,710,1342,2018-11-22 13:00:00,2018-11-22 00:00:00,LABORABLE
22,11,2018,15,684,703,1387,2018-11-22 14:00:00,2018-11-22 00:00:00,LABORABLE
22,11,2018,16,671,701,1372,2018-11-22 15:00:00,2018-11-22 00:00:00,LABORABLE
22,11,2018,17,693,746,1439,2018-11-22 16:00:00,2018-11-22 00:00:00,LABORABLE
22,11,2018,18,759,816,1575,2018-11-22 17:00:00,2018-11-22 00:00:00,LABORABLE
22,11,2018,19,697,747,1444,2018-11-22 18:00:00,2018-11-22 00:00:00,LABORABLE
22,11,2018,20,670,757,1427,2018-11-22 19:00:00,2018-11-22 00:00:00,LABORABLE
22,11,2018,21,661,693,1354,2018-11-22 20:00:00,2018-11-22 00:00:00,LABORABLE
22,11,2018,22,603,604,1207,2018-11-22 21:00:00,2018-11-22 00:00:00,LABORABLE
22,11,2018,23,444,480,924,2018-11-22 22:00:00,2018-11-22 00:00:00,LABORABLE
22,11,2018,24,253,407,660,2018-11-22 23:00:00,2018-11-22 00:00:00,LABORABLE
23,11,2018,1,200,289,489,2018-11-23 00:00:00,2018-11-23 00:00:00,LABORABLE
23,11,2018,2,135,216,351,2018-11-23 01:00:00,2018-11-23 00:00:00,LABORABLE
23,11,2018,3,83,176,259,2018-11-23 02:00:00,2018-11-23 00:00:00,LABORABLE
23,11,2018,4,71,136,207,2018-11-23 03:00:00,2018-11-23 00:00:00,LABORABLE
23,11,2018,5,77,109,186,2018-11-23 04:00:00,2018-11-23 00:00:00,LABORABLE
23,11,2018,6,156,170,326,2018-11-23 05:00:00,2018-11-23 00:00:00,LABORABLE
23,11,2018,7,444,427,871,2018-11-23 06:00:00,2018-11-23 00:00:00,LABORABLE
23,11,2018,8,662,671,1333,2018-11-23 07:00:00,2018-11-23 00:00:00,LABORABLE
23,11,2018,9,504,563,1067,2018-11-23 08:00:00,2018-11-23 00:00:00,LABORABLE
23,11,2018,10,638,725,1363,2018-11-23 09:00:00,2018-11-23 00:00:00,LABORABLE
23,11,2018,11,610,717,1327,2018-11-23 10:00:00,2018-11-23 00:00:00,LABORABLE
23,11,2018,12,562,692,1254,2018-11-23 11:00:00,2018-11-23 00:00:00,LABORABLE
23,11,2018,13,644,761,1405,2018-11-23 12:00:00,2018-11-23 00:00:00,LABORABLE
23,11,2018,14,698,783,1481,2018-11-23 13:00:00,2018-11-23 00:00:00,LABORABLE
23,11,2018,15,765,778,1543,2018-11-23 14:00:00,2018-11-23 00:00:00,LABORABLE
23,11,2018,16,678,742,1420,2018-11-23 15:00:00,2018-11-23 00:00:00,LABORABLE
23,11,2018,17,681,745,1426,2018-11-23 16:00:00,2018-11-23 00:00:00,LABORABLE
23,11,2018,18,718,792,1510,2018-11-23 17:00:00,2018-11-23 00:00:00,LABORABLE
23,11,2018,19,726,800,1526,2018-11-23 18:00:00,2018-11-23 00:00:00,LABORABLE
23,11,2018,20,663,793,1456,2018-11-23 19:00:00,2018-11-23 00:00:00,LABORABLE
23,11,2018,21,703,822,1525,2018-11-23 20:00:00,2018-11-23 00:00:00,LABORABLE
23,11,2018,22,664,762,1426,2018-11-23 21:00:00,2018-11-23 00:00:00,LABORABLE
23,11,2018,23,495,563,1058,2018-11-23 22:00:00,2018-11-23 00:00:00,LABORABLE
23,11,2018,24,380,483,863,2018-11-23 23:00:00,2018-11-23 00:00:00,LABORABLE
24,11,2018,1,331,396,727,2018-11-24 00:00:00,2018-11-24 00:00:00,SÁBADO
24,11,2018,2,219,348,567,2018-11-24 01:00:00,2018-11-24 00:00:00,SÁBADO
24,11,2018,3,173,279,452,2018-11-24 02:00:00,2018-11-24 00:00:00,SÁBADO
24,11,2018,4,125,285,410,2018-11-24 03:00:00,2018-11-24 00:00:00,SÁBADO
24,11,2018,5,115,212,327,2018-11-24 04:00:00,2018-11-24 00:00:00,SÁBADO
24,11,2018,6,136,232,368,2018-11-24 05:00:00,2018-11-24 00:00:00,SÁBADO
24,11,2018,7,216,264,480,2018-11-24 06:00:00,2018-11-24 00:00:00,SÁBADO
24,11,2018,8,323,286,609,2018-11-24 07:00:00,2018-11-24 00:00:00,SÁBADO
24,11,2018,9,337,423,760,2018-11-24 08:00:00,2018-11-24 00:00:00,SÁBADO
24,11,2018,10,474,483,957,2018-11-24 09:00:00,2018-11-24 00:00:00,SÁBADO
24,11,2018,11,580,646,1226,2018-11-24 10:00:00,2018-11-24 00:00:00,SÁBADO
24,11,2018,12,646,716,1362,2018-11-24 11:00:00,2018-11-24 00:00:00,SÁBADO
24,11,2018,13,666,707,1373,2018-11-24 12:00:00,2018-11-24 00:00:00,SÁBADO
24,11,2018,14,673,776,1449,2018-11-24 13:00:00,2018-11-24 00:00:00,SÁBADO
24,11,2018,15,621,820,1441,2018-11-24 14:00:00,2018-11-24 00:00:00,SÁBADO
24,11,2018,16,541,699,1240,2018-11-24 15:00:00,2018-11-24 00:00:00,SÁBADO
24,11,2018,17,543,735,1278,2018-11-24 16:00:00,2018-11-24 00:00:00,SÁBADO
24,11,2018,18,625,839,1464,2018-11-24 17:00:00,2018-11-24 00:00:00,SÁBADO
24,11,2018,19,704,849,1553,2018-11-24 18:00:00,2018-11-24 00:00:00,SÁBADO
24,11,2018,20,608,782,1390,2018-11-24 19:00:00,2018-11-24 00:00:00,SÁBADO
24,11,2018,21,633,704,1337,2018-11-24 20:00:00,2018-11-24 00:00:00,SÁBADO
24,11,2018,22,606,630,1236,2018-11-24 21:00:00,2018-11-24 00:00:00,SÁBADO
24,11,2018,23,506,564,1070,2018-11-24 22:00:00,2018-11-24 00:00:00,SÁBADO
24,11,2018,24,477,517,994,2018-11-24 23:00:00,2018-11-24 00:00:00,SÁBADO
25,11,2018,1,343,529,872,2018-11-25 00:00:00,2018-11-25 00:00:00,DOMINGO
25,11,2018,2,315,459,774,2018-11-25 01:00:00,2018-11-25 00:00:00,DOMINGO
25,11,2018,3,253,427,680,2018-11-25 02:00:00,2018-11-25 00:00:00,DOMINGO
25,11,2018,4,194,328,522,2018-11-25 03:00:00,2018-11-25 00:00:00,DOMINGO
25,11,2018,5,155,246,401,2018-11-25 04:00:00,2018-11-25 00:00:00,DOMINGO
25,11,2018,6,142,276,418,2018-11-25 05:00:00,2018-11-25 00:00:00,DOMINGO
25,11,2018,7,180,258,438,2018-11-25 06:00:00,2018-11-25 00:00:00,DOMINGO
25,11,2018,8,220,235,455,2018-11-25 07:00:00,2018-11-25 00:00:00,DOMINGO
25,11,2018,9,209,282,491,2018-11-25 08:00:00,2018-11-25 00:00:00,DOMINGO
25,11,2018,10,306,342,648,2018-11-25 09:00:00,2018-11-25 00:00:00,DOMINGO
25,11,2018,11,401,506,907,2018-11-25 10:00:00,2018-11-25 00:00:00,DOMINGO
25,11,2018,12,556,550,1106,2018-11-25 11:00:00,2018-11-25 00:00:00,DOMINGO
25,11,2018,13,592,639,1231,2018-11-25 12:00:00,2018-11-25 00:00:00,DOMINGO
25,11,2018,14,586,723,1309,2018-11-25 13:00:00,2018-11-25 00:00:00,DOMINGO
25,11,2018,15,588,681,1269,2018-11-25 14:00:00,2018-11-25 00:00:00,DOMINGO
25,11,2018,16,445,667,1112,2018-11-25 15:00:00,2018-11-25 00:00:00,DOMINGO
25,11,2018,17,423,621,1044,2018-11-25 16:00:00,2018-11-25 00:00:00,DOMINGO
25,11,2018,18,485,744,1229,2018-11-25 17:00:00,2018-11-25 00:00:00,DOMINGO
25,11,2018,19,614,768,1382,2018-11-25 18:00:00,2018-11-25 00:00:00,DOMINGO
25,11,2018,20,586,656,1242,2018-11-25 19:00:00,2018-11-25 00:00:00,DOMINGO
25,11,2018,21,499,636,1135,2018-11-25 20:00:00,2018-11-25 00:00:00,DOMINGO
25,11,2018,22,459,618,1077,2018-11-25 21:00:00,2018-11-25 00:00:00,DOMINGO
25,11,2018,23,368,459,827,2018-11-25 22:00:00,2018-11-25 00:00:00,DOMINGO
25,11,2018,24,252,357,609,2018-11-25 23:00:00,2018-11-25 00:00:00,DOMINGO
26,11,2018,1,145,297,442,2018-11-26 00:00:00,2018-11-26 00:00:00,LABORABLE
26,11,2018,2,125,202,327,2018-11-26 01:00:00,2018-11-26 00:00:00,LABORABLE
26,11,2018,3,83,166,249,2018-11-26 02:00:00,2018-11-26 00:00:00,LABORABLE
26,11,2018,4,60,100,160,2018-11-26 03:00:00,2018-11-26 00:00:00,LABORABLE
26,11,2018,5,84,108,192,2018-11-26 04:00:00,2018-11-26 00:00:00,LABORABLE
26,11,2018,6,137,183,320,2018-11-26 05:00:00,2018-11-26 00:00:00,LABORABLE
26,11,2018,7,437,448,885,2018-11-26 06:00:00,2018-11-26 00:00:00,LABORABLE
26,11,2018,8,693,697,1390,2018-11-26 07:00:00,2018-11-26 00:00:00,LABORABLE
26,11,2018,9,717,682,1399,2018-11-26 08:00:00,2018-11-26 00:00:00,LABORABLE
26,11,2018,10,646,682,1328,2018-11-26 09:00:00,2018-11-26 00:00:00,LABORABLE
26,11,2018,11,562,641,1203,2018-11-26 10:00:00,2018-11-26 00:00:00,LABORABLE
26,11,2018,12,575,691,1266,2018-11-26 11:00:00,2018-11-26 00:00:00,LABORABLE
26,11,2018,13,610,748,1358,2018-11-26 12:00:00,2018-11-26 00:00:00,LABORABLE
26,11,2018,14,606,744,1350,2018-11-26 13:00:00,2018-11-26 00:00:00,LABORABLE
26,11,2018,15,685,730,1415,2018-11-26 14:00:00,2018-11-26 00:00:00,LABORABLE
26,11,2018,16,662,748,1410,2018-11-26 15:00:00,2018-11-26 00:00:00,LABORABLE
26,11,2018,17,656,684,1340,2018-11-26 16:00:00,2018-11-26 00:00:00,LABORABLE
26,11,2018,18,679,762,1441,2018-11-26 17:00:00,2018-11-26 00:00:00,LABORABLE
26,11,2018,19,699,773,1472,2018-11-26 18:00:00,2018-11-26 00:00:00,LABORABLE
26,11,2018,20,596,781,1377,2018-11-26 19:00:00,2018-11-26 00:00:00,LABORABLE
26,11,2018,21,616,726,1342,2018-11-26 20:00:00,2018-11-26 00:00:00,LABORABLE
26,11,2018,22,477,572,1049,2018-11-26 21:00:00,2018-11-26 00:00:00,LABORABLE
26,11,2018,23,341,441,782,2018-11-26 22:00:00,2018-11-26 00:00:00,LABORABLE
26,11,2018,24,185,325,510,2018-11-26 23:00:00,2018-11-26 00:00:00,LABORABLE
27,11,2018,1,154,244,398,2018-11-27 00:00:00,2018-11-27 00:00:00,LABORABLE
27,11,2018,2,96,164,260,2018-11-27 01:00:00,2018-11-27 00:00:00,LABORABLE
27,11,2018,3,69,116,185,2018-11-27 02:00:00,2018-11-27 00:00:00,LABORABLE
27,11,2018,4,62,99,161,2018-11-27 03:00:00,2018-11-27 00:00:00,LABORABLE
27,11,2018,5,72,101,173,2018-11-27 04:00:00,2018-11-27 00:00:00,LABORABLE
27,11,2018,6,152,160,312,2018-11-27 05:00:00,2018-11-27 00:00:00,LABORABLE
27,11,2018,7,452,406,858,2018-11-27 06:00:00,2018-11-27 00:00:00,LABORABLE
27,11,2018,8,644,624,1268,2018-11-27 07:00:00,2018-11-27 00:00:00,LABORABLE
27,11,2018,9,686,692,1378,2018-11-27 08:00:00,2018-11-27 00:00:00,LABORABLE
27,11,2018,10,637,685,1322,2018-11-27 09:00:00,2018-11-27 00:00:00,LABORABLE
27,11,2018,11,428,524,952,2018-11-27 10:00:00,2018-11-27 00:00:00,LABORABLE
27,11,2018,12,570,734,1304,2018-11-27 11:00:00,2018-11-27 00:00:00,LABORABLE
27,11,2018,13,632,702,1334,2018-11-27 12:00:00,2018-11-27 00:00:00,LABORABLE
27,11,2018,14,617,729,1346,2018-11-27 13:00:00,2018-11-27 00:00:00,LABORABLE
27,11,2018,15,696,767,1463,2018-11-27 14:00:00,2018-11-27 00:00:00,LABORABLE
27,11,2018,16,698,671,1369,2018-11-27 15:00:00,2018-11-27 00:00:00,LABORABLE
27,11,2018,17,650,800,1450,2018-11-27 16:00:00,2018-11-27 00:00:00,LABORABLE
27,11,2018,18,653,836,1489,2018-11-27 17:00:00,2018-11-27 00:00:00,LABORABLE
27,11,2018,19,672,791,1463,2018-11-27 18:00:00,2018-11-27 00:00:00,LABORABLE
27,11,2018,20,602,772,1374,2018-11-27 19:00:00,2018-11-27 00:00:00,LABORABLE
27,11,2018,21,613,788,1401,2018-11-27 20:00:00,2018-11-27 00:00:00,LABORABLE
27,11,2018,22,478,646,1124,2018-11-27 21:00:00,2018-11-27 00:00:00,LABORABLE
27,11,2018,23,336,450,786,2018-11-27 22:00:00,2018-11-27 00:00:00,LABORABLE
27,11,2018,24,253,312,565,2018-11-27 23:00:00,2018-11-27 00:00:00,LABORABLE
28,11,2018,1,157,246,403,2018-11-28 00:00:00,2018-11-28 00:00:00,LABORABLE
28,11,2018,2,114,191,305,2018-11-28 01:00:00,2018-11-28 00:00:00,LABORABLE
28,11,2018,3,78,123,201,2018-11-28 02:00:00,2018-11-28 00:00:00,LABORABLE
28,11,2018,4,58,128,186,2018-11-28 03:00:00,2018-11-28 00:00:00,LABORABLE
28,11,2018,5,69,101,170,2018-11-28 04:00:00,2018-11-28 00:00:00,LABORABLE
28,11,2018,6,162,167,329,2018-11-28 05:00:00,2018-11-28 00:00:00,LABORABLE
28,11,2018,7,428,420,848,2018-11-28 06:00:00,2018-11-28 00:00:00,LABORABLE
28,11,2018,8,632,713,1345,2018-11-28 07:00:00,2018-11-28 00:00:00,LABORABLE
28,11,2018,9,702,743,1445,2018-11-28 08:00:00,2018-11-28 00:00:00,LABORABLE
28,11,2018,10,654,723,1377,2018-11-28 09:00:00,2018-11-28 00:00:00,LABORABLE
28,11,2018,11,409,687,1096,2018-11-28 10:00:00,2018-11-28 00:00:00,LABORABLE
28,11,2018,12,587,816,1403,2018-11-28 11:00:00,2018-11-28 00:00:00,LABORABLE
28,11,2018,13,623,769,1392,2018-11-28 12:00:00,2018-11-28 00:00:00,LABORABLE
28,11,2018,14,623,831,1454,2018-11-28 13:00:00,2018-11-28 00:00:00,LABORABLE
28,11,2018,15,655,757,1412,2018-11-28 14:00:00,2018-11-28 00:00:00,LABORABLE
28,11,2018,16,661,679,1340,2018-11-28 15:00:00,2018-11-28 00:00:00,LABORABLE
28,11,2018,17,671,801,1472,2018-11-28 16:00:00,2018-11-28 00:00:00,LABORABLE
28,11,2018,18,699,822,1521,2018-11-28 17:00:00,2018-11-28 00:00:00,LABORABLE
28,11,2018,19,681,816,1497,2018-11-28 18:00:00,2018-11-28 00:00:00,LABORABLE
28,11,2018,20,607,799,1406,2018-11-28 19:00:00,2018-11-28 00:00:00,LABORABLE
28,11,2018,21,645,733,1378,2018-11-28 20:00:00,2018-11-28 00:00:00,LABORABLE
28,11,2018,22,533,554,1087,2018-11-28 21:00:00,2018-11-28 00:00:00,LABORABLE
28,11,2018,23,399,480,879,2018-11-28 22:00:00,2018-11-28 00:00:00,LABORABLE
28,11,2018,24,269,386,655,2018-11-28 23:00:00,2018-11-28 00:00:00,LABORABLE
29,11,2018,1,181,276,457,2018-11-29 00:00:00,2018-11-29 00:00:00,LABORABLE
29,11,2018,2,117,186,303,2018-11-29 01:00:00,2018-11-29 00:00:00,LABORABLE
29,11,2018,3,80,144,224,2018-11-29 02:00:00,2018-11-29 00:00:00,LABORABLE
29,11,2018,4,62,103,165,2018-11-29 03:00:00,2018-11-29 00:00:00,LABORABLE
29,11,2018,5,81,117,198,2018-11-29 04:00:00,2018-11-29 00:00:00,LABORABLE
29,11,2018,6,149,183,332,2018-11-29 05:00:00,2018-11-29 00:00:00,LABORABLE
29,11,2018,7,458,434,892,2018-11-29 06:00:00,2018-11-29 00:00:00,LABORABLE
29,11,2018,8,685,668,1353,2018-11-29 07:00:00,2018-11-29 00:00:00,LABORABLE
29,11,2018,9,677,726,1403,2018-11-29 08:00:00,2018-11-29 00:00:00,LABORABLE
29,11,2018,10,690,721,1411,2018-11-29 09:00:00,2018-11-29 00:00:00,LABORABLE
29,11,2018,11,623,703,1326,2018-11-29 10:00:00,2018-11-29 00:00:00,LABORABLE
29,11,2018,12,619,740,1359,2018-11-29 11:00:00,2018-11-29 00:00:00,LABORABLE
29,11,2018,13,685,782,1467,2018-11-29 12:00:00,2018-11-29 00:00:00,LABORABLE
29,11,2018,14,648,796,1444,2018-11-29 13:00:00,2018-11-29 00:00:00,LABORABLE
29,11,2018,15,713,779,1492,2018-11-29 14:00:00,2018-11-29 00:00:00,LABORABLE
29,11,2018,16,708,698,1406,2018-11-29 15:00:00,2018-11-29 00:00:00,LABORABLE
29,11,2018,17,662,802,1464,2018-11-29 16:00:00,2018-11-29 00:00:00,LABORABLE
29,11,2018,18,736,784,1520,2018-11-29 17:00:00,2018-11-29 00:00:00,LABORABLE
29,11,2018,19,689,853,1542,2018-11-29 18:00:00,2018-11-29 00:00:00,LABORABLE
29,11,2018,20,672,829,1501,2018-11-29 19:00:00,2018-11-29 00:00:00,LABORABLE
29,11,2018,21,648,804,1452,2018-11-29 20:00:00,2018-11-29 00:00:00,LABORABLE
29,11,2018,22,551,628,1179,2018-11-29 21:00:00,2018-11-29 00:00:00,LABORABLE
29,11,2018,23,443,475,918,2018-11-29 22:00:00,2018-11-29 00:00:00,LABORABLE
29,11,2018,24,291,380,671,2018-11-29 23:00:00,2018-11-29 00:00:00,LABORABLE
30,11,2018,1,210,316,526,2018-11-30 00:00:00,2018-11-30 00:00:00,LABORABLE
30,11,2018,2,122,248,370,2018-11-30 01:00:00,2018-11-30 00:00:00,LABORABLE
30,11,2018,3,89,169,258,2018-11-30 02:00:00,2018-11-30 00:00:00,LABORABLE
30,11,2018,4,69,121,190,2018-11-30 03:00:00,2018-11-30 00:00:00,LABORABLE
30,11,2018,5,77,108,185,2018-11-30 04:00:00,2018-11-30 00:00:00,LABORABLE
30,11,2018,6,173,177,350,2018-11-30 05:00:00,2018-11-30 00:00:00,LABORABLE
30,11,2018,7,434,433,867,2018-11-30 06:00:00,2018-11-30 00:00:00,LABORABLE
30,11,2018,8,671,680,1351,2018-11-30 07:00:00,2018-11-30 00:00:00,LABORABLE
30,11,2018,9,672,732,1404,2018-11-30 08:00:00,2018-11-30 00:00:00,LABORABLE
30,11,2018,10,692,718,1410,2018-11-30 09:00:00,2018-11-30 00:00:00,LABORABLE
30,11,2018,11,572,706,1278,2018-11-30 10:00:00,2018-11-30 00:00:00,LABORABLE
30,11,2018,12,624,775,1399,2018-11-30 11:00:00,2018-11-30 00:00:00,LABORABLE
30,11,2018,13,617,771,1388,2018-11-30 12:00:00,2018-11-30 00:00:00,LABORABLE
30,11,2018,14,738,806,1544,2018-11-30 13:00:00,2018-11-30 00:00:00,LABORABLE
30,11,2018,15,696,776,1472,2018-11-30 14:00:00,2018-11-30 00:00:00,LABORABLE
30,11,2018,16,683,728,1411,2018-11-30 15:00:00,2018-11-30 00:00:00,LABORABLE
30,11,2018,17,677,825,1502,2018-11-30 16:00:00,2018-11-30 00:00:00,LABORABLE
30,11,2018,18,740,845,1585,2018-11-30 17:00:00,2018-11-30 00:00:00,LABORABLE
30,11,2018,19,749,865,1614,2018-11-30 18:00:00,2018-11-30 00:00:00,LABORABLE
30,11,2018,20,701,826,1527,2018-11-30 19:00:00,2018-11-30 00:00:00,LABORABLE
30,11,2018,21,632,780,1412,2018-11-30 20:00:00,2018-11-30 00:00:00,LABORABLE
30,11,2018,22,608,768,1376,2018-11-30 21:00:00,2018-11-30 00:00:00,LABORABLE
30,11,2018,23,537,612,1149,2018-11-30 22:00:00,2018-11-30 00:00:00,LABORABLE
30,11,2018,24,434,572,1006,2018-11-30 23:00:00,2018-11-30 00:00:00,LABORABLE
1,12,2018,1,319,521,840,2018-12-01 00:00:00,2018-01-12 00:00:00,SÁBADO
1,12,2018,2,265,432,697,2018-12-01 01:00:00,2018-01-12 00:00:00,SÁBADO
1,12,2018,3,193,336,529,2018-12-01 02:00:00,2018-01-12 00:00:00,SÁBADO
1,12,2018,4,155,265,420,2018-12-01 03:00:00,2018-01-12 00:00:00,SÁBADO
1,12,2018,5,148,255,403,2018-12-01 04:00:00,2018-01-12 00:00:00,SÁBADO
1,12,2018,6,184,237,421,2018-12-01 05:00:00,2018-01-12 00:00:00,SÁBADO
1,12,2018,7,238,312,550,2018-12-01 06:00:00,2018-01-12 00:00:00,SÁBADO
1,12,2018,8,279,324,603,2018-12-01 07:00:00,2018-01-12 00:00:00,SÁBADO
1,12,2018,9,381,433,814,2018-12-01 08:00:00,2018-01-12 00:00:00,SÁBADO
1,12,2018,10,462,531,993,2018-12-01 09:00:00,2018-01-12 00:00:00,SÁBADO
1,12,2018,11,565,643,1208,2018-12-01 10:00:00,2018-01-12 00:00:00,SÁBADO
1,12,2018,12,639,782,1421,2018-12-01 11:00:00,2018-01-12 00:00:00,SÁBADO
1,12,2018,13,686,787,1473,2018-12-01 12:00:00,2018-01-12 00:00:00,SÁBADO
1,12,2018,14,743,859,1602,2018-12-01 13:00:00,2018-01-12 00:00:00,SÁBADO
1,12,2018,15,678,834,1512,2018-12-01 14:00:00,2018-01-12 00:00:00,SÁBADO
1,12,2018,16,590,722,1312,2018-12-01 15:00:00,2018-01-12 00:00:00,SÁBADO
1,12,2018,17,570,684,1254,2018-12-01 16:00:00,2018-01-12 00:00:00,SÁBADO
1,12,2018,18,629,814,1443,2018-12-01 17:00:00,2018-01-12 00:00:00,SÁBADO
1,12,2018,19,711,825,1536,2018-12-01 18:00:00,2018-01-12 00:00:00,SÁBADO
1,12,2018,20,646,780,1426,2018-12-01 19:00:00,2018-01-12 00:00:00,SÁBADO
1,12,2018,21,603,694,1297,2018-12-01 20:00:00,2018-01-12 00:00:00,SÁBADO
1,12,2018,22,619,635,1254,2018-12-01 21:00:00,2018-01-12 00:00:00,SÁBADO
1,12,2018,23,585,622,1207,2018-12-01 22:00:00,2018-01-12 00:00:00,SÁBADO
1,12,2018,24,427,610,1037,2018-12-01 23:00:00,2018-01-12 00:00:00,SÁBADO
2,12,2018,1,379,507,886,2018-12-02 00:00:00,2018-02-12 00:00:00,DOMINGO
2,12,2018,2,317,478,795,2018-12-02 01:00:00,2018-02-12 00:00:00,DOMINGO
2,12,2018,3,228,403,631,2018-12-02 02:00:00,2018-02-12 00:00:00,DOMINGO
2,12,2018,4,188,365,553,2018-12-02 03:00:00,2018-02-12 00:00:00,DOMINGO
2,12,2018,5,154,302,456,2018-12-02 04:00:00,2018-02-12 00:00:00,DOMINGO
2,12,2018,6,177,325,502,2018-12-02 05:00:00,2018-02-12 00:00:00,DOMINGO
2,12,2018,7,197,283,480,2018-12-02 06:00:00,2018-02-12 00:00:00,DOMINGO
2,12,2018,8,202,269,471,2018-12-02 07:00:00,2018-02-12 00:00:00,DOMINGO
2,12,2018,9,212,328,540,2018-12-02 08:00:00,2018-02-12 00:00:00,DOMINGO
2,12,2018,10,353,395,748,2018-12-02 09:00:00,2018-02-12 00:00:00,DOMINGO
2,12,2018,11,413,502,915,2018-12-02 10:00:00,2018-02-12 00:00:00,DOMINGO
2,12,2018,12,538,551,1089,2018-12-02 11:00:00,2018-02-12 00:00:00,DOMINGO
2,12,2018,13,580,674,1254,2018-12-02 12:00:00,2018-02-12 00:00:00,DOMINGO
2,12,2018,14,592,734,1326,2018-12-02 13:00:00,2018-02-12 00:00:00,DOMINGO
2,12,2018,15,602,766,1368,2018-12-02 14:00:00,2018-02-12 00:00:00,DOMINGO
2,12,2018,16,528,651,1179,2018-12-02 15:00:00,2018-02-12 00:00:00,DOMINGO
2,12,2018,17,478,750,1228,2018-12-02 16:00:00,2018-02-12 00:00:00,DOMINGO
2,12,2018,18,548,848,1396,2018-12-02 17:00:00,2018-02-12 00:00:00,DOMINGO
2,12,2018,19,700,735,1435,2018-12-02 18:00:00,2018-02-12 00:00:00,DOMINGO
2,12,2018,20,613,767,1380,2018-12-02 19:00:00,2018-02-12 00:00:00,DOMINGO
2,12,2018,21,523,723,1246,2018-12-02 20:00:00,2018-02-12 00:00:00,DOMINGO
2,12,2018,22,509,614,1123,2018-12-02 21:00:00,2018-02-12 00:00:00,DOMINGO
2,12,2018,23,359,501,860,2018-12-02 22:00:00,2018-02-12 00:00:00,DOMINGO
2,12,2018,24,266,363,629,2018-12-02 23:00:00,2018-02-12 00:00:00,DOMINGO
3,12,2018,1,175,279,454,2018-12-03 00:00:00,2018-03-12 00:00:00,LABORABLE
3,12,2018,2,121,185,306,2018-12-03 01:00:00,2018-03-12 00:00:00,LABORABLE
3,12,2018,3,88,162,250,2018-12-03 02:00:00,2018-03-12 00:00:00,LABORABLE
3,12,2018,4,70,143,213,2018-12-03 03:00:00,2018-03-12 00:00:00,LABORABLE
3,12,2018,5,82,111,193,2018-12-03 04:00:00,2018-03-12 00:00:00,LABORABLE
3,12,2018,6,149,177,326,2018-12-03 05:00:00,2018-03-12 00:00:00,LABORABLE
3,12,2018,7,444,438,882,2018-12-03 06:00:00,2018-03-12 00:00:00,LABORABLE
3,12,2018,8,704,656,1360,2018-12-03 07:00:00,2018-03-12 00:00:00,LABORABLE
3,12,2018,9,681,679,1360,2018-12-03 08:00:00,2018-03-12 00:00:00,LABORABLE
3,12,2018,10,627,718,1345,2018-12-03 09:00:00,2018-03-12 00:00:00,LABORABLE
3,12,2018,11,594,690,1284,2018-12-03 10:00:00,2018-03-12 00:00:00,LABORABLE
3,12,2018,12,502,555,1057,2018-12-03 11:00:00,2018-03-12 00:00:00,LABORABLE
3,12,2018,13,644,800,1444,2018-12-03 12:00:00,2018-03-12 00:00:00,LABORABLE
3,12,2018,14,641,745,1386,2018-12-03 13:00:00,2018-03-12 00:00:00,LABORABLE
3,12,2018,15,666,709,1375,2018-12-03 14:00:00,2018-03-12 00:00:00,LABORABLE
3,12,2018,16,660,689,1349,2018-12-03 15:00:00,2018-03-12 00:00:00,LABORABLE
3,12,2018,17,648,776,1424,2018-12-03 16:00:00,2018-03-12 00:00:00,LABORABLE
3,12,2018,18,715,769,1484,2018-12-03 17:00:00,2018-03-12 00:00:00,LABORABLE
3,12,2018,19,666,812,1478,2018-12-03 18:00:00,2018-03-12 00:00:00,LABORABLE
3,12,2018,20,606,827,1433,2018-12-03 19:00:00,2018-03-12 00:00:00,LABORABLE
3,12,2018,21,597,711,1308,2018-12-03 20:00:00,2018-03-12 00:00:00,LABORABLE
3,12,2018,22,508,607,1115,2018-12-03 21:00:00,2018-03-12 00:00:00,LABORABLE
3,12,2018,23,363,475,838,2018-12-03 22:00:00,2018-03-12 00:00:00,LABORABLE
3,12,2018,24,209,318,527,2018-12-03 23:00:00,2018-03-12 00:00:00,LABORABLE
4,12,2018,1,130,235,365,2018-12-04 00:00:00,2018-04-12 00:00:00,LABORABLE
4,12,2018,2,95,164,259,2018-12-04 01:00:00,2018-04-12 00:00:00,LABORABLE
4,12,2018,3,74,121,195,2018-12-04 02:00:00,2018-04-12 00:00:00,LABORABLE
4,12,2018,4,58,100,158,2018-12-04 03:00:00,2018-04-12 00:00:00,LABORABLE
4,12,2018,5,75,110,185,2018-12-04 04:00:00,2018-04-12 00:00:00,LABORABLE
4,12,2018,6,159,155,314,2018-12-04 05:00:00,2018-04-12 00:00:00,LABORABLE
4,12,2018,7,442,433,875,2018-12-04 06:00:00,2018-04-12 00:00:00,LABORABLE
4,12,2018,8,650,631,1281,2018-12-04 07:00:00,2018-04-12 00:00:00,LABORABLE
4,12,2018,9,674,646,1320,2018-12-04 08:00:00,2018-04-12 00:00:00,LABORABLE
4,12,2018,10,664,706,1370,2018-12-04 09:00:00,2018-04-12 00:00:00,LABORABLE
4,12,2018,11,556,678,1234,2018-12-04 10:00:00,2018-04-12 00:00:00,LABORABLE
4,12,2018,12,480,563,1043,2018-12-04 11:00:00,2018-04-12 00:00:00,LABORABLE
4,12,2018,13,616,772,1388,2018-12-04 12:00:00,2018-04-12 00:00:00,LABORABLE
4,12,2018,14,637,761,1398,2018-12-04 13:00:00,2018-04-12 00:00:00,LABORABLE
4,12,2018,15,700,734,1434,2018-12-04 14:00:00,2018-04-12 00:00:00,LABORABLE
4,12,2018,16,664,694,1358,2018-12-04 15:00:00,2018-04-12 00:00:00,LABORABLE
4,12,2018,17,633,758,1391,2018-12-04 16:00:00,2018-04-12 00:00:00,LABORABLE
4,12,2018,18,733,811,1544,2018-12-04 17:00:00,2018-04-12 00:00:00,LABORABLE
4,12,2018,19,720,816,1536,2018-12-04 18:00:00,2018-04-12 00:00:00,LABORABLE
4,12,2018,20,645,816,1461,2018-12-04 19:00:00,2018-04-12 00:00:00,LABORABLE
4,12,2018,21,641,755,1396,2018-12-04 20:00:00,2018-04-12 00:00:00,LABORABLE
4,12,2018,22,517,571,1088,2018-12-04 21:00:00,2018-04-12 00:00:00,LABORABLE
4,12,2018,23,394,462,856,2018-12-04 22:00:00,2018-04-12 00:00:00,LABORABLE
4,12,2018,24,238,391,629,2018-12-04 23:00:00,2018-04-12 00:00:00,LABORABLE
5,12,2018,1,170,306,476,2018-12-05 00:00:00,2018-05-12 00:00:00,LABORABLE
5,12,2018,2,114,215,329,2018-12-05 01:00:00,2018-05-12 00:00:00,LABORABLE
5,12,2018,3,86,136,222,2018-12-05 02:00:00,2018-05-12 00:00:00,LABORABLE
5,12,2018,4,68,105,173,2018-12-05 03:00:00,2018-05-12 00:00:00,LABORABLE
5,12,2018,5,71,97,168,2018-12-05 04:00:00,2018-05-12 00:00:00,LABORABLE
5,12,2018,6,156,188,344,2018-12-05 05:00:00,2018-05-12 00:00:00,LABORABLE
5,12,2018,7,445,407,852,2018-12-05 06:00:00,2018-05-12 00:00:00,LABORABLE
5,12,2018,8,636,653,1289,2018-12-05 07:00:00,2018-05-12 00:00:00,LABORABLE
5,12,2018,9,665,684,1349,2018-12-05 08:00:00,2018-05-12 00:00:00,LABORABLE
5,12,2018,10,673,730,1403,2018-12-05 09:00:00,2018-05-12 00:00:00,LABORABLE
5,12,2018,11,564,693,1257,2018-12-05 10:00:00,2018-05-12 00:00:00,LABORABLE
5,12,2018,12,602,760,1362,2018-12-05 11:00:00,2018-05-12 00:00:00,LABORABLE
5,12,2018,13,685,713,1398,2018-12-05 12:00:00,2018-05-12 00:00:00,LABORABLE
5,12,2018,14,679,755,1434,2018-12-05 13:00:00,2018-05-12 00:00:00,LABORABLE
5,12,2018,15,569,844,1413,2018-12-05 14:00:00,2018-05-12 00:00:00,LABORABLE
5,12,2018,16,672,672,1344,2018-12-05 15:00:00,2018-05-12 00:00:00,LABORABLE
5,12,2018,17,672,717,1389,2018-12-05 16:00:00,2018-05-12 00:00:00,LABORABLE
5,12,2018,18,669,781,1450,2018-12-05 17:00:00,2018-05-12 00:00:00,LABORABLE
5,12,2018,19,721,818,1539,2018-12-05 18:00:00,2018-05-12 00:00:00,LABORABLE
5,12,2018,20,643,823,1466,2018-12-05 19:00:00,2018-05-12 00:00:00,LABORABLE
5,12,2018,21,705,836,1541,2018-12-05 20:00:00,2018-05-12 00:00:00,LABORABLE
5,12,2018,22,607,726,1333,2018-12-05 21:00:00,2018-05-12 00:00:00,LABORABLE
5,12,2018,23,493,570,1063,2018-12-05 22:00:00,2018-05-12 00:00:00,LABORABLE
5,12,2018,24,324,505,829,2018-12-05 23:00:00,2018-05-12 00:00:00,LABORABLE
6,12,2018,1,276,362,638,2018-12-06 00:00:00,2018-06-12 00:00:00,FESTIVO
6,12,2018,2,183,310,493,2018-12-06 01:00:00,2018-06-12 00:00:00,FESTIVO
6,12,2018,3,158,278,436,2018-12-06 02:00:00,2018-06-12 00:00:00,FESTIVO
6,12,2018,4,123,204,327,2018-12-06 03:00:00,2018-06-12 00:00:00,FESTIVO
6,12,2018,5,106,185,291,2018-12-06 04:00:00,2018-06-12 00:00:00,FESTIVO
6,12,2018,6,116,187,303,2018-12-06 05:00:00,2018-06-12 00:00:00,FESTIVO
6,12,2018,7,213,234,447,2018-12-06 06:00:00,2018-06-12 00:00:00,FESTIVO
6,12,2018,8,246,241,487,2018-12-06 07:00:00,2018-06-12 00:00:00,FESTIVO
6,12,2018,9,328,352,680,2018-12-06 08:00:00,2018-06-12 00:00:00,FESTIVO
6,12,2018,10,413,426,839,2018-12-06 09:00:00,2018-06-12 00:00:00,FESTIVO
6,12,2018,11,471,505,976,2018-12-06 10:00:00,2018-06-12 00:00:00,FESTIVO
6,12,2018,12,555,561,1116,2018-12-06 11:00:00,2018-06-12 00:00:00,FESTIVO
6,12,2018,13,563,622,1185,2018-12-06 12:00:00,2018-06-12 00:00:00,FESTIVO
6,12,2018,14,596,599,1195,2018-12-06 13:00:00,2018-06-12 00:00:00,FESTIVO
6,12,2018,15,548,669,1217,2018-12-06 14:00:00,2018-06-12 00:00:00,FESTIVO
6,12,2018,16,413,616,1029,2018-12-06 15:00:00,2018-06-12 00:00:00,FESTIVO
6,12,2018,17,475,615,1090,2018-12-06 16:00:00,2018-06-12 00:00:00,FESTIVO
6,12,2018,18,559,675,1234,2018-12-06 17:00:00,2018-06-12 00:00:00,FESTIVO
6,12,2018,19,563,710,1273,2018-12-06 18:00:00,2018-06-12 00:00:00,FESTIVO
6,12,2018,20,546,748,1294,2018-12-06 19:00:00,2018-06-12 00:00:00,FESTIVO
6,12,2018,21,534,673,1207,2018-12-06 20:00:00,2018-06-12 00:00:00,FESTIVO
6,12,2018,22,454,573,1027,2018-12-06 21:00:00,2018-06-12 00:00:00,FESTIVO
6,12,2018,23,457,588,1045,2018-12-06 22:00:00,2018-06-12 00:00:00,FESTIVO
6,12,2018,24,316,479,795,2018-12-06 23:00:00,2018-06-12 00:00:00,FESTIVO
7,12,2018,1,234,332,566,2018-12-07 00:00:00,2018-07-12 00:00:00,LABORABLE
7,12,2018,2,143,264,407,2018-12-07 01:00:00,2018-07-12 00:00:00,LABORABLE
7,12,2018,3,132,212,344,2018-12-07 02:00:00,2018-07-12 00:00:00,LABORABLE
7,12,2018,4,99,156,255,2018-12-07 03:00:00,2018-07-12 00:00:00,LABORABLE
7,12,2018,5,87,131,218,2018-12-07 04:00:00,2018-07-12 00:00:00,LABORABLE
7,12,2018,6,141,194,335,2018-12-07 05:00:00,2018-07-12 00:00:00,LABORABLE
7,12,2018,7,326,310,636,2018-12-07 06:00:00,2018-07-12 00:00:00,LABORABLE
7,12,2018,8,456,441,897,2018-12-07 07:00:00,2018-07-12 00:00:00,LABORABLE
7,12,2018,9,461,568,1029,2018-12-07 08:00:00,2018-07-12 00:00:00,LABORABLE
7,12,2018,10,564,611,1175,2018-12-07 09:00:00,2018-07-12 00:00:00,LABORABLE
7,12,2018,11,566,655,1221,2018-12-07 10:00:00,2018-07-12 00:00:00,LABORABLE
7,12,2018,12,646,740,1386,2018-12-07 11:00:00,2018-07-12 00:00:00,LABORABLE
7,12,2018,13,678,751,1429,2018-12-07 12:00:00,2018-07-12 00:00:00,LABORABLE
7,12,2018,14,681,770,1451,2018-12-07 13:00:00,2018-07-12 00:00:00,LABORABLE
7,12,2018,15,641,715,1356,2018-12-07 14:00:00,2018-07-12 00:00:00,LABORABLE
7,12,2018,16,584,661,1245,2018-12-07 15:00:00,2018-07-12 00:00:00,LABORABLE
7,12,2018,17,608,741,1349,2018-12-07 16:00:00,2018-07-12 00:00:00,LABORABLE
7,12,2018,18,567,790,1357,2018-12-07 17:00:00,2018-07-12 00:00:00,LABORABLE
7,12,2018,19,638,777,1415,2018-12-07 18:00:00,2018-07-12 00:00:00,LABORABLE
7,12,2018,20,621,807,1428,2018-12-07 19:00:00,2018-07-12 00:00:00,LABORABLE
7,12,2018,21,582,805,1387,2018-12-07 20:00:00,2018-07-12 00:00:00,LABORABLE
7,12,2018,22,549,720,1269,2018-12-07 21:00:00,2018-07-12 00:00:00,LABORABLE
7,12,2018,23,467,585,1052,2018-12-07 22:00:00,2018-07-12 00:00:00,LABORABLE
7,12,2018,24,347,539,886,2018-12-07 23:00:00,2018-07-12 00:00:00,LABORABLE
8,12,2018,1,322,419,741,2018-12-08 00:00:00,2018-08-12 00:00:00,FESTIVO
8,12,2018,2,231,368,599,2018-12-08 01:00:00,2018-08-12 00:00:00,FESTIVO
8,12,2018,3,164,305,469,2018-12-08 02:00:00,2018-08-12 00:00:00,FESTIVO
8,12,2018,4,119,228,347,2018-12-08 03:00:00,2018-08-12 00:00:00,FESTIVO
8,12,2018,5,143,221,364,2018-12-08 04:00:00,2018-08-12 00:00:00,FESTIVO
8,12,2018,6,106,264,370,2018-12-08 05:00:00,2018-08-12 00:00:00,FESTIVO
8,12,2018,7,174,260,434,2018-12-08 06:00:00,2018-08-12 00:00:00,FESTIVO
8,12,2018,8,225,277,502,2018-12-08 07:00:00,2018-08-12 00:00:00,FESTIVO
8,12,2018,9,251,333,584,2018-12-08 08:00:00,2018-08-12 00:00:00,FESTIVO
8,12,2018,10,348,398,746,2018-12-08 09:00:00,2018-08-12 00:00:00,FESTIVO
8,12,2018,11,453,554,1007,2018-12-08 10:00:00,2018-08-12 00:00:00,FESTIVO
8,12,2018,12,567,640,1207,2018-12-08 11:00:00,2018-08-12 00:00:00,FESTIVO
8,12,2018,13,586,623,1209,2018-12-08 12:00:00,2018-08-12 00:00:00,FESTIVO
8,12,2018,14,621,697,1318,2018-12-08 13:00:00,2018-08-12 00:00:00,FESTIVO
8,12,2018,15,504,736,1240,2018-12-08 14:00:00,2018-08-12 00:00:00,FESTIVO
8,12,2018,16,501,631,1132,2018-12-08 15:00:00,2018-08-12 00:00:00,FESTIVO
8,12,2018,17,475,690,1165,2018-12-08 16:00:00,2018-08-12 00:00:00,FESTIVO
8,12,2018,18,492,753,1245,2018-12-08 17:00:00,2018-08-12 00:00:00,FESTIVO
8,12,2018,19,597,770,1367,2018-12-08 18:00:00,2018-08-12 00:00:00,FESTIVO
8,12,2018,20,599,743,1342,2018-12-08 19:00:00,2018-08-12 00:00:00,FESTIVO
8,12,2018,21,519,766,1285,2018-12-08 20:00:00,2018-08-12 00:00:00,FESTIVO
8,12,2018,22,528,628,1156,2018-12-08 21:00:00,2018-08-12 00:00:00,FESTIVO
8,12,2018,23,497,589,1086,2018-12-08 22:00:00,2018-08-12 00:00:00,FESTIVO
8,12,2018,24,406,574,980,2018-12-08 23:00:00,2018-08-12 00:00:00,FESTIVO
9,12,2018,1,335,524,859,2018-12-09 00:00:00,2018-09-12 00:00:00,DOMINGO
9,12,2018,2,280,399,679,2018-12-09 01:00:00,2018-09-12 00:00:00,DOMINGO
9,12,2018,3,206,371,577,2018-12-09 02:00:00,2018-09-12 00:00:00,DOMINGO
9,12,2018,4,212,313,525,2018-12-09 03:00:00,2018-09-12 00:00:00,DOMINGO
9,12,2018,5,153,302,455,2018-12-09 04:00:00,2018-09-12 00:00:00,DOMINGO
9,12,2018,6,141,257,398,2018-12-09 05:00:00,2018-09-12 00:00:00,DOMINGO
9,12,2018,7,178,320,498,2018-12-09 06:00:00,2018-09-12 00:00:00,DOMINGO
9,12,2018,8,169,239,408,2018-12-09 07:00:00,2018-09-12 00:00:00,DOMINGO
9,12,2018,9,205,270,475,2018-12-09 08:00:00,2018-09-12 00:00:00,DOMINGO
9,12,2018,10,307,395,702,2018-12-09 09:00:00,2018-09-12 00:00:00,DOMINGO
9,12,2018,11,412,446,858,2018-12-09 10:00:00,2018-09-12 00:00:00,DOMINGO
9,12,2018,12,456,529,985,2018-12-09 11:00:00,2018-09-12 00:00:00,DOMINGO
9,12,2018,13,516,598,1114,2018-12-09 12:00:00,2018-09-12 00:00:00,DOMINGO
9,12,2018,14,554,689,1243,2018-12-09 13:00:00,2018-09-12 00:00:00,DOMINGO
9,12,2018,15,565,699,1264,2018-12-09 14:00:00,2018-09-12 00:00:00,DOMINGO
9,12,2018,16,444,605,1049,2018-12-09 15:00:00,2018-09-12 00:00:00,DOMINGO
9,12,2018,17,499,702,1201,2018-12-09 16:00:00,2018-09-12 00:00:00,DOMINGO
9,12,2018,18,525,713,1238,2018-12-09 17:00:00,2018-09-12 00:00:00,DOMINGO
9,12,2018,19,527,777,1304,2018-12-09 18:00:00,2018-09-12 00:00:00,DOMINGO
9,12,2018,20,545,750,1295,2018-12-09 19:00:00,2018-09-12 00:00:00,DOMINGO
9,12,2018,21,534,646,1180,2018-12-09 20:00:00,2018-09-12 00:00:00,DOMINGO
9,12,2018,22,454,632,1086,2018-12-09 21:00:00,2018-09-12 00:00:00,DOMINGO
9,12,2018,23,392,485,877,2018-12-09 22:00:00,2018-09-12 00:00:00,DOMINGO
9,12,2018,24,287,469,756,2018-12-09 23:00:00,2018-09-12 00:00:00,DOMINGO
10,12,2018,1,196,308,504,2018-12-10 00:00:00,2018-10-12 00:00:00,LABORABLE
10,12,2018,2,111,223,334,2018-12-10 01:00:00,2018-10-12 00:00:00,LABORABLE
10,12,2018,3,84,166,250,2018-12-10 02:00:00,2018-10-12 00:00:00,LABORABLE
10,12,2018,4,88,142,230,2018-12-10 03:00:00,2018-10-12 00:00:00,LABORABLE
10,12,2018,5,78,124,202,2018-12-10 04:00:00,2018-10-12 00:00:00,LABORABLE
10,12,2018,6,158,196,354,2018-12-10 05:00:00,2018-10-12 00:00:00,LABORABLE
10,12,2018,7,441,418,859,2018-12-10 06:00:00,2018-10-12 00:00:00,LABORABLE
10,12,2018,8,676,690,1366,2018-12-10 07:00:00,2018-10-12 00:00:00,LABORABLE
10,12,2018,9,672,681,1353,2018-12-10 08:00:00,2018-10-12 00:00:00,LABORABLE
10,12,2018,10,633,725,1358,2018-12-10 09:00:00,2018-10-12 00:00:00,LABORABLE
10,12,2018,11,584,691,1275,2018-12-10 10:00:00,2018-10-12 00:00:00,LABORABLE
10,12,2018,12,600,716,1316,2018-12-10 11:00:00,2018-10-12 00:00:00,LABORABLE
10,12,2018,13,640,713,1353,2018-12-10 12:00:00,2018-10-12 00:00:00,LABORABLE
10,12,2018,14,631,682,1313,2018-12-10 13:00:00,2018-10-12 00:00:00,LABORABLE
10,12,2018,15,686,754,1440,2018-12-10 14:00:00,2018-10-12 00:00:00,LABORABLE
10,12,2018,16,642,684,1326,2018-12-10 15:00:00,2018-10-12 00:00:00,LABORABLE
10,12,2018,17,627,774,1401,2018-12-10 16:00:00,2018-10-12 00:00:00,LABORABLE
10,12,2018,18,677,786,1463,2018-12-10 17:00:00,2018-10-12 00:00:00,LABORABLE
10,12,2018,19,704,754,1458,2018-12-10 18:00:00,2018-10-12 00:00:00,LABORABLE
10,12,2018,20,649,749,1398,2018-12-10 19:00:00,2018-10-12 00:00:00,LABORABLE
10,12,2018,21,587,806,1393,2018-12-10 20:00:00,2018-10-12 00:00:00,LABORABLE
10,12,2018,22,509,572,1081,2018-12-10 21:00:00,2018-10-12 00:00:00,LABORABLE
10,12,2018,23,366,443,809,2018-12-10 22:00:00,2018-10-12 00:00:00,LABORABLE
10,12,2018,24,223,344,567,2018-12-10 23:00:00,2018-10-12 00:00:00,LABORABLE
11,12,2018,1,132,255,387,2018-12-11 00:00:00,2018-11-12 00:00:00,LABORABLE
11,12,2018,2,81,201,282,2018-12-11 01:00:00,2018-11-12 00:00:00,LABORABLE
11,12,2018,3,59,134,193,2018-12-11 02:00:00,2018-11-12 00:00:00,LABORABLE
11,12,2018,4,53,117,170,2018-12-11 03:00:00,2018-11-12 00:00:00,LABORABLE
11,12,2018,5,69,118,187,2018-12-11 04:00:00,2018-11-12 00:00:00,LABORABLE
11,12,2018,6,146,158,304,2018-12-11 05:00:00,2018-11-12 00:00:00,LABORABLE
11,12,2018,7,427,389,816,2018-12-11 06:00:00,2018-11-12 00:00:00,LABORABLE
11,12,2018,8,673,672,1345,2018-12-11 07:00:00,2018-11-12 00:00:00,LABORABLE
11,12,2018,9,689,690,1379,2018-12-11 08:00:00,2018-11-12 00:00:00,LABORABLE
11,12,2018,10,627,768,1395,2018-12-11 09:00:00,2018-11-12 00:00:00,LABORABLE
11,12,2018,11,457,529,986,2018-12-11 10:00:00,2018-11-12 00:00:00,LABORABLE
11,12,2018,12,589,683,1272,2018-12-11 11:00:00,2018-11-12 00:00:00,LABORABLE
11,12,2018,13,599,759,1358,2018-12-11 12:00:00,2018-11-12 00:00:00,LABORABLE
11,12,2018,14,632,708,1340,2018-12-11 13:00:00,2018-11-12 00:00:00,LABORABLE
11,12,2018,15,692,736,1428,2018-12-11 14:00:00,2018-11-12 00:00:00,LABORABLE
11,12,2018,16,700,670,1370,2018-12-11 15:00:00,2018-11-12 00:00:00,LABORABLE
11,12,2018,17,604,877,1481,2018-12-11 16:00:00,2018-11-12 00:00:00,LABORABLE
11,12,2018,18,734,730,1464,2018-12-11 17:00:00,2018-11-12 00:00:00,LABORABLE
11,12,2018,19,671,793,1464,2018-12-11 18:00:00,2018-11-12 00:00:00,LABORABLE
11,12,2018,20,660,775,1435,2018-12-11 19:00:00,2018-11-12 00:00:00,LABORABLE
11,12,2018,21,638,752,1390,2018-12-11 20:00:00,2018-11-12 00:00:00,LABORABLE
11,12,2018,22,497,602,1099,2018-12-11 21:00:00,2018-11-12 00:00:00,LABORABLE
11,12,2018,23,364,534,898,2018-12-11 22:00:00,2018-11-12 00:00:00,LABORABLE
11,12,2018,24,235,354,589,2018-12-11 23:00:00,2018-11-12 00:00:00,LABORABLE
12,12,2018,1,165,236,401,2018-12-12 00:00:00,2018-12-12 00:00:00,LABORABLE
12,12,2018,2,120,179,299,2018-12-12 01:00:00,2018-12-12 00:00:00,LABORABLE
12,12,2018,3,74,162,236,2018-12-12 02:00:00,2018-12-12 00:00:00,LABORABLE
12,12,2018,4,63,92,155,2018-12-12 03:00:00,2018-12-12 00:00:00,LABORABLE
12,12,2018,5,81,101,182,2018-12-12 04:00:00,2018-12-12 00:00:00,LABORABLE
12,12,2018,6,163,163,326,2018-12-12 05:00:00,2018-12-12 00:00:00,LABORABLE
12,12,2018,7,432,386,818,2018-12-12 06:00:00,2018-12-12 00:00:00,LABORABLE
12,12,2018,8,677,609,1286,2018-12-12 07:00:00,2018-12-12 00:00:00,LABORABLE
12,12,2018,9,715,685,1400,2018-12-12 08:00:00,2018-12-12 00:00:00,LABORABLE
12,12,2018,10,672,696,1368,2018-12-12 09:00:00,2018-12-12 00:00:00,LABORABLE
12,12,2018,11,559,672,1231,2018-12-12 10:00:00,2018-12-12 00:00:00,LABORABLE
12,12,2018,12,489,836,1325,2018-12-12 11:00:00,2018-12-12 00:00:00,LABORABLE
12,12,2018,13,619,767,1386,2018-12-12 12:00:00,2018-12-12 00:00:00,LABORABLE
12,12,2018,14,647,736,1383,2018-12-12 13:00:00,2018-12-12 00:00:00,LABORABLE
12,12,2018,15,711,701,1412,2018-12-12 14:00:00,2018-12-12 00:00:00,LABORABLE
12,12,2018,16,685,706,1391,2018-12-12 15:00:00,2018-12-12 00:00:00,LABORABLE
12,12,2018,17,650,704,1354,2018-12-12 16:00:00,2018-12-12 00:00:00,LABORABLE
12,12,2018,18,694,742,1436,2018-12-12 17:00:00,2018-12-12 00:00:00,LABORABLE
12,12,2018,19,720,795,1515,2018-12-12 18:00:00,2018-12-12 00:00:00,LABORABLE
12,12,2018,20,645,743,1388,2018-12-12 19:00:00,2018-12-12 00:00:00,LABORABLE
12,12,2018,21,654,724,1378,2018-12-12 20:00:00,2018-12-12 00:00:00,LABORABLE
12,12,2018,22,544,633,1177,2018-12-12 21:00:00,2018-12-12 00:00:00,LABORABLE
12,12,2018,23,439,453,892,2018-12-12 22:00:00,2018-12-12 00:00:00,LABORABLE
12,12,2018,24,246,375,621,2018-12-12 23:00:00,2018-12-12 00:00:00,LABORABLE
13,12,2018,1,205,292,497,2018-12-13 00:00:00,2018-12-13 00:00:00,LABORABLE
13,12,2018,2,122,214,336,2018-12-13 01:00:00,2018-12-13 00:00:00,LABORABLE
13,12,2018,3,96,182,278,2018-12-13 02:00:00,2018-12-13 00:00:00,LABORABLE
13,12,2018,4,62,129,191,2018-12-13 03:00:00,2018-12-13 00:00:00,LABORABLE
13,12,2018,5,75,137,212,2018-12-13 04:00:00,2018-12-13 00:00:00,LABORABLE
13,12,2018,6,159,170,329,2018-12-13 05:00:00,2018-12-13 00:00:00,LABORABLE
13,12,2018,7,435,408,843,2018-12-13 06:00:00,2018-12-13 00:00:00,LABORABLE
13,12,2018,8,662,636,1298,2018-12-13 07:00:00,2018-12-13 00:00:00,LABORABLE
13,12,2018,9,687,728,1415,2018-12-13 08:00:00,2018-12-13 00:00:00,LABORABLE
13,12,2018,10,624,717,1341,2018-12-13 09:00:00,2018-12-13 00:00:00,LABORABLE
13,12,2018,11,554,708,1262,2018-12-13 10:00:00,2018-12-13 00:00:00,LABORABLE
13,12,2018,12,614,694,1308,2018-12-13 11:00:00,2018-12-13 00:00:00,LABORABLE
13,12,2018,13,646,747,1393,2018-12-13 12:00:00,2018-12-13 00:00:00,LABORABLE
13,12,2018,14,642,717,1359,2018-12-13 13:00:00,2018-12-13 00:00:00,LABORABLE
13,12,2018,15,674,699,1373,2018-12-13 14:00:00,2018-12-13 00:00:00,LABORABLE
13,12,2018,16,650,693,1343,2018-12-13 15:00:00,2018-12-13 00:00:00,LABORABLE
13,12,2018,17,663,743,1406,2018-12-13 16:00:00,2018-12-13 00:00:00,LABORABLE
13,12,2018,18,714,792,1506,2018-12-13 17:00:00,2018-12-13 00:00:00,LABORABLE
13,12,2018,19,726,793,1519,2018-12-13 18:00:00,2018-12-13 00:00:00,LABORABLE
13,12,2018,20,684,780,1464,2018-12-13 19:00:00,2018-12-13 00:00:00,LABORABLE
13,12,2018,21,661,799,1460,2018-12-13 20:00:00,2018-12-13 00:00:00,LABORABLE
13,12,2018,22,574,608,1182,2018-12-13 21:00:00,2018-12-13 00:00:00,LABORABLE
13,12,2018,23,434,512,946,2018-12-13 22:00:00,2018-12-13 00:00:00,LABORABLE
13,12,2018,24,256,399,655,2018-12-13 23:00:00,2018-12-13 00:00:00,LABORABLE
14,12,2018,1,180,317,497,2018-12-14 00:00:00,2018-12-14 00:00:00,LABORABLE
14,12,2018,2,137,231,368,2018-12-14 01:00:00,2018-12-14 00:00:00,LABORABLE
14,12,2018,3,121,198,319,2018-12-14 02:00:00,2018-12-14 00:00:00,LABORABLE
14,12,2018,4,64,177,241,2018-12-14 03:00:00,2018-12-14 00:00:00,LABORABLE
14,12,2018,5,88,117,205,2018-12-14 04:00:00,2018-12-14 00:00:00,LABORABLE
14,12,2018,6,167,179,346,2018-12-14 05:00:00,2018-12-14 00:00:00,LABORABLE
14,12,2018,7,434,423,857,2018-12-14 06:00:00,2018-12-14 00:00:00,LABORABLE
14,12,2018,8,659,649,1308,2018-12-14 07:00:00,2018-12-14 00:00:00,LABORABLE
14,12,2018,9,700,706,1406,2018-12-14 08:00:00,2018-12-14 00:00:00,LABORABLE
14,12,2018,10,661,716,1377,2018-12-14 09:00:00,2018-12-14 00:00:00,LABORABLE
14,12,2018,11,573,669,1242,2018-12-14 10:00:00,2018-12-14 00:00:00,LABORABLE
14,12,2018,12,652,713,1365,2018-12-14 11:00:00,2018-12-14 00:00:00,LABORABLE
14,12,2018,13,715,744,1459,2018-12-14 12:00:00,2018-12-14 00:00:00,LABORABLE
14,12,2018,14,683,786,1469,2018-12-14 13:00:00,2018-12-14 00:00:00,LABORABLE
14,12,2018,15,715,795,1510,2018-12-14 14:00:00,2018-12-14 00:00:00,LABORABLE
14,12,2018,16,674,696,1370,2018-12-14 15:00:00,2018-12-14 00:00:00,LABORABLE
14,12,2018,17,682,735,1417,2018-12-14 16:00:00,2018-12-14 00:00:00,LABORABLE
14,12,2018,18,679,789,1468,2018-12-14 17:00:00,2018-12-14 00:00:00,LABORABLE
14,12,2018,19,676,848,1524,2018-12-14 18:00:00,2018-12-14 00:00:00,LABORABLE
14,12,2018,20,673,867,1540,2018-12-14 19:00:00,2018-12-14 00:00:00,LABORABLE
14,12,2018,21,706,816,1522,2018-12-14 20:00:00,2018-12-14 00:00:00,LABORABLE
14,12,2018,22,610,750,1360,2018-12-14 21:00:00,2018-12-14 00:00:00,LABORABLE
14,12,2018,23,504,610,1114,2018-12-14 22:00:00,2018-12-14 00:00:00,LABORABLE
14,12,2018,24,371,545,916,2018-12-14 23:00:00,2018-12-14 00:00:00,LABORABLE
15,12,2018,1,322,471,793,2018-12-15 00:00:00,2018-12-15 00:00:00,SÁBADO
15,12,2018,2,299,439,738,2018-12-15 01:00:00,2018-12-15 00:00:00,SÁBADO
15,12,2018,3,241,379,620,2018-12-15 02:00:00,2018-12-15 00:00:00,SÁBADO
15,12,2018,4,225,316,541,2018-12-15 03:00:00,2018-12-15 00:00:00,SÁBADO
15,12,2018,5,163,262,425,2018-12-15 04:00:00,2018-12-15 00:00:00,SÁBADO
15,12,2018,6,170,257,427,2018-12-15 05:00:00,2018-12-15 00:00:00,SÁBADO
15,12,2018,7,222,300,522,2018-12-15 06:00:00,2018-12-15 00:00:00,SÁBADO
15,12,2018,8,304,313,617,2018-12-15 07:00:00,2018-12-15 00:00:00,SÁBADO
15,12,2018,9,361,389,750,2018-12-15 08:00:00,2018-12-15 00:00:00,SÁBADO
15,12,2018,10,435,542,977,2018-12-15 09:00:00,2018-12-15 00:00:00,SÁBADO
15,12,2018,11,612,598,1210,2018-12-15 10:00:00,2018-12-15 00:00:00,SÁBADO
15,12,2018,12,639,719,1358,2018-12-15 11:00:00,2018-12-15 00:00:00,SÁBADO
15,12,2018,13,700,753,1453,2018-12-15 12:00:00,2018-12-15 00:00:00,SÁBADO
15,12,2018,14,714,824,1538,2018-12-15 13:00:00,2018-12-15 00:00:00,SÁBADO
15,12,2018,15,698,794,1492,2018-12-15 14:00:00,2018-12-15 00:00:00,SÁBADO
15,12,2018,16,574,813,1387,2018-12-15 15:00:00,2018-12-15 00:00:00,SÁBADO
15,12,2018,17,525,725,1250,2018-12-15 16:00:00,2018-12-15 00:00:00,SÁBADO
15,12,2018,18,620,832,1452,2018-12-15 17:00:00,2018-12-15 00:00:00,SÁBADO
15,12,2018,19,631,798,1429,2018-12-15 18:00:00,2018-12-15 00:00:00,SÁBADO
15,12,2018,20,619,791,1410,2018-12-15 19:00:00,2018-12-15 00:00:00,SÁBADO
15,12,2018,21,615,794,1409,2018-12-15 20:00:00,2018-12-15 00:00:00,SÁBADO
15,12,2018,22,599,717,1316,2018-12-15 21:00:00,2018-12-15 00:00:00,SÁBADO
15,12,2018,23,555,642,1197,2018-12-15 22:00:00,2018-12-15 00:00:00,SÁBADO
15,12,2018,24,418,591,1009,2018-12-15 23:00:00,2018-12-15 00:00:00,SÁBADO
16,12,2018,1,382,567,949,2018-12-16 00:00:00,2018-12-16 00:00:00,DOMINGO
16,12,2018,2,305,456,761,2018-12-16 01:00:00,2018-12-16 00:00:00,DOMINGO
16,12,2018,3,290,426,716,2018-12-16 02:00:00,2018-12-16 00:00:00,DOMINGO
16,12,2018,4,235,374,609,2018-12-16 03:00:00,2018-12-16 00:00:00,DOMINGO
16,12,2018,5,189,361,550,2018-12-16 04:00:00,2018-12-16 00:00:00,DOMINGO
16,12,2018,6,162,290,452,2018-12-16 05:00:00,2018-12-16 00:00:00,DOMINGO
16,12,2018,7,211,332,543,2018-12-16 06:00:00,2018-12-16 00:00:00,DOMINGO
16,12,2018,8,203,276,479,2018-12-16 07:00:00,2018-12-16 00:00:00,DOMINGO
16,12,2018,9,227,282,509,2018-12-16 08:00:00,2018-12-16 00:00:00,DOMINGO
16,12,2018,10,311,380,691,2018-12-16 09:00:00,2018-12-16 00:00:00,DOMINGO
16,12,2018,11,408,499,907,2018-12-16 10:00:00,2018-12-16 00:00:00,DOMINGO
16,12,2018,12,519,550,1069,2018-12-16 11:00:00,2018-12-16 00:00:00,DOMINGO
16,12,2018,13,583,618,1201,2018-12-16 12:00:00,2018-12-16 00:00:00,DOMINGO
16,12,2018,14,642,721,1363,2018-12-16 13:00:00,2018-12-16 00:00:00,DOMINGO
16,12,2018,15,566,696,1262,2018-12-16 14:00:00,2018-12-16 00:00:00,DOMINGO
16,12,2018,16,556,611,1167,2018-12-16 15:00:00,2018-12-16 00:00:00,DOMINGO
16,12,2018,17,505,655,1160,2018-12-16 16:00:00,2018-12-16 00:00:00,DOMINGO
16,12,2018,18,596,782,1378,2018-12-16 17:00:00,2018-12-16 00:00:00,DOMINGO
16,12,2018,19,586,746,1332,2018-12-16 18:00:00,2018-12-16 00:00:00,DOMINGO
16,12,2018,20,595,732,1327,2018-12-16 19:00:00,2018-12-16 00:00:00,DOMINGO
16,12,2018,21,549,689,1238,2018-12-16 20:00:00,2018-12-16 00:00:00,DOMINGO
16,12,2018,22,505,613,1118,2018-12-16 21:00:00,2018-12-16 00:00:00,DOMINGO
16,12,2018,23,410,502,912,2018-12-16 22:00:00,2018-12-16 00:00:00,DOMINGO
16,12,2018,24,267,377,644,2018-12-16 23:00:00,2018-12-16 00:00:00,DOMINGO
17,12,2018,1,186,274,460,2018-12-17 00:00:00,2018-12-17 00:00:00,LABORABLE
17,12,2018,2,96,221,317,2018-12-17 01:00:00,2018-12-17 00:00:00,LABORABLE
17,12,2018,3,86,150,236,2018-12-17 02:00:00,2018-12-17 00:00:00,LABORABLE
17,12,2018,4,70,122,192,2018-12-17 03:00:00,2018-12-17 00:00:00,LABORABLE
17,12,2018,5,73,107,180,2018-12-17 04:00:00,2018-12-17 00:00:00,LABORABLE
17,12,2018,6,156,174,330,2018-12-17 05:00:00,2018-12-17 00:00:00,LABORABLE
17,12,2018,7,454,416,870,2018-12-17 06:00:00,2018-12-17 00:00:00,LABORABLE
17,12,2018,8,665,687,1352,2018-12-17 07:00:00,2018-12-17 00:00:00,LABORABLE
17,12,2018,9,685,683,1368,2018-12-17 08:00:00,2018-12-17 00:00:00,LABORABLE
17,12,2018,10,602,813,1415,2018-12-17 09:00:00,2018-12-17 00:00:00,LABORABLE
17,12,2018,11,568,658,1226,2018-12-17 10:00:00,2018-12-17 00:00:00,LABORABLE
17,12,2018,12,629,728,1357,2018-12-17 11:00:00,2018-12-17 00:00:00,LABORABLE
17,12,2018,13,730,745,1475,2018-12-17 12:00:00,2018-12-17 00:00:00,LABORABLE
17,12,2018,14,566,785,1351,2018-12-17 13:00:00,2018-12-17 00:00:00,LABORABLE
17,12,2018,15,644,767,1411,2018-12-17 14:00:00,2018-12-17 00:00:00,LABORABLE
17,12,2018,16,665,705,1370,2018-12-17 15:00:00,2018-12-17 00:00:00,LABORABLE
17,12,2018,17,655,704,1359,2018-12-17 16:00:00,2018-12-17 00:00:00,LABORABLE
17,12,2018,18,721,864,1585,2018-12-17 17:00:00,2018-12-17 00:00:00,LABORABLE
17,12,2018,19,679,828,1507,2018-12-17 18:00:00,2018-12-17 00:00:00,LABORABLE
17,12,2018,20,614,799,1413,2018-12-17 19:00:00,2018-12-17 00:00:00,LABORABLE
17,12,2018,21,618,783,1401,2018-12-17 20:00:00,2018-12-17 00:00:00,LABORABLE
17,12,2018,22,507,576,1083,2018-12-17 21:00:00,2018-12-17 00:00:00,LABORABLE
17,12,2018,23,330,474,804,2018-12-17 22:00:00,2018-12-17 00:00:00,LABORABLE
17,12,2018,24,220,311,531,2018-12-17 23:00:00,2018-12-17 00:00:00,LABORABLE
18,12,2018,1,163,226,389,2018-12-18 00:00:00,2018-12-18 00:00:00,LABORABLE
18,12,2018,2,110,194,304,2018-12-18 01:00:00,2018-12-18 00:00:00,LABORABLE
18,12,2018,3,74,160,234,2018-12-18 02:00:00,2018-12-18 00:00:00,LABORABLE
18,12,2018,4,50,94,144,2018-12-18 03:00:00,2018-12-18 00:00:00,LABORABLE
18,12,2018,5,85,113,198,2018-12-18 04:00:00,2018-12-18 00:00:00,LABORABLE
18,12,2018,6,146,182,328,2018-12-18 05:00:00,2018-12-18 00:00:00,LABORABLE
18,12,2018,7,449,399,848,2018-12-18 06:00:00,2018-12-18 00:00:00,LABORABLE
18,12,2018,8,660,658,1318,2018-12-18 07:00:00,2018-12-18 00:00:00,LABORABLE
18,12,2018,9,707,714,1421,2018-12-18 08:00:00,2018-12-18 00:00:00,LABORABLE
18,12,2018,10,670,719,1389,2018-12-18 09:00:00,2018-12-18 00:00:00,LABORABLE
18,12,2018,11,581,674,1255,2018-12-18 10:00:00,2018-12-18 00:00:00,LABORABLE
18,12,2018,12,483,614,1097,2018-12-18 11:00:00,2018-12-18 00:00:00,LABORABLE
18,12,2018,13,634,755,1389,2018-12-18 12:00:00,2018-12-18 00:00:00,LABORABLE
18,12,2018,14,667,757,1424,2018-12-18 13:00:00,2018-12-18 00:00:00,LABORABLE
18,12,2018,15,672,750,1422,2018-12-18 14:00:00,2018-12-18 00:00:00,LABORABLE
18,12,2018,16,637,695,1332,2018-12-18 15:00:00,2018-12-18 00:00:00,LABORABLE
18,12,2018,17,621,782,1403,2018-12-18 16:00:00,2018-12-18 00:00:00,LABORABLE
18,12,2018,18,770,806,1576,2018-12-18 17:00:00,2018-12-18 00:00:00,LABORABLE
18,12,2018,19,698,816,1514,2018-12-18 18:00:00,2018-12-18 00:00:00,LABORABLE
18,12,2018,20,665,800,1465,2018-12-18 19:00:00,2018-12-18 00:00:00,LABORABLE
18,12,2018,21,669,770,1439,2018-12-18 20:00:00,2018-12-18 00:00:00,LABORABLE
18,12,2018,22,537,619,1156,2018-12-18 21:00:00,2018-12-18 00:00:00,LABORABLE
18,12,2018,23,381,441,822,2018-12-18 22:00:00,2018-12-18 00:00:00,LABORABLE
18,12,2018,24,243,392,635,2018-12-18 23:00:00,2018-12-18 00:00:00,LABORABLE
19,12,2018,1,153,266,419,2018-12-19 00:00:00,2018-12-19 00:00:00,LABORABLE
19,12,2018,2,127,189,316,2018-12-19 01:00:00,2018-12-19 00:00:00,LABORABLE
19,12,2018,3,76,135,211,2018-12-19 02:00:00,2018-12-19 00:00:00,LABORABLE
19,12,2018,4,72,134,206,2018-12-19 03:00:00,2018-12-19 00:00:00,LABORABLE
19,12,2018,5,72,102,174,2018-12-19 04:00:00,2018-12-19 00:00:00,LABORABLE
19,12,2018,6,138,151,289,2018-12-19 05:00:00,2018-12-19 00:00:00,LABORABLE
19,12,2018,7,436,409,845,2018-12-19 06:00:00,2018-12-19 00:00:00,LABORABLE
19,12,2018,8,621,597,1218,2018-12-19 07:00:00,2018-12-19 00:00:00,LABORABLE
19,12,2018,9,687,697,1384,2018-12-19 08:00:00,2018-12-19 00:00:00,LABORABLE
19,12,2018,10,695,725,1420,2018-12-19 09:00:00,2018-12-19 00:00:00,LABORABLE
19,12,2018,11,620,713,1333,2018-12-19 10:00:00,2018-12-19 00:00:00,LABORABLE
19,12,2018,12,515,829,1344,2018-12-19 11:00:00,2018-12-19 00:00:00,LABORABLE
19,12,2018,13,611,737,1348,2018-12-19 12:00:00,2018-12-19 00:00:00,LABORABLE
19,12,2018,14,685,762,1447,2018-12-19 13:00:00,2018-12-19 00:00:00,LABORABLE
19,12,2018,15,672,734,1406,2018-12-19 14:00:00,2018-12-19 00:00:00,LABORABLE
19,12,2018,16,627,726,1353,2018-12-19 15:00:00,2018-12-19 00:00:00,LABORABLE
19,12,2018,17,692,759,1451,2018-12-19 16:00:00,2018-12-19 00:00:00,LABORABLE
19,12,2018,18,716,775,1491,2018-12-19 17:00:00,2018-12-19 00:00:00,LABORABLE
19,12,2018,19,688,801,1489,2018-12-19 18:00:00,2018-12-19 00:00:00,LABORABLE
19,12,2018,20,699,816,1515,2018-12-19 19:00:00,2018-12-19 00:00:00,LABORABLE
19,12,2018,21,622,758,1380,2018-12-19 20:00:00,2018-12-19 00:00:00,LABORABLE
19,12,2018,22,516,716,1232,2018-12-19 21:00:00,2018-12-19 00:00:00,LABORABLE
19,12,2018,23,400,480,880,2018-12-19 22:00:00,2018-12-19 00:00:00,LABORABLE
19,12,2018,24,234,401,635,2018-12-19 23:00:00,2018-12-19 00:00:00,LABORABLE
20,12,2018,1,197,331,528,2018-12-20 00:00:00,2018-12-20 00:00:00,LABORABLE
20,12,2018,2,147,226,373,2018-12-20 01:00:00,2018-12-20 00:00:00,LABORABLE
20,12,2018,3,113,177,290,2018-12-20 02:00:00,2018-12-20 00:00:00,LABORABLE
20,12,2018,4,77,126,203,2018-12-20 03:00:00,2018-12-20 00:00:00,LABORABLE
20,12,2018,5,95,124,219,2018-12-20 04:00:00,2018-12-20 00:00:00,LABORABLE
20,12,2018,6,155,165,320,2018-12-20 05:00:00,2018-12-20 00:00:00,LABORABLE
20,12,2018,7,412,424,836,2018-12-20 06:00:00,2018-12-20 00:00:00,LABORABLE
20,12,2018,8,736,617,1353,2018-12-20 07:00:00,2018-12-20 00:00:00,LABORABLE
20,12,2018,9,756,706,1462,2018-12-20 08:00:00,2018-12-20 00:00:00,LABORABLE
20,12,2018,10,652,746,1398,2018-12-20 09:00:00,2018-12-20 00:00:00,LABORABLE
20,12,2018,11,675,696,1371,2018-12-20 10:00:00,2018-12-20 00:00:00,LABORABLE
20,12,2018,12,619,721,1340,2018-12-20 11:00:00,2018-12-20 00:00:00,LABORABLE
20,12,2018,13,699,774,1473,2018-12-20 12:00:00,2018-12-20 00:00:00,LABORABLE
20,12,2018,14,687,815,1502,2018-12-20 13:00:00,2018-12-20 00:00:00,LABORABLE
20,12,2018,15,705,768,1473,2018-12-20 14:00:00,2018-12-20 00:00:00,LABORABLE
20,12,2018,16,711,720,1431,2018-12-20 15:00:00,2018-12-20 00:00:00,LABORABLE
20,12,2018,17,674,762,1436,2018-12-20 16:00:00,2018-12-20 00:00:00,LABORABLE
20,12,2018,18,758,819,1577,2018-12-20 17:00:00,2018-12-20 00:00:00,LABORABLE
20,12,2018,19,691,781,1472,2018-12-20 18:00:00,2018-12-20 00:00:00,LABORABLE
20,12,2018,20,691,788,1479,2018-12-20 19:00:00,2018-12-20 00:00:00,LABORABLE
20,12,2018,21,690,788,1478,2018-12-20 20:00:00,2018-12-20 00:00:00,LABORABLE
20,12,2018,22,646,705,1351,2018-12-20 21:00:00,2018-12-20 00:00:00,LABORABLE
20,12,2018,23,469,586,1055,2018-12-20 22:00:00,2018-12-20 00:00:00,LABORABLE
20,12,2018,24,331,426,757,2018-12-20 23:00:00,2018-12-20 00:00:00,LABORABLE
21,12,2018,1,248,396,644,2018-12-21 00:00:00,2018-12-21 00:00:00,LABORABLE
21,12,2018,2,167,325,492,2018-12-21 01:00:00,2018-12-21 00:00:00,LABORABLE
21,12,2018,3,142,210,352,2018-12-21 02:00:00,2018-12-21 00:00:00,LABORABLE
21,12,2018,4,101,194,295,2018-12-21 03:00:00,2018-12-21 00:00:00,LABORABLE
21,12,2018,5,130,139,269,2018-12-21 04:00:00,2018-12-21 00:00:00,LABORABLE
21,12,2018,6,174,190,364,2018-12-21 05:00:00,2018-12-21 00:00:00,LABORABLE
21,12,2018,7,403,406,809,2018-12-21 06:00:00,2018-12-21 00:00:00,LABORABLE
21,12,2018,8,630,582,1212,2018-12-21 07:00:00,2018-12-21 00:00:00,LABORABLE
21,12,2018,9,643,676,1319,2018-12-21 08:00:00,2018-12-21 00:00:00,LABORABLE
21,12,2018,10,711,691,1402,2018-12-21 09:00:00,2018-12-21 00:00:00,LABORABLE
21,12,2018,11,634,699,1333,2018-12-21 10:00:00,2018-12-21 00:00:00,LABORABLE
21,12,2018,12,675,747,1422,2018-12-21 11:00:00,2018-12-21 00:00:00,LABORABLE
21,12,2018,13,735,779,1514,2018-12-21 12:00:00,2018-12-21 00:00:00,LABORABLE
21,12,2018,14,737,799,1536,2018-12-21 13:00:00,2018-12-21 00:00:00,LABORABLE
21,12,2018,15,571,811,1382,2018-12-21 14:00:00,2018-12-21 00:00:00,LABORABLE
21,12,2018,16,692,766,1458,2018-12-21 15:00:00,2018-12-21 00:00:00,LABORABLE
21,12,2018,17,675,777,1452,2018-12-21 16:00:00,2018-12-21 00:00:00,LABORABLE
21,12,2018,18,723,744,1467,2018-12-21 17:00:00,2018-12-21 00:00:00,LABORABLE
21,12,2018,19,731,913,1644,2018-12-21 18:00:00,2018-12-21 00:00:00,LABORABLE
21,12,2018,20,682,870,1552,2018-12-21 19:00:00,2018-12-21 00:00:00,LABORABLE
21,12,2018,21,704,838,1542,2018-12-21 20:00:00,2018-12-21 00:00:00,LABORABLE
21,12,2018,22,672,807,1479,2018-12-21 21:00:00,2018-12-21 00:00:00,LABORABLE
21,12,2018,23,523,648,1171,2018-12-21 22:00:00,2018-12-21 00:00:00,LABORABLE
21,12,2018,24,438,555,993,2018-12-21 23:00:00,2018-12-21 00:00:00,LABORABLE
22,12,2018,1,322,502,824,2018-12-22 00:00:00,2018-12-22 00:00:00,SÁBADO
22,12,2018,2,267,429,696,2018-12-22 01:00:00,2018-12-22 00:00:00,SÁBADO
22,12,2018,3,239,362,601,2018-12-22 02:00:00,2018-12-22 00:00:00,SÁBADO
22,12,2018,4,174,290,464,2018-12-22 03:00:00,2018-12-22 00:00:00,SÁBADO
22,12,2018,5,162,255,417,2018-12-22 04:00:00,2018-12-22 00:00:00,SÁBADO
22,12,2018,6,169,256,425,2018-12-22 05:00:00,2018-12-22 00:00:00,SÁBADO
22,12,2018,7,216,270,486,2018-12-22 06:00:00,2018-12-22 00:00:00,SÁBADO
22,12,2018,8,274,284,558,2018-12-22 07:00:00,2018-12-22 00:00:00,SÁBADO
22,12,2018,9,335,390,725,2018-12-22 08:00:00,2018-12-22 00:00:00,SÁBADO
22,12,2018,10,447,507,954,2018-12-22 09:00:00,2018-12-22 00:00:00,SÁBADO
22,12,2018,11,562,603,1165,2018-12-22 10:00:00,2018-12-22 00:00:00,SÁBADO
22,12,2018,12,625,770,1395,2018-12-22 11:00:00,2018-12-22 00:00:00,SÁBADO
22,12,2018,13,708,740,1448,2018-12-22 12:00:00,2018-12-22 00:00:00,SÁBADO
22,12,2018,14,702,788,1490,2018-12-22 13:00:00,2018-12-22 00:00:00,SÁBADO
22,12,2018,15,658,804,1462,2018-12-22 14:00:00,2018-12-22 00:00:00,SÁBADO
22,12,2018,16,567,702,1269,2018-12-22 15:00:00,2018-12-22 00:00:00,SÁBADO
22,12,2018,17,518,759,1277,2018-12-22 16:00:00,2018-12-22 00:00:00,SÁBADO
22,12,2018,18,576,822,1398,2018-12-22 17:00:00,2018-12-22 00:00:00,SÁBADO
22,12,2018,19,669,852,1521,2018-12-22 18:00:00,2018-12-22 00:00:00,SÁBADO
22,12,2018,20,657,769,1426,2018-12-22 19:00:00,2018-12-22 00:00:00,SÁBADO
22,12,2018,21,587,776,1363,2018-12-22 20:00:00,2018-12-22 00:00:00,SÁBADO
22,12,2018,22,594,727,1321,2018-12-22 21:00:00,2018-12-22 00:00:00,SÁBADO
22,12,2018,23,562,708,1270,2018-12-22 22:00:00,2018-12-22 00:00:00,SÁBADO
22,12,2018,24,432,610,1042,2018-12-22 23:00:00,2018-12-22 00:00:00,SÁBADO
23,12,2018,1,362,528,890,2018-12-23 00:00:00,2018-12-23 00:00:00,DOMINGO
23,12,2018,2,282,463,745,2018-12-23 01:00:00,2018-12-23 00:00:00,DOMINGO
23,12,2018,3,250,418,668,2018-12-23 02:00:00,2018-12-23 00:00:00,DOMINGO
23,12,2018,4,193,352,545,2018-12-23 03:00:00,2018-12-23 00:00:00,DOMINGO
23,12,2018,5,142,281,423,2018-12-23 04:00:00,2018-12-23 00:00:00,DOMINGO
23,12,2018,6,154,282,436,2018-12-23 05:00:00,2018-12-23 00:00:00,DOMINGO
23,12,2018,7,199,306,505,2018-12-23 06:00:00,2018-12-23 00:00:00,DOMINGO
23,12,2018,8,200,248,448,2018-12-23 07:00:00,2018-12-23 00:00:00,DOMINGO
23,12,2018,9,226,272,498,2018-12-23 08:00:00,2018-12-23 00:00:00,DOMINGO
23,12,2018,10,349,405,754,2018-12-23 09:00:00,2018-12-23 00:00:00,DOMINGO
23,12,2018,11,388,511,899,2018-12-23 10:00:00,2018-12-23 00:00:00,DOMINGO
23,12,2018,12,525,609,1134,2018-12-23 11:00:00,2018-12-23 00:00:00,DOMINGO
23,12,2018,13,623,743,1366,2018-12-23 12:00:00,2018-12-23 00:00:00,DOMINGO
23,12,2018,14,623,814,1437,2018-12-23 13:00:00,2018-12-23 00:00:00,DOMINGO
23,12,2018,15,567,725,1292,2018-12-23 14:00:00,2018-12-23 00:00:00,DOMINGO
23,12,2018,16,524,724,1248,2018-12-23 15:00:00,2018-12-23 00:00:00,DOMINGO
23,12,2018,17,478,707,1185,2018-12-23 16:00:00,2018-12-23 00:00:00,DOMINGO
23,12,2018,18,585,796,1381,2018-12-23 17:00:00,2018-12-23 00:00:00,DOMINGO
23,12,2018,19,590,841,1431,2018-12-23 18:00:00,2018-12-23 00:00:00,DOMINGO
23,12,2018,20,577,781,1358,2018-12-23 19:00:00,2018-12-23 00:00:00,DOMINGO
23,12,2018,21,510,724,1234,2018-12-23 20:00:00,2018-12-23 00:00:00,DOMINGO
23,12,2018,22,461,675,1136,2018-12-23 21:00:00,2018-12-23 00:00:00,DOMINGO
23,12,2018,23,463,579,1042,2018-12-23 22:00:00,2018-12-23 00:00:00,DOMINGO
23,12,2018,24,319,456,775,2018-12-23 23:00:00,2018-12-23 00:00:00,DOMINGO
24,12,2018,1,245,391,636,2018-12-24 00:00:00,2018-12-24 00:00:00,LABORABLE
24,12,2018,2,145,239,384,2018-12-24 01:00:00,2018-12-24 00:00:00,LABORABLE
24,12,2018,3,116,204,320,2018-12-24 02:00:00,2018-12-24 00:00:00,LABORABLE
24,12,2018,4,69,164,233,2018-12-24 03:00:00,2018-12-24 00:00:00,LABORABLE
24,12,2018,5,84,119,203,2018-12-24 04:00:00,2018-12-24 00:00:00,LABORABLE
24,12,2018,6,143,156,299,2018-12-24 05:00:00,2018-12-24 00:00:00,LABORABLE
24,12,2018,7,305,376,681,2018-12-24 06:00:00,2018-12-24 00:00:00,LABORABLE
24,12,2018,8,521,568,1089,2018-12-24 07:00:00,2018-12-24 00:00:00,LABORABLE
24,12,2018,9,599,699,1298,2018-12-24 08:00:00,2018-12-24 00:00:00,LABORABLE
24,12,2018,10,475,789,1264,2018-12-24 09:00:00,2018-12-24 00:00:00,LABORABLE
24,12,2018,11,575,693,1268,2018-12-24 10:00:00,2018-12-24 00:00:00,LABORABLE
24,12,2018,12,682,819,1501,2018-12-24 11:00:00,2018-12-24 00:00:00,LABORABLE
24,12,2018,13,689,801,1490,2018-12-24 12:00:00,2018-12-24 00:00:00,LABORABLE
24,12,2018,14,756,842,1598,2018-12-24 13:00:00,2018-12-24 00:00:00,LABORABLE
24,12,2018,15,691,871,1562,2018-12-24 14:00:00,2018-12-24 00:00:00,LABORABLE
24,12,2018,16,582,804,1386,2018-12-24 15:00:00,2018-12-24 00:00:00,LABORABLE
24,12,2018,17,548,786,1334,2018-12-24 16:00:00,2018-12-24 00:00:00,LABORABLE
24,12,2018,18,564,841,1405,2018-12-24 17:00:00,2018-12-24 00:00:00,LABORABLE
24,12,2018,19,699,857,1556,2018-12-24 18:00:00,2018-12-24 00:00:00,LABORABLE
24,12,2018,20,808,841,1649,2018-12-24 19:00:00,2018-12-24 00:00:00,LABORABLE
24,12,2018,21,735,866,1601,2018-12-24 20:00:00,2018-12-24 00:00:00,LABORABLE
24,12,2018,22,522,612,1134,2018-12-24 21:00:00,2018-12-24 00:00:00,LABORABLE
24,12,2018,23,300,495,795,2018-12-24 22:00:00,2018-12-24 00:00:00,LABORABLE
24,12,2018,24,360,445,805,2018-12-24 23:00:00,2018-12-24 00:00:00,LABORABLE
25,12,2018,1,596,636,1232,2018-12-25 00:00:00,2018-12-25 00:00:00,FESTIVO
25,12,2018,2,556,580,1136,2018-12-25 01:00:00,2018-12-25 00:00:00,FESTIVO
25,12,2018,3,438,479,917,2018-12-25 02:00:00,2018-12-25 00:00:00,FESTIVO
25,12,2018,4,296,373,669,2018-12-25 03:00:00,2018-12-25 00:00:00,FESTIVO
25,12,2018,5,202,283,485,2018-12-25 04:00:00,2018-12-25 00:00:00,FESTIVO
25,12,2018,6,157,240,397,2018-12-25 05:00:00,2018-12-25 00:00:00,FESTIVO
25,12,2018,7,171,245,416,2018-12-25 06:00:00,2018-12-25 00:00:00,FESTIVO
25,12,2018,8,184,217,401,2018-12-25 07:00:00,2018-12-25 00:00:00,FESTIVO
25,12,2018,9,123,178,301,2018-12-25 08:00:00,2018-12-25 00:00:00,FESTIVO
25,12,2018,10,147,185,332,2018-12-25 09:00:00,2018-12-25 00:00:00,FESTIVO
25,12,2018,11,182,231,413,2018-12-25 10:00:00,2018-12-25 00:00:00,FESTIVO
25,12,2018,12,242,382,624,2018-12-25 11:00:00,2018-12-25 00:00:00,FESTIVO
25,12,2018,13,402,460,862,2018-12-25 12:00:00,2018-12-25 00:00:00,FESTIVO
25,12,2018,14,577,623,1200,2018-12-25 13:00:00,2018-12-25 00:00:00,FESTIVO
25,12,2018,15,541,533,1074,2018-12-25 14:00:00,2018-12-25 00:00:00,FESTIVO
25,12,2018,16,381,538,919,2018-12-25 15:00:00,2018-12-25 00:00:00,FESTIVO
25,12,2018,17,402,562,964,2018-12-25 16:00:00,2018-12-25 00:00:00,FESTIVO
25,12,2018,18,538,643,1181,2018-12-25 17:00:00,2018-12-25 00:00:00,FESTIVO
25,12,2018,19,619,726,1345,2018-12-25 18:00:00,2018-12-25 00:00:00,FESTIVO
25,12,2018,20,610,732,1342,2018-12-25 19:00:00,2018-12-25 00:00:00,FESTIVO
25,12,2018,21,558,636,1194,2018-12-25 20:00:00,2018-12-25 00:00:00,FESTIVO
25,12,2018,22,422,573,995,2018-12-25 21:00:00,2018-12-25 00:00:00,FESTIVO
25,12,2018,23,346,418,764,2018-12-25 22:00:00,2018-12-25 00:00:00,FESTIVO
25,12,2018,24,265,372,637,2018-12-25 23:00:00,2018-12-25 00:00:00,FESTIVO
26,12,2018,1,156,274,430,2018-12-26 00:00:00,2018-12-26 00:00:00,LABORABLE
26,12,2018,2,95,179,274,2018-12-26 01:00:00,2018-12-26 00:00:00,LABORABLE
26,12,2018,3,77,171,248,2018-12-26 02:00:00,2018-12-26 00:00:00,LABORABLE
26,12,2018,4,59,116,175,2018-12-26 03:00:00,2018-12-26 00:00:00,LABORABLE
26,12,2018,5,62,110,172,2018-12-26 04:00:00,2018-12-26 00:00:00,LABORABLE
26,12,2018,6,143,156,299,2018-12-26 05:00:00,2018-12-26 00:00:00,LABORABLE
26,12,2018,7,321,352,673,2018-12-26 06:00:00,2018-12-26 00:00:00,LABORABLE
26,12,2018,8,530,461,991,2018-12-26 07:00:00,2018-12-26 00:00:00,LABORABLE
26,12,2018,9,616,572,1188,2018-12-26 08:00:00,2018-12-26 00:00:00,LABORABLE
26,12,2018,10,530,619,1149,2018-12-26 09:00:00,2018-12-26 00:00:00,LABORABLE
26,12,2018,11,553,676,1229,2018-12-26 10:00:00,2018-12-26 00:00:00,LABORABLE
26,12,2018,12,618,791,1409,2018-12-26 11:00:00,2018-12-26 00:00:00,LABORABLE
26,12,2018,13,623,720,1343,2018-12-26 12:00:00,2018-12-26 00:00:00,LABORABLE
26,12,2018,14,641,731,1372,2018-12-26 13:00:00,2018-12-26 00:00:00,LABORABLE
26,12,2018,15,636,764,1400,2018-12-26 14:00:00,2018-12-26 00:00:00,LABORABLE
26,12,2018,16,574,680,1254,2018-12-26 15:00:00,2018-12-26 00:00:00,LABORABLE
26,12,2018,17,552,730,1282,2018-12-26 16:00:00,2018-12-26 00:00:00,LABORABLE
26,12,2018,18,665,849,1514,2018-12-26 17:00:00,2018-12-26 00:00:00,LABORABLE
26,12,2018,19,688,812,1500,2018-12-26 18:00:00,2018-12-26 00:00:00,LABORABLE
26,12,2018,20,620,833,1453,2018-12-26 19:00:00,2018-12-26 00:00:00,LABORABLE
26,12,2018,21,581,777,1358,2018-12-26 20:00:00,2018-12-26 00:00:00,LABORABLE
26,12,2018,22,486,632,1118,2018-12-26 21:00:00,2018-12-26 00:00:00,LABORABLE
26,12,2018,23,419,486,905,2018-12-26 22:00:00,2018-12-26 00:00:00,LABORABLE
26,12,2018,24,245,372,617,2018-12-26 23:00:00,2018-12-26 00:00:00,LABORABLE
27,12,2018,1,192,283,475,2018-12-27 00:00:00,2018-12-27 00:00:00,LABORABLE
27,12,2018,2,137,266,403,2018-12-27 01:00:00,2018-12-27 00:00:00,LABORABLE
27,12,2018,3,103,168,271,2018-12-27 02:00:00,2018-12-27 00:00:00,LABORABLE
27,12,2018,4,72,116,188,2018-12-27 03:00:00,2018-12-27 00:00:00,LABORABLE
27,12,2018,5,88,115,203,2018-12-27 04:00:00,2018-12-27 00:00:00,LABORABLE
27,12,2018,6,144,165,309,2018-12-27 05:00:00,2018-12-27 00:00:00,LABORABLE
27,12,2018,7,342,343,685,2018-12-27 06:00:00,2018-12-27 00:00:00,LABORABLE
27,12,2018,8,535,523,1058,2018-12-27 07:00:00,2018-12-27 00:00:00,LABORABLE
27,12,2018,9,513,581,1094,2018-12-27 08:00:00,2018-12-27 00:00:00,LABORABLE
27,12,2018,10,546,675,1221,2018-12-27 09:00:00,2018-12-27 00:00:00,LABORABLE
27,12,2018,11,601,663,1264,2018-12-27 10:00:00,2018-12-27 00:00:00,LABORABLE
27,12,2018,12,664,724,1388,2018-12-27 11:00:00,2018-12-27 00:00:00,LABORABLE
27,12,2018,13,657,760,1417,2018-12-27 12:00:00,2018-12-27 00:00:00,LABORABLE
27,12,2018,14,601,668,1269,2018-12-27 13:00:00,2018-12-27 00:00:00,LABORABLE
27,12,2018,15,655,775,1430,2018-12-27 14:00:00,2018-12-27 00:00:00,LABORABLE
27,12,2018,16,629,711,1340,2018-12-27 15:00:00,2018-12-27 00:00:00,LABORABLE
27,12,2018,17,578,699,1277,2018-12-27 16:00:00,2018-12-27 00:00:00,LABORABLE
27,12,2018,18,687,825,1512,2018-12-27 17:00:00,2018-12-27 00:00:00,LABORABLE
27,12,2018,19,721,857,1578,2018-12-27 18:00:00,2018-12-27 00:00:00,LABORABLE
27,12,2018,20,711,847,1558,2018-12-27 19:00:00,2018-12-27 00:00:00,LABORABLE
27,12,2018,21,653,807,1460,2018-12-27 20:00:00,2018-12-27 00:00:00,LABORABLE
27,12,2018,22,552,694,1246,2018-12-27 21:00:00,2018-12-27 00:00:00,LABORABLE
27,12,2018,23,467,526,993,2018-12-27 22:00:00,2018-12-27 00:00:00,LABORABLE
27,12,2018,24,297,375,672,2018-12-27 23:00:00,2018-12-27 00:00:00,LABORABLE
28,12,2018,1,249,322,571,2018-12-28 00:00:00,2018-12-28 00:00:00,LABORABLE
28,12,2018,2,127,257,384,2018-12-28 01:00:00,2018-12-28 00:00:00,LABORABLE
28,12,2018,3,106,196,302,2018-12-28 02:00:00,2018-12-28 00:00:00,LABORABLE
28,12,2018,4,59,128,187,2018-12-28 03:00:00,2018-12-28 00:00:00,LABORABLE
28,12,2018,5,98,129,227,2018-12-28 04:00:00,2018-12-28 00:00:00,LABORABLE
28,12,2018,6,158,179,337,2018-12-28 05:00:00,2018-12-28 00:00:00,LABORABLE
28,12,2018,7,347,350,697,2018-12-28 06:00:00,2018-12-28 00:00:00,LABORABLE
28,12,2018,8,528,478,1006,2018-12-28 07:00:00,2018-12-28 00:00:00,LABORABLE
28,12,2018,9,473,556,1029,2018-12-28 08:00:00,2018-12-28 00:00:00,LABORABLE
28,12,2018,10,539,626,1165,2018-12-28 09:00:00,2018-12-28 00:00:00,LABORABLE
28,12,2018,11,598,690,1288,2018-12-28 10:00:00,2018-12-28 00:00:00,LABORABLE
28,12,2018,12,625,770,1395,2018-12-28 11:00:00,2018-12-28 00:00:00,LABORABLE
28,12,2018,13,689,789,1478,2018-12-28 12:00:00,2018-12-28 00:00:00,LABORABLE
28,12,2018,14,543,642,1185,2018-12-28 13:00:00,2018-12-28 00:00:00,LABORABLE
28,12,2018,15,707,775,1482,2018-12-28 14:00:00,2018-12-28 00:00:00,LABORABLE
28,12,2018,16,638,756,1394,2018-12-28 15:00:00,2018-12-28 00:00:00,LABORABLE
28,12,2018,17,602,753,1355,2018-12-28 16:00:00,2018-12-28 00:00:00,LABORABLE
28,12,2018,18,695,799,1494,2018-12-28 17:00:00,2018-12-28 00:00:00,LABORABLE
28,12,2018,19,689,829,1518,2018-12-28 18:00:00,2018-12-28 00:00:00,LABORABLE
28,12,2018,20,634,838,1472,2018-12-28 19:00:00,2018-12-28 00:00:00,LABORABLE
28,12,2018,21,713,868,1581,2018-12-28 20:00:00,2018-12-28 00:00:00,LABORABLE
28,12,2018,22,641,727,1368,2018-12-28 21:00:00,2018-12-28 00:00:00,LABORABLE
28,12,2018,23,561,573,1134,2018-12-28 22:00:00,2018-12-28 00:00:00,LABORABLE
28,12,2018,24,482,479,961,2018-12-28 23:00:00,2018-12-28 00:00:00,LABORABLE
29,12,2018,1,473,470,943,2018-12-29 00:00:00,2018-12-29 00:00:00,SÁBADO
29,12,2018,2,266,361,627,2018-12-29 01:00:00,2018-12-29 00:00:00,SÁBADO
29,12,2018,3,198,315,513,2018-12-29 02:00:00,2018-12-29 00:00:00,SÁBADO
29,12,2018,4,153,276,429,2018-12-29 03:00:00,2018-12-29 00:00:00,SÁBADO
29,12,2018,5,136,203,339,2018-12-29 04:00:00,2018-12-29 00:00:00,SÁBADO
29,12,2018,6,157,238,395,2018-12-29 05:00:00,2018-12-29 00:00:00,SÁBADO
29,12,2018,7,201,270,471,2018-12-29 06:00:00,2018-12-29 00:00:00,SÁBADO
29,12,2018,8,257,274,531,2018-12-29 07:00:00,2018-12-29 00:00:00,SÁBADO
29,12,2018,9,291,379,670,2018-12-29 08:00:00,2018-12-29 00:00:00,SÁBADO
29,12,2018,10,423,458,881,2018-12-29 09:00:00,2018-12-29 00:00:00,SÁBADO
29,12,2018,11,537,596,1133,2018-12-29 10:00:00,2018-12-29 00:00:00,SÁBADO
29,12,2018,12,623,681,1304,2018-12-29 11:00:00,2018-12-29 00:00:00,SÁBADO
29,12,2018,13,665,787,1452,2018-12-29 12:00:00,2018-12-29 00:00:00,SÁBADO
29,12,2018,14,703,751,1454,2018-12-29 13:00:00,2018-12-29 00:00:00,SÁBADO
29,12,2018,15,608,779,1387,2018-12-29 14:00:00,2018-12-29 00:00:00,SÁBADO
29,12,2018,16,521,728,1249,2018-12-29 15:00:00,2018-12-29 00:00:00,SÁBADO
29,12,2018,17,488,707,1195,2018-12-29 16:00:00,2018-12-29 00:00:00,SÁBADO
29,12,2018,18,601,734,1335,2018-12-29 17:00:00,2018-12-29 00:00:00,SÁBADO
29,12,2018,19,644,817,1461,2018-12-29 18:00:00,2018-12-29 00:00:00,SÁBADO
29,12,2018,20,622,777,1399,2018-12-29 19:00:00,2018-12-29 00:00:00,SÁBADO
29,12,2018,21,662,783,1445,2018-12-29 20:00:00,2018-12-29 00:00:00,SÁBADO
29,12,2018,22,584,702,1286,2018-12-29 21:00:00,2018-12-29 00:00:00,SÁBADO
29,12,2018,23,504,652,1156,2018-12-29 22:00:00,2018-12-29 00:00:00,SÁBADO
29,12,2018,24,483,537,1020,2018-12-29 23:00:00,2018-12-29 00:00:00,SÁBADO
30,12,2018,1,638,504,1142,2018-12-30 00:00:00,2018-12-30 00:00:00,DOMINGO
30,12,2018,2,294,425,719,2018-12-30 01:00:00,2018-12-30 00:00:00,DOMINGO
30,12,2018,3,268,347,615,2018-12-30 02:00:00,2018-12-30 00:00:00,DOMINGO
30,12,2018,4,188,350,538,2018-12-30 03:00:00,2018-12-30 00:00:00,DOMINGO
30,12,2018,5,126,243,369,2018-12-30 04:00:00,2018-12-30 00:00:00,DOMINGO
30,12,2018,6,138,277,415,2018-12-30 05:00:00,2018-12-30 00:00:00,DOMINGO
30,12,2018,7,220,283,503,2018-12-30 06:00:00,2018-12-30 00:00:00,DOMINGO
30,12,2018,8,159,243,402,2018-12-30 07:00:00,2018-12-30 00:00:00,DOMINGO
30,12,2018,9,245,271,516,2018-12-30 08:00:00,2018-12-30 00:00:00,DOMINGO
30,12,2018,10,322,341,663,2018-12-30 09:00:00,2018-12-30 00:00:00,DOMINGO
30,12,2018,11,419,450,869,2018-12-30 10:00:00,2018-12-30 00:00:00,DOMINGO
30,12,2018,12,488,587,1075,2018-12-30 11:00:00,2018-12-30 00:00:00,DOMINGO
30,12,2018,13,594,646,1240,2018-12-30 12:00:00,2018-12-30 00:00:00,DOMINGO
30,12,2018,14,509,695,1204,2018-12-30 13:00:00,2018-12-30 00:00:00,DOMINGO
30,12,2018,15,541,715,1256,2018-12-30 14:00:00,2018-12-30 00:00:00,DOMINGO
30,12,2018,16,485,664,1149,2018-12-30 15:00:00,2018-12-30 00:00:00,DOMINGO
30,12,2018,17,443,735,1178,2018-12-30 16:00:00,2018-12-30 00:00:00,DOMINGO
30,12,2018,18,559,730,1289,2018-12-30 17:00:00,2018-12-30 00:00:00,DOMINGO
30,12,2018,19,546,707,1253,2018-12-30 18:00:00,2018-12-30 00:00:00,DOMINGO
30,12,2018,20,567,756,1323,2018-12-30 19:00:00,2018-12-30 00:00:00,DOMINGO
30,12,2018,21,464,742,1206,2018-12-30 20:00:00,2018-12-30 00:00:00,DOMINGO
30,12,2018,22,508,630,1138,2018-12-30 21:00:00,2018-12-30 00:00:00,DOMINGO
30,12,2018,23,437,537,974,2018-12-30 22:00:00,2018-12-30 00:00:00,DOMINGO
30,12,2018,24,305,433,738,2018-12-30 23:00:00,2018-12-30 00:00:00,DOMINGO
31,12,2018,1,248,344,592,2018-12-31 00:00:00,2018-12-31 00:00:00,LABORABLE
31,12,2018,2,166,254,420,2018-12-31 01:00:00,2018-12-31 00:00:00,LABORABLE
31,12,2018,3,121,184,305,2018-12-31 02:00:00,2018-12-31 00:00:00,LABORABLE
31,12,2018,4,86,162,248,2018-12-31 03:00:00,2018-12-31 00:00:00,LABORABLE
31,12,2018,5,64,142,206,2018-12-31 04:00:00,2018-12-31 00:00:00,LABORABLE
31,12,2018,6,146,155,301,2018-12-31 05:00:00,2018-12-31 00:00:00,LABORABLE
31,12,2018,7,305,380,685,2018-12-31 06:00:00,2018-12-31 00:00:00,LABORABLE
31,12,2018,8,521,566,1087,2018-12-31 07:00:00,2018-12-31 00:00:00,LABORABLE
31,12,2018,9,599,747,1346,2018-12-31 08:00:00,2018-12-31 00:00:00,LABORABLE
31,12,2018,10,468,771,1239,2018-12-31 09:00:00,2018-12-31 00:00:00,LABORABLE
31,12,2018,11,597,744,1341,2018-12-31 10:00:00,2018-12-31 00:00:00,LABORABLE
31,12,2018,12,611,721,1332,2018-12-31 11:00:00,2018-12-31 00:00:00,LABORABLE
31,12,2018,13,703,835,1538,2018-12-31 12:00:00,2018-12-31 00:00:00,LABORABLE
31,12,2018,14,708,877,1585,2018-12-31 13:00:00,2018-12-31 00:00:00,LABORABLE
31,12,2018,15,696,844,1540,2018-12-31 14:00:00,2018-12-31 00:00:00,LABORABLE
31,12,2018,16,563,765,1328,2018-12-31 15:00:00,2018-12-31 00:00:00,LABORABLE
31,12,2018,17,563,789,1352,2018-12-31 16:00:00,2018-12-31 00:00:00,LABORABLE
31,12,2018,18,576,804,1380,2018-12-31 17:00:00,2018-12-31 00:00:00,LABORABLE
31,12,2018,19,660,872,1532,2018-12-31 18:00:00,2018-12-31 00:00:00,LABORABLE
31,12,2018,20,745,777,1522,2018-12-31 19:00:00,2018-12-31 00:00:00,LABORABLE
31,12,2018,21,726,812,1538,2018-12-31 20:00:00,2018-12-31 00:00:00,LABORABLE
31,12,2018,22,578,630,1208,2018-12-31 21:00:00,2018-12-31 00:00:00,LABORABLE
31,12,2018,23,329,443,772,2018-12-31 22:00:00,2018-12-31 00:00:00,LABORABLE
31,12,2018,24,187,319,506,2018-12-31 23:00:00,2018-12-31 00:00:00,LABORABLE
1,1,2019,1,415,489,904,2019-01-01 00:00:00,2019-01-01 00:00:00,FESTIVO
1,1,2019,2,757,732,1489,2019-01-01 01:00:00,2019-01-01 00:00:00,FESTIVO
1,1,2019,3,624,567,1191,2019-01-01 02:00:00,2019-01-01 00:00:00,FESTIVO
1,1,2019,4,474,495,969,2019-01-01 03:00:00,2019-01-01 00:00:00,FESTIVO
1,1,2019,5,285,335,620,2019-01-01 04:00:00,2019-01-01 00:00:00,FESTIVO
1,1,2019,6,258,266,524,2019-01-01 05:00:00,2019-01-01 00:00:00,FESTIVO
1,1,2019,7,295,347,642,2019-01-01 06:00:00,2019-01-01 00:00:00,FESTIVO
1,1,2019,8,227,293,520,2019-01-01 07:00:00,2019-01-01 00:00:00,FESTIVO
1,1,2019,9,176,221,397,2019-01-01 08:00:00,2019-01-01 00:00:00,FESTIVO
1,1,2019,10,146,254,400,2019-01-01 09:00:00,2019-01-01 00:00:00,FESTIVO
1,1,2019,11,169,250,419,2019-01-01 10:00:00,2019-01-01 00:00:00,FESTIVO
1,1,2019,12,227,309,536,2019-01-01 11:00:00,2019-01-01 00:00:00,FESTIVO
1,1,2019,13,367,393,760,2019-01-01 12:00:00,2019-01-01 00:00:00,FESTIVO
1,1,2019,14,487,513,1000,2019-01-01 13:00:00,2019-01-01 00:00:00,FESTIVO
1,1,2019,15,513,547,1060,2019-01-01 14:00:00,2019-01-01 00:00:00,FESTIVO
1,1,2019,16,360,496,856,2019-01-01 15:00:00,2019-01-01 00:00:00,FESTIVO
1,1,2019,17,431,537,968,2019-01-01 16:00:00,2019-01-01 00:00:00,FESTIVO
1,1,2019,18,499,594,1093,2019-01-01 17:00:00,2019-01-01 00:00:00,FESTIVO
1,1,2019,19,557,701,1258,2019-01-01 18:00:00,2019-01-01 00:00:00,FESTIVO
1,1,2019,20,590,711,1301,2019-01-01 19:00:00,2019-01-01 00:00:00,FESTIVO
1,1,2019,21,481,615,1096,2019-01-01 20:00:00,2019-01-01 00:00:00,FESTIVO
1,1,2019,22,396,514,910,2019-01-01 21:00:00,2019-01-01 00:00:00,FESTIVO
1,1,2019,23,283,464,747,2019-01-01 22:00:00,2019-01-01 00:00:00,FESTIVO
1,1,2019,24,215,331,546,2019-01-01 23:00:00,2019-01-01 00:00:00,FESTIVO
2,1,2019,1,150,279,429,2019-01-02 00:00:00,2019-02-01 00:00:00,LABORABLE
2,1,2019,2,100,206,306,2019-01-02 01:00:00,2019-02-01 00:00:00,LABORABLE
2,1,2019,3,49,118,167,2019-01-02 02:00:00,2019-02-01 00:00:00,LABORABLE
2,1,2019,4,68,116,184,2019-01-02 03:00:00,2019-02-01 00:00:00,LABORABLE
2,1,2019,5,54,90,144,2019-01-02 04:00:00,2019-02-01 00:00:00,LABORABLE
2,1,2019,6,127,145,272,2019-01-02 05:00:00,2019-02-01 00:00:00,LABORABLE
2,1,2019,7,308,344,652,2019-01-02 06:00:00,2019-02-01 00:00:00,LABORABLE
2,1,2019,8,549,482,1031,2019-01-02 07:00:00,2019-02-01 00:00:00,LABORABLE
2,1,2019,9,490,521,1011,2019-01-02 08:00:00,2019-02-01 00:00:00,LABORABLE
2,1,2019,10,566,609,1175,2019-01-02 09:00:00,2019-02-01 00:00:00,LABORABLE
2,1,2019,11,550,603,1153,2019-01-02 10:00:00,2019-02-01 00:00:00,LABORABLE
2,1,2019,12,614,723,1337,2019-01-02 11:00:00,2019-02-01 00:00:00,LABORABLE
2,1,2019,13,639,675,1314,2019-01-02 12:00:00,2019-02-01 00:00:00,LABORABLE
2,1,2019,14,621,720,1341,2019-01-02 13:00:00,2019-02-01 00:00:00,LABORABLE
2,1,2019,15,639,710,1349,2019-01-02 14:00:00,2019-02-01 00:00:00,LABORABLE
2,1,2019,16,596,662,1258,2019-01-02 15:00:00,2019-02-01 00:00:00,LABORABLE
2,1,2019,17,620,770,1390,2019-01-02 16:00:00,2019-02-01 00:00:00,LABORABLE
2,1,2019,18,662,672,1334,2019-01-02 17:00:00,2019-02-01 00:00:00,LABORABLE
2,1,2019,19,644,768,1412,2019-01-02 18:00:00,2019-02-01 00:00:00,LABORABLE
2,1,2019,20,565,789,1354,2019-01-02 19:00:00,2019-02-01 00:00:00,LABORABLE
2,1,2019,21,559,788,1347,2019-01-02 20:00:00,2019-02-01 00:00:00,LABORABLE
2,1,2019,22,453,639,1092,2019-01-02 21:00:00,2019-02-01 00:00:00,LABORABLE
2,1,2019,23,390,523,913,2019-01-02 22:00:00,2019-02-01 00:00:00,LABORABLE
2,1,2019,24,227,343,570,2019-01-02 23:00:00,2019-02-01 00:00:00,LABORABLE
3,1,2019,1,175,263,438,2019-01-03 00:00:00,2019-03-01 00:00:00,LABORABLE
3,1,2019,2,148,226,374,2019-01-03 01:00:00,2019-03-01 00:00:00,LABORABLE
3,1,2019,3,85,137,222,2019-01-03 02:00:00,2019-03-01 00:00:00,LABORABLE
3,1,2019,4,75,116,191,2019-01-03 03:00:00,2019-03-01 00:00:00,LABORABLE
3,1,2019,5,90,112,202,2019-01-03 04:00:00,2019-03-01 00:00:00,LABORABLE
3,1,2019,6,133,142,275,2019-01-03 05:00:00,2019-03-01 00:00:00,LABORABLE
3,1,2019,7,344,341,685,2019-01-03 06:00:00,2019-03-01 00:00:00,LABORABLE
3,1,2019,8,557,467,1024,2019-01-03 07:00:00,2019-03-01 00:00:00,LABORABLE
3,1,2019,9,506,576,1082,2019-01-03 08:00:00,2019-03-01 00:00:00,LABORABLE
3,1,2019,10,567,645,1212,2019-01-03 09:00:00,2019-03-01 00:00:00,LABORABLE
3,1,2019,11,613,661,1274,2019-01-03 10:00:00,2019-03-01 00:00:00,LABORABLE
3,1,2019,12,620,754,1374,2019-01-03 11:00:00,2019-03-01 00:00:00,LABORABLE
3,1,2019,13,627,747,1374,2019-01-03 12:00:00,2019-03-01 00:00:00,LABORABLE
3,1,2019,14,657,796,1453,2019-01-03 13:00:00,2019-03-01 00:00:00,LABORABLE
3,1,2019,15,647,698,1345,2019-01-03 14:00:00,2019-03-01 00:00:00,LABORABLE
3,1,2019,16,607,686,1293,2019-01-03 15:00:00,2019-03-01 00:00:00,LABORABLE
3,1,2019,17,636,796,1432,2019-01-03 16:00:00,2019-03-01 00:00:00,LABORABLE
3,1,2019,18,704,786,1490,2019-01-03 17:00:00,2019-03-01 00:00:00,LABORABLE
3,1,2019,19,721,780,1501,2019-01-03 18:00:00,2019-03-01 00:00:00,LABORABLE
3,1,2019,20,653,837,1490,2019-01-03 19:00:00,2019-03-01 00:00:00,LABORABLE
3,1,2019,21,626,760,1386,2019-01-03 20:00:00,2019-03-01 00:00:00,LABORABLE
3,1,2019,22,583,643,1226,2019-01-03 21:00:00,2019-03-01 00:00:00,LABORABLE
3,1,2019,23,405,515,920,2019-01-03 22:00:00,2019-03-01 00:00:00,LABORABLE
3,1,2019,24,317,369,686,2019-01-03 23:00:00,2019-03-01 00:00:00,LABORABLE
4,1,2019,1,202,331,533,2019-01-04 00:00:00,2019-04-01 00:00:00,LABORABLE
4,1,2019,2,141,249,390,2019-01-04 01:00:00,2019-04-01 00:00:00,LABORABLE
4,1,2019,3,97,174,271,2019-01-04 02:00:00,2019-04-01 00:00:00,LABORABLE
4,1,2019,4,81,117,198,2019-01-04 03:00:00,2019-04-01 00:00:00,LABORABLE
4,1,2019,5,94,105,199,2019-01-04 04:00:00,2019-04-01 00:00:00,LABORABLE
4,1,2019,6,134,165,299,2019-01-04 05:00:00,2019-04-01 00:00:00,LABORABLE
4,1,2019,7,349,349,698,2019-01-04 06:00:00,2019-04-01 00:00:00,LABORABLE
4,1,2019,8,531,520,1051,2019-01-04 07:00:00,2019-04-01 00:00:00,LABORABLE
4,1,2019,9,529,589,1118,2019-01-04 08:00:00,2019-04-01 00:00:00,LABORABLE
4,1,2019,10,592,670,1262,2019-01-04 09:00:00,2019-04-01 00:00:00,LABORABLE
4,1,2019,11,549,710,1259,2019-01-04 10:00:00,2019-04-01 00:00:00,LABORABLE
4,1,2019,12,624,714,1338,2019-01-04 11:00:00,2019-04-01 00:00:00,LABORABLE
4,1,2019,13,711,756,1467,2019-01-04 12:00:00,2019-04-01 00:00:00,LABORABLE
4,1,2019,14,560,687,1247,2019-01-04 13:00:00,2019-04-01 00:00:00,LABORABLE
4,1,2019,15,729,758,1487,2019-01-04 14:00:00,2019-04-01 00:00:00,LABORABLE
4,1,2019,16,617,758,1375,2019-01-04 15:00:00,2019-04-01 00:00:00,LABORABLE
4,1,2019,17,621,731,1352,2019-01-04 16:00:00,2019-04-01 00:00:00,LABORABLE
4,1,2019,18,652,838,1490,2019-01-04 17:00:00,2019-04-01 00:00:00,LABORABLE
4,1,2019,19,623,791,1414,2019-01-04 18:00:00,2019-04-01 00:00:00,LABORABLE
4,1,2019,20,665,892,1557,2019-01-04 19:00:00,2019-04-01 00:00:00,LABORABLE
4,1,2019,21,767,756,1523,2019-01-04 20:00:00,2019-04-01 00:00:00,LABORABLE
4,1,2019,22,591,741,1332,2019-01-04 21:00:00,2019-04-01 00:00:00,LABORABLE
4,1,2019,23,486,612,1098,2019-01-04 22:00:00,2019-04-01 00:00:00,LABORABLE
4,1,2019,24,389,487,876,2019-01-04 23:00:00,2019-04-01 00:00:00,LABORABLE
5,1,2019,1,251,418,669,2019-01-05 00:00:00,2019-05-01 00:00:00,SÁBADO
5,1,2019,2,257,344,601,2019-01-05 01:00:00,2019-05-01 00:00:00,SÁBADO
5,1,2019,3,164,289,453,2019-01-05 02:00:00,2019-05-01 00:00:00,SÁBADO
5,1,2019,4,145,255,400,2019-01-05 03:00:00,2019-05-01 00:00:00,SÁBADO
5,1,2019,5,103,182,285,2019-01-05 04:00:00,2019-05-01 00:00:00,SÁBADO
5,1,2019,6,136,221,357,2019-01-05 05:00:00,2019-05-01 00:00:00,SÁBADO
5,1,2019,7,182,261,443,2019-01-05 06:00:00,2019-05-01 00:00:00,SÁBADO
5,1,2019,8,247,254,501,2019-01-05 07:00:00,2019-05-01 00:00:00,SÁBADO
5,1,2019,9,290,353,643,2019-01-05 08:00:00,2019-05-01 00:00:00,SÁBADO
5,1,2019,10,426,473,899,2019-01-05 09:00:00,2019-05-01 00:00:00,SÁBADO
5,1,2019,11,529,591,1120,2019-01-05 10:00:00,2019-05-01 00:00:00,SÁBADO
5,1,2019,12,585,737,1322,2019-01-05 11:00:00,2019-05-01 00:00:00,SÁBADO
5,1,2019,13,682,751,1433,2019-01-05 12:00:00,2019-05-01 00:00:00,SÁBADO
5,1,2019,14,676,786,1462,2019-01-05 13:00:00,2019-05-01 00:00:00,SÁBADO
5,1,2019,15,582,765,1347,2019-01-05 14:00:00,2019-05-01 00:00:00,SÁBADO
5,1,2019,16,585,702,1287,2019-01-05 15:00:00,2019-05-01 00:00:00,SÁBADO
5,1,2019,17,493,646,1139,2019-01-05 16:00:00,2019-05-01 00:00:00,SÁBADO
5,1,2019,18,572,736,1308,2019-01-05 17:00:00,2019-05-01 00:00:00,SÁBADO
5,1,2019,19,553,778,1331,2019-01-05 18:00:00,2019-05-01 00:00:00,SÁBADO
5,1,2019,20,554,729,1283,2019-01-05 19:00:00,2019-05-01 00:00:00,SÁBADO
5,1,2019,21,504,700,1204,2019-01-05 20:00:00,2019-05-01 00:00:00,SÁBADO
5,1,2019,22,566,630,1196,2019-01-05 21:00:00,2019-05-01 00:00:00,SÁBADO
5,1,2019,23,444,650,1094,2019-01-05 22:00:00,2019-05-01 00:00:00,SÁBADO
5,1,2019,24,420,575,995,2019-01-05 23:00:00,2019-05-01 00:00:00,SÁBADO
6,1,2019,1,373,533,906,2019-01-06 00:00:00,2019-06-01 00:00:00,DOMINGO
6,1,2019,2,285,446,731,2019-01-06 01:00:00,2019-06-01 00:00:00,DOMINGO
6,1,2019,3,235,343,578,2019-01-06 02:00:00,2019-06-01 00:00:00,DOMINGO
6,1,2019,4,159,283,442,2019-01-06 03:00:00,2019-06-01 00:00:00,DOMINGO
6,1,2019,5,162,231,393,2019-01-06 04:00:00,2019-06-01 00:00:00,DOMINGO
6,1,2019,6,154,217,371,2019-01-06 05:00:00,2019-06-01 00:00:00,DOMINGO
6,1,2019,7,159,254,413,2019-01-06 06:00:00,2019-06-01 00:00:00,DOMINGO
6,1,2019,8,127,215,342,2019-01-06 07:00:00,2019-06-01 00:00:00,DOMINGO
6,1,2019,9,173,234,407,2019-01-06 08:00:00,2019-06-01 00:00:00,DOMINGO
6,1,2019,10,264,309,573,2019-01-06 09:00:00,2019-06-01 00:00:00,DOMINGO
6,1,2019,11,328,468,796,2019-01-06 10:00:00,2019-06-01 00:00:00,DOMINGO
6,1,2019,12,480,523,1003,2019-01-06 11:00:00,2019-06-01 00:00:00,DOMINGO
6,1,2019,13,577,652,1229,2019-01-06 12:00:00,2019-06-01 00:00:00,DOMINGO
6,1,2019,14,762,787,1549,2019-01-06 13:00:00,2019-06-01 00:00:00,DOMINGO
6,1,2019,15,738,719,1457,2019-01-06 14:00:00,2019-06-01 00:00:00,DOMINGO
6,1,2019,16,550,726,1276,2019-01-06 15:00:00,2019-06-01 00:00:00,DOMINGO
6,1,2019,17,500,671,1171,2019-01-06 16:00:00,2019-06-01 00:00:00,DOMINGO
6,1,2019,18,642,770,1412,2019-01-06 17:00:00,2019-06-01 00:00:00,DOMINGO
6,1,2019,19,716,760,1476,2019-01-06 18:00:00,2019-06-01 00:00:00,DOMINGO
6,1,2019,20,709,771,1480,2019-01-06 19:00:00,2019-06-01 00:00:00,DOMINGO
6,1,2019,21,591,736,1327,2019-01-06 20:00:00,2019-06-01 00:00:00,DOMINGO
6,1,2019,22,591,645,1236,2019-01-06 21:00:00,2019-06-01 00:00:00,DOMINGO
6,1,2019,23,429,525,954,2019-01-06 22:00:00,2019-06-01 00:00:00,DOMINGO
6,1,2019,24,345,468,813,2019-01-06 23:00:00,2019-06-01 00:00:00,DOMINGO
7,1,2019,1,250,362,612,2019-01-07 00:00:00,2019-07-01 00:00:00,FESTIVO
7,1,2019,2,151,276,427,2019-01-07 01:00:00,2019-07-01 00:00:00,FESTIVO
7,1,2019,3,112,253,365,2019-01-07 02:00:00,2019-07-01 00:00:00,FESTIVO
7,1,2019,4,88,172,260,2019-01-07 03:00:00,2019-07-01 00:00:00,FESTIVO
7,1,2019,5,71,129,200,2019-01-07 04:00:00,2019-07-01 00:00:00,FESTIVO
7,1,2019,6,96,146,242,2019-01-07 05:00:00,2019-07-01 00:00:00,FESTIVO
7,1,2019,7,161,174,335,2019-01-07 06:00:00,2019-07-01 00:00:00,FESTIVO
7,1,2019,8,180,210,390,2019-01-07 07:00:00,2019-07-01 00:00:00,FESTIVO
7,1,2019,9,225,264,489,2019-01-07 08:00:00,2019-07-01 00:00:00,FESTIVO
7,1,2019,10,300,406,706,2019-01-07 09:00:00,2019-07-01 00:00:00,FESTIVO
7,1,2019,11,373,506,879,2019-01-07 10:00:00,2019-07-01 00:00:00,FESTIVO
7,1,2019,12,482,584,1066,2019-01-07 11:00:00,2019-07-01 00:00:00,FESTIVO
7,1,2019,13,496,636,1132,2019-01-07 12:00:00,2019-07-01 00:00:00,FESTIVO
7,1,2019,14,509,615,1124,2019-01-07 13:00:00,2019-07-01 00:00:00,FESTIVO
7,1,2019,15,505,644,1149,2019-01-07 14:00:00,2019-07-01 00:00:00,FESTIVO
7,1,2019,16,453,611,1064,2019-01-07 15:00:00,2019-07-01 00:00:00,FESTIVO
7,1,2019,17,462,642,1104,2019-01-07 16:00:00,2019-07-01 00:00:00,FESTIVO
7,1,2019,18,537,681,1218,2019-01-07 17:00:00,2019-07-01 00:00:00,FESTIVO
7,1,2019,19,578,655,1233,2019-01-07 18:00:00,2019-07-01 00:00:00,FESTIVO
7,1,2019,20,518,716,1234,2019-01-07 19:00:00,2019-07-01 00:00:00,FESTIVO
7,1,2019,21,444,627,1071,2019-01-07 20:00:00,2019-07-01 00:00:00,FESTIVO
7,1,2019,22,432,570,1002,2019-01-07 21:00:00,2019-07-01 00:00:00,FESTIVO
7,1,2019,23,326,399,725,2019-01-07 22:00:00,2019-07-01 00:00:00,FESTIVO
7,1,2019,24,266,304,570,2019-01-07 23:00:00,2019-07-01 00:00:00,FESTIVO
8,1,2019,1,156,237,393,2019-01-08 00:00:00,2019-08-01 00:00:00,LABORABLE
8,1,2019,2,93,168,261,2019-01-08 01:00:00,2019-08-01 00:00:00,LABORABLE
8,1,2019,3,64,124,188,2019-01-08 02:00:00,2019-08-01 00:00:00,LABORABLE
8,1,2019,4,65,95,160,2019-01-08 03:00:00,2019-08-01 00:00:00,LABORABLE
8,1,2019,5,65,100,165,2019-01-08 04:00:00,2019-08-01 00:00:00,LABORABLE
8,1,2019,6,171,145,316,2019-01-08 05:00:00,2019-08-01 00:00:00,LABORABLE
8,1,2019,7,408,412,820,2019-01-08 06:00:00,2019-08-01 00:00:00,LABORABLE
8,1,2019,8,609,635,1244,2019-01-08 07:00:00,2019-08-01 00:00:00,LABORABLE
8,1,2019,9,676,714,1390,2019-01-08 08:00:00,2019-08-01 00:00:00,LABORABLE
8,1,2019,10,654,706,1360,2019-01-08 09:00:00,2019-08-01 00:00:00,LABORABLE
8,1,2019,11,598,685,1283,2019-01-08 10:00:00,2019-08-01 00:00:00,LABORABLE
8,1,2019,12,583,705,1288,2019-01-08 11:00:00,2019-08-01 00:00:00,LABORABLE
8,1,2019,13,633,747,1380,2019-01-08 12:00:00,2019-08-01 00:00:00,LABORABLE
8,1,2019,14,684,814,1498,2019-01-08 13:00:00,2019-08-01 00:00:00,LABORABLE
8,1,2019,15,685,758,1443,2019-01-08 14:00:00,2019-08-01 00:00:00,LABORABLE
8,1,2019,16,652,698,1350,2019-01-08 15:00:00,2019-08-01 00:00:00,LABORABLE
8,1,2019,17,639,763,1402,2019-01-08 16:00:00,2019-08-01 00:00:00,LABORABLE
8,1,2019,18,689,769,1458,2019-01-08 17:00:00,2019-08-01 00:00:00,LABORABLE
8,1,2019,19,675,826,1501,2019-01-08 18:00:00,2019-08-01 00:00:00,LABORABLE
8,1,2019,20,611,811,1422,2019-01-08 19:00:00,2019-08-01 00:00:00,LABORABLE
8,1,2019,21,586,772,1358,2019-01-08 20:00:00,2019-08-01 00:00:00,LABORABLE
8,1,2019,22,480,596,1076,2019-01-08 21:00:00,2019-08-01 00:00:00,LABORABLE
8,1,2019,23,380,451,831,2019-01-08 22:00:00,2019-08-01 00:00:00,LABORABLE
8,1,2019,24,204,303,507,2019-01-08 23:00:00,2019-08-01 00:00:00,LABORABLE
9,1,2019,1,164,231,395,2019-01-09 00:00:00,2019-09-01 00:00:00,LABORABLE
9,1,2019,2,86,176,262,2019-01-09 01:00:00,2019-09-01 00:00:00,LABORABLE
9,1,2019,3,73,129,202,2019-01-09 02:00:00,2019-09-01 00:00:00,LABORABLE
9,1,2019,4,57,100,157,2019-01-09 03:00:00,2019-09-01 00:00:00,LABORABLE
9,1,2019,5,65,88,153,2019-01-09 04:00:00,2019-09-01 00:00:00,LABORABLE
9,1,2019,6,139,148,287,2019-01-09 05:00:00,2019-09-01 00:00:00,LABORABLE
9,1,2019,7,400,402,802,2019-01-09 06:00:00,2019-09-01 00:00:00,LABORABLE
9,1,2019,8,580,620,1200,2019-01-09 07:00:00,2019-09-01 00:00:00,LABORABLE
9,1,2019,9,672,668,1340,2019-01-09 08:00:00,2019-09-01 00:00:00,LABORABLE
9,1,2019,10,661,697,1358,2019-01-09 09:00:00,2019-09-01 00:00:00,LABORABLE
9,1,2019,11,436,491,927,2019-01-09 10:00:00,2019-09-01 00:00:00,LABORABLE
9,1,2019,12,596,760,1356,2019-01-09 11:00:00,2019-09-01 00:00:00,LABORABLE
9,1,2019,13,629,687,1316,2019-01-09 12:00:00,2019-09-01 00:00:00,LABORABLE
9,1,2019,14,663,736,1399,2019-01-09 13:00:00,2019-09-01 00:00:00,LABORABLE
9,1,2019,15,685,762,1447,2019-01-09 14:00:00,2019-09-01 00:00:00,LABORABLE
9,1,2019,16,670,709,1379,2019-01-09 15:00:00,2019-09-01 00:00:00,LABORABLE
9,1,2019,17,607,688,1295,2019-01-09 16:00:00,2019-09-01 00:00:00,LABORABLE
9,1,2019,18,674,818,1492,2019-01-09 17:00:00,2019-09-01 00:00:00,LABORABLE
9,1,2019,19,718,798,1516,2019-01-09 18:00:00,2019-09-01 00:00:00,LABORABLE
9,1,2019,20,604,756,1360,2019-01-09 19:00:00,2019-09-01 00:00:00,LABORABLE
9,1,2019,21,629,740,1369,2019-01-09 20:00:00,2019-09-01 00:00:00,LABORABLE
9,1,2019,22,475,598,1073,2019-01-09 21:00:00,2019-09-01 00:00:00,LABORABLE
9,1,2019,23,381,480,861,2019-01-09 22:00:00,2019-09-01 00:00:00,LABORABLE
9,1,2019,24,240,371,611,2019-01-09 23:00:00,2019-09-01 00:00:00,LABORABLE
10,1,2019,1,181,269,450,2019-01-10 00:00:00,2019-10-01 00:00:00,LABORABLE
10,1,2019,2,110,202,312,2019-01-10 01:00:00,2019-10-01 00:00:00,LABORABLE
10,1,2019,3,73,132,205,2019-01-10 02:00:00,2019-10-01 00:00:00,LABORABLE
10,1,2019,4,65,103,168,2019-01-10 03:00:00,2019-10-01 00:00:00,LABORABLE
10,1,2019,5,75,91,166,2019-01-10 04:00:00,2019-10-01 00:00:00,LABORABLE
10,1,2019,6,155,159,314,2019-01-10 05:00:00,2019-10-01 00:00:00,LABORABLE
10,1,2019,7,406,406,812,2019-01-10 06:00:00,2019-10-01 00:00:00,LABORABLE
10,1,2019,8,636,609,1245,2019-01-10 07:00:00,2019-10-01 00:00:00,LABORABLE
10,1,2019,9,498,709,1207,2019-01-10 08:00:00,2019-10-01 00:00:00,LABORABLE
10,1,2019,10,657,745,1402,2019-01-10 09:00:00,2019-10-01 00:00:00,LABORABLE
10,1,2019,11,677,670,1347,2019-01-10 10:00:00,2019-10-01 00:00:00,LABORABLE
10,1,2019,12,613,723,1336,2019-01-10 11:00:00,2019-10-01 00:00:00,LABORABLE
10,1,2019,13,689,780,1469,2019-01-10 12:00:00,2019-10-01 00:00:00,LABORABLE
10,1,2019,14,666,799,1465,2019-01-10 13:00:00,2019-10-01 00:00:00,LABORABLE
10,1,2019,15,698,712,1410,2019-01-10 14:00:00,2019-10-01 00:00:00,LABORABLE
10,1,2019,16,666,694,1360,2019-01-10 15:00:00,2019-10-01 00:00:00,LABORABLE
10,1,2019,17,653,734,1387,2019-01-10 16:00:00,2019-10-01 00:00:00,LABORABLE
10,1,2019,18,728,809,1537,2019-01-10 17:00:00,2019-10-01 00:00:00,LABORABLE
10,1,2019,19,699,789,1488,2019-01-10 18:00:00,2019-10-01 00:00:00,LABORABLE
10,1,2019,20,676,787,1463,2019-01-10 19:00:00,2019-10-01 00:00:00,LABORABLE
10,1,2019,21,618,773,1391,2019-01-10 20:00:00,2019-10-01 00:00:00,LABORABLE
10,1,2019,22,563,596,1159,2019-01-10 21:00:00,2019-10-01 00:00:00,LABORABLE
10,1,2019,23,432,553,985,2019-01-10 22:00:00,2019-10-01 00:00:00,LABORABLE
10,1,2019,24,268,378,646,2019-01-10 23:00:00,2019-10-01 00:00:00,LABORABLE
11,1,2019,1,195,298,493,2019-01-11 00:00:00,2019-11-01 00:00:00,LABORABLE
11,1,2019,2,118,279,397,2019-01-11 01:00:00,2019-11-01 00:00:00,LABORABLE
11,1,2019,3,106,187,293,2019-01-11 02:00:00,2019-11-01 00:00:00,LABORABLE
11,1,2019,4,84,137,221,2019-01-11 03:00:00,2019-11-01 00:00:00,LABORABLE
11,1,2019,5,82,117,199,2019-01-11 04:00:00,2019-11-01 00:00:00,LABORABLE
11,1,2019,6,168,186,354,2019-01-11 05:00:00,2019-11-01 00:00:00,LABORABLE
11,1,2019,7,239,403,642,2019-01-11 06:00:00,2019-11-01 00:00:00,LABORABLE
11,1,2019,8,378,611,989,2019-01-11 07:00:00,2019-11-01 00:00:00,LABORABLE
11,1,2019,9,671,741,1412,2019-01-11 08:00:00,2019-11-01 00:00:00,LABORABLE
11,1,2019,10,658,733,1391,2019-01-11 09:00:00,2019-11-01 00:00:00,LABORABLE
11,1,2019,11,602,680,1282,2019-01-11 10:00:00,2019-11-01 00:00:00,LABORABLE
11,1,2019,12,618,732,1350,2019-01-11 11:00:00,2019-11-01 00:00:00,LABORABLE
11,1,2019,13,622,787,1409,2019-01-11 12:00:00,2019-11-01 00:00:00,LABORABLE
11,1,2019,14,756,783,1539,2019-01-11 13:00:00,2019-11-01 00:00:00,LABORABLE
11,1,2019,15,710,787,1497,2019-01-11 14:00:00,2019-11-01 00:00:00,LABORABLE
11,1,2019,16,663,699,1362,2019-01-11 15:00:00,2019-11-01 00:00:00,LABORABLE
11,1,2019,17,680,763,1443,2019-01-11 16:00:00,2019-11-01 00:00:00,LABORABLE
11,1,2019,18,688,749,1437,2019-01-11 17:00:00,2019-11-01 00:00:00,LABORABLE
11,1,2019,19,686,793,1479,2019-01-11 18:00:00,2019-11-01 00:00:00,LABORABLE
11,1,2019,20,710,803,1513,2019-01-11 19:00:00,2019-11-01 00:00:00,LABORABLE
11,1,2019,21,707,796,1503,2019-01-11 20:00:00,2019-11-01 00:00:00,LABORABLE
11,1,2019,22,581,699,1280,2019-01-11 21:00:00,2019-11-01 00:00:00,LABORABLE
11,1,2019,23,479,606,1085,2019-01-11 22:00:00,2019-11-01 00:00:00,LABORABLE
11,1,2019,24,330,505,835,2019-01-11 23:00:00,2019-11-01 00:00:00,LABORABLE
12,1,2019,1,274,429,703,2019-01-12 00:00:00,2019-12-01 00:00:00,LABORABLE
12,1,2019,2,227,336,563,2019-01-12 01:00:00,2019-12-01 00:00:00,LABORABLE
12,1,2019,3,157,292,449,2019-01-12 02:00:00,2019-12-01 00:00:00,LABORABLE
12,1,2019,4,139,221,360,2019-01-12 03:00:00,2019-12-01 00:00:00,LABORABLE
12,1,2019,5,101,185,286,2019-01-12 04:00:00,2019-12-01 00:00:00,LABORABLE
12,1,2019,6,141,201,342,2019-01-12 05:00:00,2019-12-01 00:00:00,LABORABLE
12,1,2019,7,166,249,415,2019-01-12 06:00:00,2019-12-01 00:00:00,LABORABLE
12,1,2019,8,266,283,549,2019-01-12 07:00:00,2019-12-01 00:00:00,LABORABLE
12,1,2019,9,332,375,707,2019-01-12 08:00:00,2019-12-01 00:00:00,LABORABLE
12,1,2019,10,441,506,947,2019-01-12 09:00:00,2019-12-01 00:00:00,LABORABLE
12,1,2019,11,503,614,1117,2019-01-12 10:00:00,2019-12-01 00:00:00,LABORABLE
12,1,2019,12,620,690,1310,2019-01-12 11:00:00,2019-12-01 00:00:00,LABORABLE
12,1,2019,13,694,726,1420,2019-01-12 12:00:00,2019-12-01 00:00:00,LABORABLE
12,1,2019,14,603,734,1337,2019-01-12 13:00:00,2019-12-01 00:00:00,LABORABLE
12,1,2019,15,665,698,1363,2019-01-12 14:00:00,2019-12-01 00:00:00,LABORABLE
12,1,2019,16,534,687,1221,2019-01-12 15:00:00,2019-12-01 00:00:00,LABORABLE
12,1,2019,17,508,724,1232,2019-01-12 16:00:00,2019-12-01 00:00:00,LABORABLE
12,1,2019,18,602,740,1342,2019-01-12 17:00:00,2019-12-01 00:00:00,LABORABLE
12,1,2019,19,678,759,1437,2019-01-12 18:00:00,2019-12-01 00:00:00,LABORABLE
12,1,2019,20,647,787,1434,2019-01-12 19:00:00,2019-12-01 00:00:00,LABORABLE
12,1,2019,21,575,756,1331,2019-01-12 20:00:00,2019-12-01 00:00:00,LABORABLE
12,1,2019,22,560,693,1253,2019-01-12 21:00:00,2019-12-01 00:00:00,LABORABLE
12,1,2019,23,541,622,1163,2019-01-12 22:00:00,2019-12-01 00:00:00,LABORABLE
12,1,2019,24,430,535,965,2019-01-12 23:00:00,2019-12-01 00:00:00,LABORABLE
13,1,2019,1,360,480,840,2019-01-13 00:00:00,2019-01-13 00:00:00,LABORABLE
13,1,2019,2,301,464,765,2019-01-13 01:00:00,2019-01-13 00:00:00,LABORABLE
13,1,2019,3,238,374,612,2019-01-13 02:00:00,2019-01-13 00:00:00,LABORABLE
13,1,2019,4,217,302,519,2019-01-13 03:00:00,2019-01-13 00:00:00,LABORABLE
13,1,2019,5,161,268,429,2019-01-13 04:00:00,2019-01-13 00:00:00,LABORABLE
13,1,2019,6,131,225,356,2019-01-13 05:00:00,2019-01-13 00:00:00,LABORABLE
13,1,2019,7,176,230,406,2019-01-13 06:00:00,2019-01-13 00:00:00,LABORABLE
13,1,2019,8,164,225,389,2019-01-13 07:00:00,2019-01-13 00:00:00,LABORABLE
13,1,2019,9,214,281,495,2019-01-13 08:00:00,2019-01-13 00:00:00,LABORABLE
13,1,2019,10,319,380,699,2019-01-13 09:00:00,2019-01-13 00:00:00,LABORABLE
13,1,2019,11,427,455,882,2019-01-13 10:00:00,2019-01-13 00:00:00,LABORABLE
13,1,2019,12,527,547,1074,2019-01-13 11:00:00,2019-01-13 00:00:00,LABORABLE
13,1,2019,13,550,632,1182,2019-01-13 12:00:00,2019-01-13 00:00:00,LABORABLE
13,1,2019,14,559,690,1249,2019-01-13 13:00:00,2019-01-13 00:00:00,LABORABLE
13,1,2019,15,561,641,1202,2019-01-13 14:00:00,2019-01-13 00:00:00,LABORABLE
13,1,2019,16,449,594,1043,2019-01-13 15:00:00,2019-01-13 00:00:00,LABORABLE
13,1,2019,17,463,577,1040,2019-01-13 16:00:00,2019-01-13 00:00:00,LABORABLE
13,1,2019,18,495,688,1183,2019-01-13 17:00:00,2019-01-13 00:00:00,LABORABLE
13,1,2019,19,563,669,1232,2019-01-13 18:00:00,2019-01-13 00:00:00,LABORABLE
13,1,2019,20,576,701,1277,2019-01-13 19:00:00,2019-01-13 00:00:00,LABORABLE
13,1,2019,21,526,618,1144,2019-01-13 20:00:00,2019-01-13 00:00:00,LABORABLE
13,1,2019,22,440,554,994,2019-01-13 21:00:00,2019-01-13 00:00:00,LABORABLE
13,1,2019,23,355,486,841,2019-01-13 22:00:00,2019-01-13 00:00:00,LABORABLE
13,1,2019,24,221,331,552,2019-01-13 23:00:00,2019-01-13 00:00:00,LABORABLE
14,1,2019,1,177,285,462,2019-01-14 00:00:00,2019-01-14 00:00:00,LABORABLE
14,1,2019,2,110,208,318,2019-01-14 01:00:00,2019-01-14 00:00:00,LABORABLE
14,1,2019,3,85,174,259,2019-01-14 02:00:00,2019-01-14 00:00:00,LABORABLE
14,1,2019,4,79,103,182,2019-01-14 03:00:00,2019-01-14 00:00:00,LABORABLE
14,1,2019,5,80,111,191,2019-01-14 04:00:00,2019-01-14 00:00:00,LABORABLE
14,1,2019,6,155,159,314,2019-01-14 05:00:00,2019-01-14 00:00:00,LABORABLE
14,1,2019,7,426,407,833,2019-01-14 06:00:00,2019-01-14 00:00:00,LABORABLE
14,1,2019,8,653,639,1292,2019-01-14 07:00:00,2019-01-14 00:00:00,LABORABLE
14,1,2019,9,686,666,1352,2019-01-14 08:00:00,2019-01-14 00:00:00,LABORABLE
14,1,2019,10,681,700,1381,2019-01-14 09:00:00,2019-01-14 00:00:00,LABORABLE
14,1,2019,11,529,657,1186,2019-01-14 10:00:00,2019-01-14 00:00:00,LABORABLE
14,1,2019,12,620,708,1328,2019-01-14 11:00:00,2019-01-14 00:00:00,LABORABLE
14,1,2019,13,650,657,1307,2019-01-14 12:00:00,2019-01-14 00:00:00,LABORABLE
14,1,2019,14,637,774,1411,2019-01-14 13:00:00,2019-01-14 00:00:00,LABORABLE
14,1,2019,15,692,728,1420,2019-01-14 14:00:00,2019-01-14 00:00:00,LABORABLE
14,1,2019,16,671,661,1332,2019-01-14 15:00:00,2019-01-14 00:00:00,LABORABLE
14,1,2019,17,651,676,1327,2019-01-14 16:00:00,2019-01-14 00:00:00,LABORABLE
14,1,2019,18,704,726,1430,2019-01-14 17:00:00,2019-01-14 00:00:00,LABORABLE
14,1,2019,19,702,764,1466,2019-01-14 18:00:00,2019-01-14 00:00:00,LABORABLE
14,1,2019,20,625,738,1363,2019-01-14 19:00:00,2019-01-14 00:00:00,LABORABLE
14,1,2019,21,611,759,1370,2019-01-14 20:00:00,2019-01-14 00:00:00,LABORABLE
14,1,2019,22,515,589,1104,2019-01-14 21:00:00,2019-01-14 00:00:00,LABORABLE
14,1,2019,23,372,462,834,2019-01-14 22:00:00,2019-01-14 00:00:00,LABORABLE
14,1,2019,24,215,296,511,2019-01-14 23:00:00,2019-01-14 00:00:00,LABORABLE
15,1,2019,1,133,239,372,2019-01-15 00:00:00,2019-01-15 00:00:00,LABORABLE
15,1,2019,2,112,188,300,2019-01-15 01:00:00,2019-01-15 00:00:00,LABORABLE
15,1,2019,3,66,118,184,2019-01-15 02:00:00,2019-01-15 00:00:00,LABORABLE
15,1,2019,4,55,108,163,2019-01-15 03:00:00,2019-01-15 00:00:00,LABORABLE
15,1,2019,5,58,97,155,2019-01-15 04:00:00,2019-01-15 00:00:00,LABORABLE
15,1,2019,6,162,168,330,2019-01-15 05:00:00,2019-01-15 00:00:00,LABORABLE
15,1,2019,7,403,384,787,2019-01-15 06:00:00,2019-01-15 00:00:00,LABORABLE
15,1,2019,8,623,611,1234,2019-01-15 07:00:00,2019-01-15 00:00:00,LABORABLE
15,1,2019,9,665,710,1375,2019-01-15 08:00:00,2019-01-15 00:00:00,LABORABLE
15,1,2019,10,628,665,1293,2019-01-15 09:00:00,2019-01-15 00:00:00,LABORABLE
15,1,2019,11,411,659,1070,2019-01-15 10:00:00,2019-01-15 00:00:00,LABORABLE
15,1,2019,12,600,715,1315,2019-01-15 11:00:00,2019-01-15 00:00:00,LABORABLE
15,1,2019,13,646,737,1383,2019-01-15 12:00:00,2019-01-15 00:00:00,LABORABLE
15,1,2019,14,663,720,1383,2019-01-15 13:00:00,2019-01-15 00:00:00,LABORABLE
15,1,2019,15,725,748,1473,2019-01-15 14:00:00,2019-01-15 00:00:00,LABORABLE
15,1,2019,16,664,651,1315,2019-01-15 15:00:00,2019-01-15 00:00:00,LABORABLE
15,1,2019,17,618,755,1373,2019-01-15 16:00:00,2019-01-15 00:00:00,LABORABLE
15,1,2019,18,680,788,1468,2019-01-15 17:00:00,2019-01-15 00:00:00,LABORABLE
15,1,2019,19,659,727,1386,2019-01-15 18:00:00,2019-01-15 00:00:00,LABORABLE
15,1,2019,20,663,821,1484,2019-01-15 19:00:00,2019-01-15 00:00:00,LABORABLE
15,1,2019,21,561,745,1306,2019-01-15 20:00:00,2019-01-15 00:00:00,LABORABLE
15,1,2019,22,501,595,1096,2019-01-15 21:00:00,2019-01-15 00:00:00,LABORABLE
15,1,2019,23,370,449,819,2019-01-15 22:00:00,2019-01-15 00:00:00,LABORABLE
15,1,2019,24,214,306,520,2019-01-15 23:00:00,2019-01-15 00:00:00,LABORABLE
16,1,2019,1,170,268,438,2019-01-16 00:00:00,2019-01-16 00:00:00,LABORABLE
16,1,2019,2,108,216,324,2019-01-16 01:00:00,2019-01-16 00:00:00,LABORABLE
16,1,2019,3,77,116,193,2019-01-16 02:00:00,2019-01-16 00:00:00,LABORABLE
16,1,2019,4,62,96,158,2019-01-16 03:00:00,2019-01-16 00:00:00,LABORABLE
16,1,2019,5,69,94,163,2019-01-16 04:00:00,2019-01-16 00:00:00,LABORABLE
16,1,2019,6,108,153,261,2019-01-16 05:00:00,2019-01-16 00:00:00,LABORABLE
16,1,2019,7,398,435,833,2019-01-16 06:00:00,2019-01-16 00:00:00,LABORABLE
16,1,2019,8,643,589,1232,2019-01-16 07:00:00,2019-01-16 00:00:00,LABORABLE
16,1,2019,9,485,539,1024,2019-01-16 08:00:00,2019-01-16 00:00:00,LABORABLE
16,1,2019,10,667,694,1361,2019-01-16 09:00:00,2019-01-16 00:00:00,LABORABLE
16,1,2019,11,596,630,1226,2019-01-16 10:00:00,2019-01-16 00:00:00,LABORABLE
16,1,2019,12,611,700,1311,2019-01-16 11:00:00,2019-01-16 00:00:00,LABORABLE
16,1,2019,13,683,701,1384,2019-01-16 12:00:00,2019-01-16 00:00:00,LABORABLE
16,1,2019,14,638,759,1397,2019-01-16 13:00:00,2019-01-16 00:00:00,LABORABLE
16,1,2019,15,690,697,1387,2019-01-16 14:00:00,2019-01-16 00:00:00,LABORABLE
16,1,2019,16,653,630,1283,2019-01-16 15:00:00,2019-01-16 00:00:00,LABORABLE
16,1,2019,17,702,700,1402,2019-01-16 16:00:00,2019-01-16 00:00:00,LABORABLE
16,1,2019,18,707,738,1445,2019-01-16 17:00:00,2019-01-16 00:00:00,LABORABLE
16,1,2019,19,692,754,1446,2019-01-16 18:00:00,2019-01-16 00:00:00,LABORABLE
16,1,2019,20,635,749,1384,2019-01-16 19:00:00,2019-01-16 00:00:00,LABORABLE
16,1,2019,21,613,673,1286,2019-01-16 20:00:00,2019-01-16 00:00:00,LABORABLE
16,1,2019,22,482,576,1058,2019-01-16 21:00:00,2019-01-16 00:00:00,LABORABLE
16,1,2019,23,382,429,811,2019-01-16 22:00:00,2019-01-16 00:00:00,LABORABLE
16,1,2019,24,255,324,579,2019-01-16 23:00:00,2019-01-16 00:00:00,LABORABLE
17,1,2019,1,188,272,460,2019-01-17 00:00:00,2019-01-17 00:00:00,LABORABLE
17,1,2019,2,127,189,316,2019-01-17 01:00:00,2019-01-17 00:00:00,LABORABLE
17,1,2019,3,85,117,202,2019-01-17 02:00:00,2019-01-17 00:00:00,LABORABLE
17,1,2019,4,63,102,165,2019-01-17 03:00:00,2019-01-17 00:00:00,LABORABLE
17,1,2019,5,80,105,185,2019-01-17 04:00:00,2019-01-17 00:00:00,LABORABLE
17,1,2019,6,165,168,333,2019-01-17 05:00:00,2019-01-17 00:00:00,LABORABLE
17,1,2019,7,295,398,693,2019-01-17 06:00:00,2019-01-17 00:00:00,LABORABLE
17,1,2019,8,668,602,1270,2019-01-17 07:00:00,2019-01-17 00:00:00,LABORABLE
17,1,2019,9,719,706,1425,2019-01-17 08:00:00,2019-01-17 00:00:00,LABORABLE
17,1,2019,10,666,753,1419,2019-01-17 09:00:00,2019-01-17 00:00:00,LABORABLE
17,1,2019,11,559,570,1129,2019-01-17 10:00:00,2019-01-17 00:00:00,LABORABLE
17,1,2019,12,438,726,1164,2019-01-17 11:00:00,2019-01-17 00:00:00,LABORABLE
17,1,2019,13,640,754,1394,2019-01-17 12:00:00,2019-01-17 00:00:00,LABORABLE
17,1,2019,14,677,717,1394,2019-01-17 13:00:00,2019-01-17 00:00:00,LABORABLE
17,1,2019,15,660,673,1333,2019-01-17 14:00:00,2019-01-17 00:00:00,LABORABLE
17,1,2019,16,686,676,1362,2019-01-17 15:00:00,2019-01-17 00:00:00,LABORABLE
17,1,2019,17,647,674,1321,2019-01-17 16:00:00,2019-01-17 00:00:00,LABORABLE
17,1,2019,18,696,742,1438,2019-01-17 17:00:00,2019-01-17 00:00:00,LABORABLE
17,1,2019,19,742,747,1489,2019-01-17 18:00:00,2019-01-17 00:00:00,LABORABLE
17,1,2019,20,708,784,1492,2019-01-17 19:00:00,2019-01-17 00:00:00,LABORABLE
17,1,2019,21,710,773,1483,2019-01-17 20:00:00,2019-01-17 00:00:00,LABORABLE
17,1,2019,22,587,583,1170,2019-01-17 21:00:00,2019-01-17 00:00:00,LABORABLE
17,1,2019,23,421,484,905,2019-01-17 22:00:00,2019-01-17 00:00:00,LABORABLE
17,1,2019,24,267,331,598,2019-01-17 23:00:00,2019-01-17 00:00:00,LABORABLE
18,1,2019,1,222,275,497,2019-01-18 00:00:00,2019-01-18 00:00:00,LABORABLE
18,1,2019,2,122,291,413,2019-01-18 01:00:00,2019-01-18 00:00:00,LABORABLE
18,1,2019,3,90,149,239,2019-01-18 02:00:00,2019-01-18 00:00:00,LABORABLE
18,1,2019,4,70,119,189,2019-01-18 03:00:00,2019-01-18 00:00:00,LABORABLE
18,1,2019,5,90,144,234,2019-01-18 04:00:00,2019-01-18 00:00:00,LABORABLE
18,1,2019,6,162,164,326,2019-01-18 05:00:00,2019-01-18 00:00:00,LABORABLE
18,1,2019,7,239,405,644,2019-01-18 06:00:00,2019-01-18 00:00:00,LABORABLE
18,1,2019,8,378,571,949,2019-01-18 07:00:00,2019-01-18 00:00:00,LABORABLE
18,1,2019,9,712,691,1403,2019-01-18 08:00:00,2019-01-18 00:00:00,LABORABLE
18,1,2019,10,631,697,1328,2019-01-18 09:00:00,2019-01-18 00:00:00,LABORABLE
18,1,2019,11,600,644,1244,2019-01-18 10:00:00,2019-01-18 00:00:00,LABORABLE
18,1,2019,12,543,762,1305,2019-01-18 11:00:00,2019-01-18 00:00:00,LABORABLE
18,1,2019,13,654,731,1385,2019-01-18 12:00:00,2019-01-18 00:00:00,LABORABLE
18,1,2019,14,690,708,1398,2019-01-18 13:00:00,2019-01-18 00:00:00,LABORABLE
18,1,2019,15,621,900,1521,2019-01-18 14:00:00,2019-01-18 00:00:00,LABORABLE
18,1,2019,16,674,684,1358,2019-01-18 15:00:00,2019-01-18 00:00:00,LABORABLE
18,1,2019,17,710,729,1439,2019-01-18 16:00:00,2019-01-18 00:00:00,LABORABLE
18,1,2019,18,747,802,1549,2019-01-18 17:00:00,2019-01-18 00:00:00,LABORABLE
18,1,2019,19,733,847,1580,2019-01-18 18:00:00,2019-01-18 00:00:00,LABORABLE
18,1,2019,20,683,860,1543,2019-01-18 19:00:00,2019-01-18 00:00:00,LABORABLE
18,1,2019,21,683,767,1450,2019-01-18 20:00:00,2019-01-18 00:00:00,LABORABLE
18,1,2019,22,611,701,1312,2019-01-18 21:00:00,2019-01-18 00:00:00,LABORABLE
18,1,2019,23,490,584,1074,2019-01-18 22:00:00,2019-01-18 00:00:00,LABORABLE
18,1,2019,24,362,515,877,2019-01-18 23:00:00,2019-01-18 00:00:00,LABORABLE
19,1,2019,1,269,455,724,2019-01-19 00:00:00,2019-01-19 00:00:00,LABORABLE
19,1,2019,2,209,364,573,2019-01-19 01:00:00,2019-01-19 00:00:00,LABORABLE
19,1,2019,3,174,289,463,2019-01-19 02:00:00,2019-01-19 00:00:00,LABORABLE
19,1,2019,4,120,226,346,2019-01-19 03:00:00,2019-01-19 00:00:00,LABORABLE
19,1,2019,5,113,184,297,2019-01-19 04:00:00,2019-01-19 00:00:00,LABORABLE
19,1,2019,6,128,202,330,2019-01-19 05:00:00,2019-01-19 00:00:00,LABORABLE
19,1,2019,7,195,251,446,2019-01-19 06:00:00,2019-01-19 00:00:00,LABORABLE
19,1,2019,8,233,269,502,2019-01-19 07:00:00,2019-01-19 00:00:00,LABORABLE
19,1,2019,9,325,381,706,2019-01-19 08:00:00,2019-01-19 00:00:00,LABORABLE
19,1,2019,10,451,476,927,2019-01-19 09:00:00,2019-01-19 00:00:00,LABORABLE
19,1,2019,11,541,600,1141,2019-01-19 10:00:00,2019-01-19 00:00:00,LABORABLE
19,1,2019,12,616,682,1298,2019-01-19 11:00:00,2019-01-19 00:00:00,LABORABLE
19,1,2019,13,619,688,1307,2019-01-19 12:00:00,2019-01-19 00:00:00,LABORABLE
19,1,2019,14,702,759,1461,2019-01-19 13:00:00,2019-01-19 00:00:00,LABORABLE
19,1,2019,15,621,772,1393,2019-01-19 14:00:00,2019-01-19 00:00:00,LABORABLE
19,1,2019,16,531,668,1199,2019-01-19 15:00:00,2019-01-19 00:00:00,LABORABLE
19,1,2019,17,473,634,1107,2019-01-19 16:00:00,2019-01-19 00:00:00,LABORABLE
19,1,2019,18,528,701,1229,2019-01-19 17:00:00,2019-01-19 00:00:00,LABORABLE
19,1,2019,19,649,762,1411,2019-01-19 18:00:00,2019-01-19 00:00:00,LABORABLE
19,1,2019,20,637,701,1338,2019-01-19 19:00:00,2019-01-19 00:00:00,LABORABLE
19,1,2019,21,558,656,1214,2019-01-19 20:00:00,2019-01-19 00:00:00,LABORABLE
19,1,2019,22,533,616,1149,2019-01-19 21:00:00,2019-01-19 00:00:00,LABORABLE
19,1,2019,23,493,545,1038,2019-01-19 22:00:00,2019-01-19 00:00:00,LABORABLE
19,1,2019,24,378,526,904,2019-01-19 23:00:00,2019-01-19 00:00:00,LABORABLE
20,1,2019,1,341,440,781,2019-01-20 00:00:00,2019-01-20 00:00:00,LABORABLE
20,1,2019,2,303,404,707,2019-01-20 01:00:00,2019-01-20 00:00:00,LABORABLE
20,1,2019,3,195,361,556,2019-01-20 02:00:00,2019-01-20 00:00:00,LABORABLE
20,1,2019,4,168,281,449,2019-01-20 03:00:00,2019-01-20 00:00:00,LABORABLE
20,1,2019,5,141,263,404,2019-01-20 04:00:00,2019-01-20 00:00:00,LABORABLE
20,1,2019,6,109,264,373,2019-01-20 05:00:00,2019-01-20 00:00:00,LABORABLE
20,1,2019,7,190,278,468,2019-01-20 06:00:00,2019-01-20 00:00:00,LABORABLE
20,1,2019,8,183,232,415,2019-01-20 07:00:00,2019-01-20 00:00:00,LABORABLE
20,1,2019,9,195,245,440,2019-01-20 08:00:00,2019-01-20 00:00:00,LABORABLE
20,1,2019,10,280,388,668,2019-01-20 09:00:00,2019-01-20 00:00:00,LABORABLE
20,1,2019,11,415,461,876,2019-01-20 10:00:00,2019-01-20 00:00:00,LABORABLE
20,1,2019,12,504,537,1041,2019-01-20 11:00:00,2019-01-20 00:00:00,LABORABLE
20,1,2019,13,530,553,1083,2019-01-20 12:00:00,2019-01-20 00:00:00,LABORABLE
20,1,2019,14,548,713,1261,2019-01-20 13:00:00,2019-01-20 00:00:00,LABORABLE
20,1,2019,15,580,672,1252,2019-01-20 14:00:00,2019-01-20 00:00:00,LABORABLE
20,1,2019,16,509,580,1089,2019-01-20 15:00:00,2019-01-20 00:00:00,LABORABLE
20,1,2019,17,501,640,1141,2019-01-20 16:00:00,2019-01-20 00:00:00,LABORABLE
20,1,2019,18,541,703,1244,2019-01-20 17:00:00,2019-01-20 00:00:00,LABORABLE
20,1,2019,19,561,674,1235,2019-01-20 18:00:00,2019-01-20 00:00:00,LABORABLE
20,1,2019,20,592,687,1279,2019-01-20 19:00:00,2019-01-20 00:00:00,LABORABLE
20,1,2019,21,548,664,1212,2019-01-20 20:00:00,2019-01-20 00:00:00,LABORABLE
20,1,2019,22,530,593,1123,2019-01-20 21:00:00,2019-01-20 00:00:00,LABORABLE
20,1,2019,23,366,468,834,2019-01-20 22:00:00,2019-01-20 00:00:00,LABORABLE
20,1,2019,24,246,363,609,2019-01-20 23:00:00,2019-01-20 00:00:00,LABORABLE
21,1,2019,1,151,287,438,2019-01-21 00:00:00,2019-01-21 00:00:00,LABORABLE
21,1,2019,2,126,212,338,2019-01-21 01:00:00,2019-01-21 00:00:00,LABORABLE
21,1,2019,3,65,152,217,2019-01-21 02:00:00,2019-01-21 00:00:00,LABORABLE
21,1,2019,4,70,119,189,2019-01-21 03:00:00,2019-01-21 00:00:00,LABORABLE
21,1,2019,5,80,81,161,2019-01-21 04:00:00,2019-01-21 00:00:00,LABORABLE
21,1,2019,6,151,148,299,2019-01-21 05:00:00,2019-01-21 00:00:00,LABORABLE
21,1,2019,7,422,361,783,2019-01-21 06:00:00,2019-01-21 00:00:00,LABORABLE
21,1,2019,8,618,540,1158,2019-01-21 07:00:00,2019-01-21 00:00:00,LABORABLE
21,1,2019,9,637,629,1266,2019-01-21 08:00:00,2019-01-21 00:00:00,LABORABLE
21,1,2019,10,646,643,1289,2019-01-21 09:00:00,2019-01-21 00:00:00,LABORABLE
21,1,2019,11,523,600,1123,2019-01-21 10:00:00,2019-01-21 00:00:00,LABORABLE
21,1,2019,12,538,624,1162,2019-01-21 11:00:00,2019-01-21 00:00:00,LABORABLE
21,1,2019,13,547,695,1242,2019-01-21 12:00:00,2019-01-21 00:00:00,LABORABLE
21,1,2019,14,588,648,1236,2019-01-21 13:00:00,2019-01-21 00:00:00,LABORABLE
21,1,2019,15,627,611,1238,2019-01-21 14:00:00,2019-01-21 00:00:00,LABORABLE
21,1,2019,16,625,596,1221,2019-01-21 15:00:00,2019-01-21 00:00:00,LABORABLE
21,1,2019,17,607,696,1303,2019-01-21 16:00:00,2019-01-21 00:00:00,LABORABLE
21,1,2019,18,658,684,1342,2019-01-21 17:00:00,2019-01-21 00:00:00,LABORABLE
21,1,2019,19,681,748,1429,2019-01-21 18:00:00,2019-01-21 00:00:00,LABORABLE
21,1,2019,20,615,712,1327,2019-01-21 19:00:00,2019-01-21 00:00:00,LABORABLE
21,1,2019,21,625,717,1342,2019-01-21 20:00:00,2019-01-21 00:00:00,LABORABLE
21,1,2019,22,428,530,958,2019-01-21 21:00:00,2019-01-21 00:00:00,LABORABLE
21,1,2019,23,332,422,754,2019-01-21 22:00:00,2019-01-21 00:00:00,LABORABLE
21,1,2019,24,185,323,508,2019-01-21 23:00:00,2019-01-21 00:00:00,LABORABLE
22,1,2019,1,124,263,387,2019-01-22 00:00:00,2019-01-22 00:00:00,LABORABLE
22,1,2019,2,73,206,279,2019-01-22 01:00:00,2019-01-22 00:00:00,LABORABLE
22,1,2019,3,69,121,190,2019-01-22 02:00:00,2019-01-22 00:00:00,LABORABLE
22,1,2019,4,50,112,162,2019-01-22 03:00:00,2019-01-22 00:00:00,LABORABLE
22,1,2019,5,56,76,132,2019-01-22 04:00:00,2019-01-22 00:00:00,LABORABLE
22,1,2019,6,141,99,240,2019-01-22 05:00:00,2019-01-22 00:00:00,LABORABLE
22,1,2019,7,400,353,753,2019-01-22 06:00:00,2019-01-22 00:00:00,LABORABLE
22,1,2019,8,640,576,1216,2019-01-22 07:00:00,2019-01-22 00:00:00,LABORABLE
22,1,2019,9,674,614,1288,2019-01-22 08:00:00,2019-01-22 00:00:00,LABORABLE
22,1,2019,10,618,636,1254,2019-01-22 09:00:00,2019-01-22 00:00:00,LABORABLE
22,1,2019,11,530,571,1101,2019-01-22 10:00:00,2019-01-22 00:00:00,LABORABLE
22,1,2019,12,533,646,1179,2019-01-22 11:00:00,2019-01-22 00:00:00,LABORABLE
22,1,2019,13,473,728,1201,2019-01-22 12:00:00,2019-01-22 00:00:00,LABORABLE
22,1,2019,14,577,649,1226,2019-01-22 13:00:00,2019-01-22 00:00:00,LABORABLE
22,1,2019,15,628,706,1334,2019-01-22 14:00:00,2019-01-22 00:00:00,LABORABLE
22,1,2019,16,635,600,1235,2019-01-22 15:00:00,2019-01-22 00:00:00,LABORABLE
22,1,2019,17,598,630,1228,2019-01-22 16:00:00,2019-01-22 00:00:00,LABORABLE
22,1,2019,18,644,668,1312,2019-01-22 17:00:00,2019-01-22 00:00:00,LABORABLE
22,1,2019,19,641,712,1353,2019-01-22 18:00:00,2019-01-22 00:00:00,LABORABLE
22,1,2019,20,625,689,1314,2019-01-22 19:00:00,2019-01-22 00:00:00,LABORABLE
22,1,2019,21,560,625,1185,2019-01-22 20:00:00,2019-01-22 00:00:00,LABORABLE
22,1,2019,22,457,511,968,2019-01-22 21:00:00,2019-01-22 00:00:00,LABORABLE
22,1,2019,23,335,460,795,2019-01-22 22:00:00,2019-01-22 00:00:00,LABORABLE
22,1,2019,24,198,353,551,2019-01-22 23:00:00,2019-01-22 00:00:00,LABORABLE
23,1,2019,1,144,287,431,2019-01-23 00:00:00,2019-01-23 00:00:00,LABORABLE
23,1,2019,2,76,216,292,2019-01-23 01:00:00,2019-01-23 00:00:00,LABORABLE
23,1,2019,3,51,134,185,2019-01-23 02:00:00,2019-01-23 00:00:00,LABORABLE
23,1,2019,4,46,110,156,2019-01-23 03:00:00,2019-01-23 00:00:00,LABORABLE
23,1,2019,5,69,93,162,2019-01-23 04:00:00,2019-01-23 00:00:00,LABORABLE
23,1,2019,6,144,147,291,2019-01-23 05:00:00,2019-01-23 00:00:00,LABORABLE
23,1,2019,7,389,344,733,2019-01-23 06:00:00,2019-01-23 00:00:00,LABORABLE
23,1,2019,8,638,543,1181,2019-01-23 07:00:00,2019-01-23 00:00:00,LABORABLE
23,1,2019,9,637,633,1270,2019-01-23 08:00:00,2019-01-23 00:00:00,LABORABLE
23,1,2019,10,604,626,1230,2019-01-23 09:00:00,2019-01-23 00:00:00,LABORABLE
23,1,2019,11,457,505,962,2019-01-23 10:00:00,2019-01-23 00:00:00,LABORABLE
23,1,2019,12,548,634,1182,2019-01-23 11:00:00,2019-01-23 00:00:00,LABORABLE
23,1,2019,13,582,787,1369,2019-01-23 12:00:00,2019-01-23 00:00:00,LABORABLE
23,1,2019,14,601,674,1275,2019-01-23 13:00:00,2019-01-23 00:00:00,LABORABLE
23,1,2019,15,615,645,1260,2019-01-23 14:00:00,2019-01-23 00:00:00,LABORABLE
23,1,2019,16,678,689,1367,2019-01-23 15:00:00,2019-01-23 00:00:00,LABORABLE
23,1,2019,17,631,710,1341,2019-01-23 16:00:00,2019-01-23 00:00:00,LABORABLE
23,1,2019,18,639,705,1344,2019-01-23 17:00:00,2019-01-23 00:00:00,LABORABLE
23,1,2019,19,633,684,1317,2019-01-23 18:00:00,2019-01-23 00:00:00,LABORABLE
23,1,2019,20,593,715,1308,2019-01-23 19:00:00,2019-01-23 00:00:00,LABORABLE
23,1,2019,21,639,653,1292,2019-01-23 20:00:00,2019-01-23 00:00:00,LABORABLE
23,1,2019,22,475,488,963,2019-01-23 21:00:00,2019-01-23 00:00:00,LABORABLE
23,1,2019,23,326,390,716,2019-01-23 22:00:00,2019-01-23 00:00:00,LABORABLE
23,1,2019,24,221,265,486,2019-01-23 23:00:00,2019-01-23 00:00:00,LABORABLE
24,1,2019,1,150,267,417,2019-01-24 00:00:00,2019-01-24 00:00:00,LABORABLE
24,1,2019,2,83,203,286,2019-01-24 01:00:00,2019-01-24 00:00:00,LABORABLE
24,1,2019,3,65,157,222,2019-01-24 02:00:00,2019-01-24 00:00:00,LABORABLE
24,1,2019,4,63,90,153,2019-01-24 03:00:00,2019-01-24 00:00:00,LABORABLE
24,1,2019,5,81,106,187,2019-01-24 04:00:00,2019-01-24 00:00:00,LABORABLE
24,1,2019,6,140,137,277,2019-01-24 05:00:00,2019-01-24 00:00:00,LABORABLE
24,1,2019,7,405,367,772,2019-01-24 06:00:00,2019-01-24 00:00:00,LABORABLE
24,1,2019,8,667,547,1214,2019-01-24 07:00:00,2019-01-24 00:00:00,LABORABLE
24,1,2019,9,667,652,1319,2019-01-24 08:00:00,2019-01-24 00:00:00,LABORABLE
24,1,2019,10,671,594,1265,2019-01-24 09:00:00,2019-01-24 00:00:00,LABORABLE
24,1,2019,11,604,623,1227,2019-01-24 10:00:00,2019-01-24 00:00:00,LABORABLE
24,1,2019,12,563,586,1149,2019-01-24 11:00:00,2019-01-24 00:00:00,LABORABLE
24,1,2019,13,612,664,1276,2019-01-24 12:00:00,2019-01-24 00:00:00,LABORABLE
24,1,2019,14,595,743,1338,2019-01-24 13:00:00,2019-01-24 00:00:00,LABORABLE
24,1,2019,15,663,657,1320,2019-01-24 14:00:00,2019-01-24 00:00:00,LABORABLE
24,1,2019,16,632,743,1375,2019-01-24 15:00:00,2019-01-24 00:00:00,LABORABLE
24,1,2019,17,655,653,1308,2019-01-24 16:00:00,2019-01-24 00:00:00,LABORABLE
24,1,2019,18,684,713,1397,2019-01-24 17:00:00,2019-01-24 00:00:00,LABORABLE
24,1,2019,19,703,676,1379,2019-01-24 18:00:00,2019-01-24 00:00:00,LABORABLE
24,1,2019,20,651,716,1367,2019-01-24 19:00:00,2019-01-24 00:00:00,LABORABLE
24,1,2019,21,649,650,1299,2019-01-24 20:00:00,2019-01-24 00:00:00,LABORABLE
24,1,2019,22,512,704,1216,2019-01-24 21:00:00,2019-01-24 00:00:00,LABORABLE
24,1,2019,23,376,406,782,2019-01-24 22:00:00,2019-01-24 00:00:00,LABORABLE
24,1,2019,24,255,418,673,2019-01-24 23:00:00,2019-01-24 00:00:00,LABORABLE
25,1,2019,1,172,344,516,2019-01-25 00:00:00,2019-01-25 00:00:00,LABORABLE
25,1,2019,2,105,249,354,2019-01-25 01:00:00,2019-01-25 00:00:00,LABORABLE
25,1,2019,3,61,222,283,2019-01-25 02:00:00,2019-01-25 00:00:00,LABORABLE
25,1,2019,4,68,178,246,2019-01-25 03:00:00,2019-01-25 00:00:00,LABORABLE
25,1,2019,5,72,135,207,2019-01-25 04:00:00,2019-01-25 00:00:00,LABORABLE
25,1,2019,6,158,141,299,2019-01-25 05:00:00,2019-01-25 00:00:00,LABORABLE
25,1,2019,7,239,365,604,2019-01-25 06:00:00,2019-01-25 00:00:00,LABORABLE
25,1,2019,8,378,534,912,2019-01-25 07:00:00,2019-01-25 00:00:00,LABORABLE
25,1,2019,9,655,650,1305,2019-01-25 08:00:00,2019-01-25 00:00:00,LABORABLE
25,1,2019,10,605,645,1250,2019-01-25 09:00:00,2019-01-25 00:00:00,LABORABLE
25,1,2019,11,547,591,1138,2019-01-25 10:00:00,2019-01-25 00:00:00,LABORABLE
25,1,2019,12,585,626,1211,2019-01-25 11:00:00,2019-01-25 00:00:00,LABORABLE
25,1,2019,13,672,649,1321,2019-01-25 12:00:00,2019-01-25 00:00:00,LABORABLE
25,1,2019,14,644,666,1310,2019-01-25 13:00:00,2019-01-25 00:00:00,LABORABLE
25,1,2019,15,671,694,1365,2019-01-25 14:00:00,2019-01-25 00:00:00,LABORABLE
25,1,2019,16,627,594,1221,2019-01-25 15:00:00,2019-01-25 00:00:00,LABORABLE
25,1,2019,17,656,705,1361,2019-01-25 16:00:00,2019-01-25 00:00:00,LABORABLE
25,1,2019,18,682,709,1391,2019-01-25 17:00:00,2019-01-25 00:00:00,LABORABLE
25,1,2019,19,661,713,1374,2019-01-25 18:00:00,2019-01-25 00:00:00,LABORABLE
25,1,2019,20,639,743,1382,2019-01-25 19:00:00,2019-01-25 00:00:00,LABORABLE
25,1,2019,21,633,730,1363,2019-01-25 20:00:00,2019-01-25 00:00:00,LABORABLE
25,1,2019,22,629,670,1299,2019-01-25 21:00:00,2019-01-25 00:00:00,LABORABLE
25,1,2019,23,468,535,1003,2019-01-25 22:00:00,2019-01-25 00:00:00,LABORABLE
25,1,2019,24,322,419,741,2019-01-25 23:00:00,2019-01-25 00:00:00,LABORABLE
26,1,2019,1,222,336,558,2019-01-26 00:00:00,2019-01-26 00:00:00,LABORABLE
26,1,2019,2,168,258,426,2019-01-26 01:00:00,2019-01-26 00:00:00,LABORABLE
26,1,2019,3,144,183,327,2019-01-26 02:00:00,2019-01-26 00:00:00,LABORABLE
26,1,2019,4,145,165,310,2019-01-26 03:00:00,2019-01-26 00:00:00,LABORABLE
26,1,2019,5,95,144,239,2019-01-26 04:00:00,2019-01-26 00:00:00,LABORABLE
26,1,2019,6,120,147,267,2019-01-26 05:00:00,2019-01-26 00:00:00,LABORABLE
26,1,2019,7,184,218,402,2019-01-26 06:00:00,2019-01-26 00:00:00,LABORABLE
26,1,2019,8,257,258,515,2019-01-26 07:00:00,2019-01-26 00:00:00,LABORABLE
26,1,2019,9,340,328,668,2019-01-26 08:00:00,2019-01-26 00:00:00,LABORABLE
26,1,2019,10,406,427,833,2019-01-26 09:00:00,2019-01-26 00:00:00,LABORABLE
26,1,2019,11,540,536,1076,2019-01-26 10:00:00,2019-01-26 00:00:00,LABORABLE
26,1,2019,12,609,630,1239,2019-01-26 11:00:00,2019-01-26 00:00:00,LABORABLE
26,1,2019,13,691,707,1398,2019-01-26 12:00:00,2019-01-26 00:00:00,LABORABLE
26,1,2019,14,671,725,1396,2019-01-26 13:00:00,2019-01-26 00:00:00,LABORABLE
26,1,2019,15,634,744,1378,2019-01-26 14:00:00,2019-01-26 00:00:00,LABORABLE
26,1,2019,16,507,617,1124,2019-01-26 15:00:00,2019-01-26 00:00:00,LABORABLE
26,1,2019,17,504,587,1091,2019-01-26 16:00:00,2019-01-26 00:00:00,LABORABLE
26,1,2019,18,573,698,1271,2019-01-26 17:00:00,2019-01-26 00:00:00,LABORABLE
26,1,2019,19,644,666,1310,2019-01-26 18:00:00,2019-01-26 00:00:00,LABORABLE
26,1,2019,20,653,644,1297,2019-01-26 19:00:00,2019-01-26 00:00:00,LABORABLE
26,1,2019,21,582,681,1263,2019-01-26 20:00:00,2019-01-26 00:00:00,LABORABLE
26,1,2019,22,615,589,1204,2019-01-26 21:00:00,2019-01-26 00:00:00,LABORABLE
26,1,2019,23,524,559,1083,2019-01-26 22:00:00,2019-01-26 00:00:00,LABORABLE
26,1,2019,24,425,479,904,2019-01-26 23:00:00,2019-01-26 00:00:00,LABORABLE
27,1,2019,1,379,397,776,2019-01-27 00:00:00,2019-01-27 00:00:00,LABORABLE
27,1,2019,2,278,297,575,2019-01-27 01:00:00,2019-01-27 00:00:00,LABORABLE
27,1,2019,3,185,242,427,2019-01-27 02:00:00,2019-01-27 00:00:00,LABORABLE
27,1,2019,4,146,193,339,2019-01-27 03:00:00,2019-01-27 00:00:00,LABORABLE
27,1,2019,5,122,137,259,2019-01-27 04:00:00,2019-01-27 00:00:00,LABORABLE
27,1,2019,6,99,162,261,2019-01-27 05:00:00,2019-01-27 00:00:00,LABORABLE
27,1,2019,7,150,192,342,2019-01-27 06:00:00,2019-01-27 00:00:00,LABORABLE
27,1,2019,8,166,171,337,2019-01-27 07:00:00,2019-01-27 00:00:00,LABORABLE
27,1,2019,9,198,215,413,2019-01-27 08:00:00,2019-01-27 00:00:00,LABORABLE
27,1,2019,10,301,357,658,2019-01-27 09:00:00,2019-01-27 00:00:00,LABORABLE
27,1,2019,11,374,401,775,2019-01-27 10:00:00,2019-01-27 00:00:00,LABORABLE
27,1,2019,12,489,493,982,2019-01-27 11:00:00,2019-01-27 00:00:00,LABORABLE
27,1,2019,13,564,556,1120,2019-01-27 12:00:00,2019-01-27 00:00:00,LABORABLE
27,1,2019,14,578,568,1146,2019-01-27 13:00:00,2019-01-27 00:00:00,LABORABLE
27,1,2019,15,536,631,1167,2019-01-27 14:00:00,2019-01-27 00:00:00,LABORABLE
27,1,2019,16,433,546,979,2019-01-27 15:00:00,2019-01-27 00:00:00,LABORABLE
27,1,2019,17,478,581,1059,2019-01-27 16:00:00,2019-01-27 00:00:00,LABORABLE
27,1,2019,18,549,605,1154,2019-01-27 17:00:00,2019-01-27 00:00:00,LABORABLE
27,1,2019,19,579,658,1237,2019-01-27 18:00:00,2019-01-27 00:00:00,LABORABLE
27,1,2019,20,598,636,1234,2019-01-27 19:00:00,2019-01-27 00:00:00,LABORABLE
27,1,2019,21,544,620,1164,2019-01-27 20:00:00,2019-01-27 00:00:00,LABORABLE
27,1,2019,22,472,529,1001,2019-01-27 21:00:00,2019-01-27 00:00:00,LABORABLE
27,1,2019,23,353,443,796,2019-01-27 22:00:00,2019-01-27 00:00:00,LABORABLE
27,1,2019,24,236,326,562,2019-01-27 23:00:00,2019-01-27 00:00:00,LABORABLE
28,1,2019,1,147,275,422,2019-01-28 00:00:00,2019-01-28 00:00:00,LABORABLE
28,1,2019,2,97,182,279,2019-01-28 01:00:00,2019-01-28 00:00:00,LABORABLE
28,1,2019,3,86,104,190,2019-01-28 02:00:00,2019-01-28 00:00:00,LABORABLE
28,1,2019,4,67,84,151,2019-01-28 03:00:00,2019-01-28 00:00:00,LABORABLE
28,1,2019,5,59,87,146,2019-01-28 04:00:00,2019-01-28 00:00:00,LABORABLE
28,1,2019,6,134,133,267,2019-01-28 05:00:00,2019-01-28 00:00:00,LABORABLE
28,1,2019,7,405,364,769,2019-01-28 06:00:00,2019-01-28 00:00:00,LABORABLE
28,1,2019,8,656,570,1226,2019-01-28 07:00:00,2019-01-28 00:00:00,LABORABLE
28,1,2019,9,666,593,1259,2019-01-28 08:00:00,2019-01-28 00:00:00,LABORABLE
28,1,2019,10,625,609,1234,2019-01-28 09:00:00,2019-01-28 00:00:00,LABORABLE
28,1,2019,11,525,576,1101,2019-01-28 10:00:00,2019-01-28 00:00:00,LABORABLE
28,1,2019,12,559,636,1195,2019-01-28 11:00:00,2019-01-28 00:00:00,LABORABLE
28,1,2019,13,389,823,1212,2019-01-28 12:00:00,2019-01-28 00:00:00,LABORABLE
28,1,2019,14,631,682,1313,2019-01-28 13:00:00,2019-01-28 00:00:00,LABORABLE
28,1,2019,15,669,631,1300,2019-01-28 14:00:00,2019-01-28 00:00:00,LABORABLE
28,1,2019,16,644,626,1270,2019-01-28 15:00:00,2019-01-28 00:00:00,LABORABLE
28,1,2019,17,597,652,1249,2019-01-28 16:00:00,2019-01-28 00:00:00,LABORABLE
28,1,2019,18,631,668,1299,2019-01-28 17:00:00,2019-01-28 00:00:00,LABORABLE
28,1,2019,19,685,671,1356,2019-01-28 18:00:00,2019-01-28 00:00:00,LABORABLE
28,1,2019,20,618,662,1280,2019-01-28 19:00:00,2019-01-28 00:00:00,LABORABLE
28,1,2019,21,600,640,1240,2019-01-28 20:00:00,2019-01-28 00:00:00,LABORABLE
28,1,2019,22,481,521,1002,2019-01-28 21:00:00,2019-01-28 00:00:00,LABORABLE
28,1,2019,23,331,522,853,2019-01-28 22:00:00,2019-01-28 00:00:00,LABORABLE
28,1,2019,24,192,318,510,2019-01-28 23:00:00,2019-01-28 00:00:00,LABORABLE
29,1,2019,1,160,276,436,2019-01-29 00:00:00,2019-01-29 00:00:00,LABORABLE
29,1,2019,2,79,182,261,2019-01-29 01:00:00,2019-01-29 00:00:00,LABORABLE
29,1,2019,3,60,121,181,2019-01-29 02:00:00,2019-01-29 00:00:00,LABORABLE
29,1,2019,4,50,112,162,2019-01-29 03:00:00,2019-01-29 00:00:00,LABORABLE
29,1,2019,5,55,79,134,2019-01-29 04:00:00,2019-01-29 00:00:00,LABORABLE
29,1,2019,6,147,125,272,2019-01-29 05:00:00,2019-01-29 00:00:00,LABORABLE
29,1,2019,7,409,358,767,2019-01-29 06:00:00,2019-01-29 00:00:00,LABORABLE
29,1,2019,8,658,548,1206,2019-01-29 07:00:00,2019-01-29 00:00:00,LABORABLE
29,1,2019,9,677,640,1317,2019-01-29 08:00:00,2019-01-29 00:00:00,LABORABLE
29,1,2019,10,637,634,1271,2019-01-29 09:00:00,2019-01-29 00:00:00,LABORABLE
29,1,2019,11,428,658,1086,2019-01-29 10:00:00,2019-01-29 00:00:00,LABORABLE
29,1,2019,12,507,599,1106,2019-01-29 11:00:00,2019-01-29 00:00:00,LABORABLE
29,1,2019,13,614,598,1212,2019-01-29 12:00:00,2019-01-29 00:00:00,LABORABLE
29,1,2019,14,610,674,1284,2019-01-29 13:00:00,2019-01-29 00:00:00,LABORABLE
29,1,2019,15,637,667,1304,2019-01-29 14:00:00,2019-01-29 00:00:00,LABORABLE
29,1,2019,16,622,639,1261,2019-01-29 15:00:00,2019-01-29 00:00:00,LABORABLE
29,1,2019,17,624,619,1243,2019-01-29 16:00:00,2019-01-29 00:00:00,LABORABLE
29,1,2019,18,653,610,1263,2019-01-29 17:00:00,2019-01-29 00:00:00,LABORABLE
29,1,2019,19,665,689,1354,2019-01-29 18:00:00,2019-01-29 00:00:00,LABORABLE
29,1,2019,20,588,669,1257,2019-01-29 19:00:00,2019-01-29 00:00:00,LABORABLE
29,1,2019,21,598,623,1221,2019-01-29 20:00:00,2019-01-29 00:00:00,LABORABLE
29,1,2019,22,465,600,1065,2019-01-29 21:00:00,2019-01-29 00:00:00,LABORABLE
29,1,2019,23,338,369,707,2019-01-29 22:00:00,2019-01-29 00:00:00,LABORABLE
29,1,2019,24,219,343,562,2019-01-29 23:00:00,2019-01-29 00:00:00,LABORABLE
30,1,2019,1,137,208,345,2019-01-30 00:00:00,2019-01-30 00:00:00,LABORABLE
30,1,2019,2,82,216,298,2019-01-30 01:00:00,2019-01-30 00:00:00,LABORABLE
30,1,2019,3,73,105,178,2019-01-30 02:00:00,2019-01-30 00:00:00,LABORABLE
30,1,2019,4,42,110,152,2019-01-30 03:00:00,2019-01-30 00:00:00,LABORABLE
30,1,2019,5,73,77,150,2019-01-30 04:00:00,2019-01-30 00:00:00,LABORABLE
30,1,2019,6,147,130,277,2019-01-30 05:00:00,2019-01-30 00:00:00,LABORABLE
30,1,2019,7,395,345,740,2019-01-30 06:00:00,2019-01-30 00:00:00,LABORABLE
30,1,2019,8,655,540,1195,2019-01-30 07:00:00,2019-01-30 00:00:00,LABORABLE
30,1,2019,9,681,636,1317,2019-01-30 08:00:00,2019-01-30 00:00:00,LABORABLE
30,1,2019,10,636,600,1236,2019-01-30 09:00:00,2019-01-30 00:00:00,LABORABLE
30,1,2019,11,507,713,1220,2019-01-30 10:00:00,2019-01-30 00:00:00,LABORABLE
30,1,2019,12,561,692,1253,2019-01-30 11:00:00,2019-01-30 00:00:00,LABORABLE
30,1,2019,13,598,641,1239,2019-01-30 12:00:00,2019-01-30 00:00:00,LABORABLE
30,1,2019,14,582,672,1254,2019-01-30 13:00:00,2019-01-30 00:00:00,LABORABLE
30,1,2019,15,601,696,1297,2019-01-30 14:00:00,2019-01-30 00:00:00,LABORABLE
30,1,2019,16,625,598,1223,2019-01-30 15:00:00,2019-01-30 00:00:00,LABORABLE
30,1,2019,17,605,603,1208,2019-01-30 16:00:00,2019-01-30 00:00:00,LABORABLE
30,1,2019,18,668,711,1379,2019-01-30 17:00:00,2019-01-30 00:00:00,LABORABLE
30,1,2019,19,682,676,1358,2019-01-30 18:00:00,2019-01-30 00:00:00,LABORABLE
30,1,2019,20,582,689,1271,2019-01-30 19:00:00,2019-01-30 00:00:00,LABORABLE
30,1,2019,21,585,657,1242,2019-01-30 20:00:00,2019-01-30 00:00:00,LABORABLE
30,1,2019,22,493,542,1035,2019-01-30 21:00:00,2019-01-30 00:00:00,LABORABLE
30,1,2019,23,349,378,727,2019-01-30 22:00:00,2019-01-30 00:00:00,LABORABLE
30,1,2019,24,245,341,586,2019-01-30 23:00:00,2019-01-30 00:00:00,LABORABLE
31,1,2019,1,168,300,468,2019-01-31 00:00:00,2019-01-31 00:00:00,LABORABLE
31,1,2019,2,97,216,313,2019-01-31 01:00:00,2019-01-31 00:00:00,LABORABLE
31,1,2019,3,69,157,226,2019-01-31 02:00:00,2019-01-31 00:00:00,LABORABLE
31,1,2019,4,51,131,182,2019-01-31 03:00:00,2019-01-31 00:00:00,LABORABLE
31,1,2019,5,64,96,160,2019-01-31 04:00:00,2019-01-31 00:00:00,LABORABLE
31,1,2019,6,140,145,285,2019-01-31 05:00:00,2019-01-31 00:00:00,LABORABLE
31,1,2019,7,428,363,791,2019-01-31 06:00:00,2019-01-31 00:00:00,LABORABLE
31,1,2019,8,632,544,1176,2019-01-31 07:00:00,2019-01-31 00:00:00,LABORABLE
31,1,2019,9,705,645,1350,2019-01-31 08:00:00,2019-01-31 00:00:00,LABORABLE
31,1,2019,10,659,729,1388,2019-01-31 09:00:00,2019-01-31 00:00:00,LABORABLE
31,1,2019,11,595,594,1189,2019-01-31 10:00:00,2019-01-31 00:00:00,LABORABLE
31,1,2019,12,585,647,1232,2019-01-31 11:00:00,2019-01-31 00:00:00,LABORABLE
31,1,2019,13,577,658,1235,2019-01-31 12:00:00,2019-01-31 00:00:00,LABORABLE
31,1,2019,14,616,680,1296,2019-01-31 13:00:00,2019-01-31 00:00:00,LABORABLE
31,1,2019,15,652,634,1286,2019-01-31 14:00:00,2019-01-31 00:00:00,LABORABLE
31,1,2019,16,624,588,1212,2019-01-31 15:00:00,2019-01-31 00:00:00,LABORABLE
31,1,2019,17,645,618,1263,2019-01-31 16:00:00,2019-01-31 00:00:00,LABORABLE
31,1,2019,18,648,682,1330,2019-01-31 17:00:00,2019-01-31 00:00:00,LABORABLE
31,1,2019,19,709,683,1392,2019-01-31 18:00:00,2019-01-31 00:00:00,LABORABLE
31,1,2019,20,656,741,1397,2019-01-31 19:00:00,2019-01-31 00:00:00,LABORABLE
31,1,2019,21,642,730,1372,2019-01-31 20:00:00,2019-01-31 00:00:00,LABORABLE
31,1,2019,22,549,604,1153,2019-01-31 21:00:00,2019-01-31 00:00:00,LABORABLE
31,1,2019,23,438,445,883,2019-01-31 22:00:00,2019-01-31 00:00:00,LABORABLE
31,1,2019,24,272,428,700,2019-01-31 23:00:00,2019-01-31 00:00:00,LABORABLE
1,2,2019,1,291,346,637,2019-02-01 00:00:00,2019-01-02 00:00:00,LABORABLE
1,2,2019,2,200,323,523,2019-02-01 01:00:00,2019-01-02 00:00:00,LABORABLE
1,2,2019,3,81,198,279,2019-02-01 02:00:00,2019-01-02 00:00:00,LABORABLE
1,2,2019,4,53,156,209,2019-02-01 03:00:00,2019-01-02 00:00:00,LABORABLE
1,2,2019,5,72,99,171,2019-02-01 04:00:00,2019-01-02 00:00:00,LABORABLE
1,2,2019,6,145,156,301,2019-02-01 05:00:00,2019-01-02 00:00:00,LABORABLE
1,2,2019,7,318,426,744,2019-02-01 06:00:00,2019-01-02 00:00:00,LABORABLE
1,2,2019,8,373,514,887,2019-02-01 07:00:00,2019-01-02 00:00:00,LABORABLE
1,2,2019,9,683,592,1275,2019-02-01 08:00:00,2019-01-02 00:00:00,LABORABLE
1,2,2019,10,570,674,1244,2019-02-01 09:00:00,2019-01-02 00:00:00,LABORABLE
1,2,2019,11,534,569,1103,2019-02-01 10:00:00,2019-01-02 00:00:00,LABORABLE
1,2,2019,12,550,601,1151,2019-02-01 11:00:00,2019-01-02 00:00:00,LABORABLE
1,2,2019,13,621,668,1289,2019-02-01 12:00:00,2019-01-02 00:00:00,LABORABLE
1,2,2019,14,625,649,1274,2019-02-01 13:00:00,2019-01-02 00:00:00,LABORABLE
1,2,2019,15,656,693,1349,2019-02-01 14:00:00,2019-01-02 00:00:00,LABORABLE
1,2,2019,16,629,674,1303,2019-02-01 15:00:00,2019-01-02 00:00:00,LABORABLE
1,2,2019,17,662,671,1333,2019-02-01 16:00:00,2019-01-02 00:00:00,LABORABLE
1,2,2019,18,699,691,1390,2019-02-01 17:00:00,2019-01-02 00:00:00,LABORABLE
1,2,2019,19,715,775,1490,2019-02-01 18:00:00,2019-01-02 00:00:00,LABORABLE
1,2,2019,20,676,746,1422,2019-02-01 19:00:00,2019-01-02 00:00:00,LABORABLE
1,2,2019,21,675,790,1465,2019-02-01 20:00:00,2019-01-02 00:00:00,LABORABLE
1,2,2019,22,614,650,1264,2019-02-01 21:00:00,2019-01-02 00:00:00,LABORABLE
1,2,2019,23,486,667,1153,2019-02-01 22:00:00,2019-01-02 00:00:00,LABORABLE
1,2,2019,24,309,539,848,2019-02-01 23:00:00,2019-01-02 00:00:00,LABORABLE
2,2,2019,1,384,261,645,2019-02-02 00:00:00,2019-02-02 00:00:00,LABORABLE
2,2,2019,2,213,214,427,2019-02-02 01:00:00,2019-02-02 00:00:00,LABORABLE
2,2,2019,3,137,154,291,2019-02-02 02:00:00,2019-02-02 00:00:00,LABORABLE
2,2,2019,4,114,102,216,2019-02-02 03:00:00,2019-02-02 00:00:00,LABORABLE
2,2,2019,5,112,100,212,2019-02-02 04:00:00,2019-02-02 00:00:00,LABORABLE
2,2,2019,6,227,105,332,2019-02-02 05:00:00,2019-02-02 00:00:00,LABORABLE
2,2,2019,7,533,337,870,2019-02-02 06:00:00,2019-02-02 00:00:00,LABORABLE
2,2,2019,8,1038,579,1617,2019-02-02 07:00:00,2019-02-02 00:00:00,LABORABLE
2,2,2019,9,1322,705,2027,2019-02-02 08:00:00,2019-02-02 00:00:00,LABORABLE
2,2,2019,10,1060,707,1767,2019-02-02 09:00:00,2019-02-02 00:00:00,LABORABLE
2,2,2019,11,659,670,1329,2019-02-02 10:00:00,2019-02-02 00:00:00,LABORABLE
2,2,2019,12,1278,715,1993,2019-02-02 11:00:00,2019-02-02 00:00:00,LABORABLE
2,2,2019,13,1180,726,1906,2019-02-02 12:00:00,2019-02-02 00:00:00,LABORABLE
2,2,2019,14,1155,769,1924,2019-02-02 13:00:00,2019-02-02 00:00:00,LABORABLE
2,2,2019,15,1209,740,1949,2019-02-02 14:00:00,2019-02-02 00:00:00,LABORABLE
2,2,2019,16,1149,655,1804,2019-02-02 15:00:00,2019-02-02 00:00:00,LABORABLE
2,2,2019,17,1321,731,2052,2019-02-02 16:00:00,2019-02-02 00:00:00,LABORABLE
2,2,2019,18,1424,817,2241,2019-02-02 17:00:00,2019-02-02 00:00:00,LABORABLE
2,2,2019,19,1396,836,2232,2019-02-02 18:00:00,2019-02-02 00:00:00,LABORABLE
2,2,2019,20,1479,820,2299,2019-02-02 19:00:00,2019-02-02 00:00:00,LABORABLE
2,2,2019,21,1374,782,2156,2019-02-02 20:00:00,2019-02-02 00:00:00,LABORABLE
2,2,2019,22,1144,683,1827,2019-02-02 21:00:00,2019-02-02 00:00:00,LABORABLE
2,2,2019,23,869,475,1344,2019-02-02 22:00:00,2019-02-02 00:00:00,LABORABLE
2,2,2019,24,563,358,921,2019-02-02 23:00:00,2019-02-02 00:00:00,LABORABLE
3,2,2019,1,428,278,706,2019-02-03 00:00:00,2019-03-02 00:00:00,LABORABLE
3,2,2019,2,265,227,492,2019-02-03 01:00:00,2019-03-02 00:00:00,LABORABLE
3,2,2019,3,142,164,306,2019-02-03 02:00:00,2019-03-02 00:00:00,LABORABLE
3,2,2019,4,143,133,276,2019-02-03 03:00:00,2019-03-02 00:00:00,LABORABLE
3,2,2019,5,141,103,244,2019-02-03 04:00:00,2019-03-02 00:00:00,LABORABLE
3,2,2019,6,199,139,338,2019-02-03 05:00:00,2019-03-02 00:00:00,LABORABLE
3,2,2019,7,532,329,861,2019-02-03 06:00:00,2019-03-02 00:00:00,LABORABLE
3,2,2019,8,1033,565,1598,2019-02-03 07:00:00,2019-03-02 00:00:00,LABORABLE
3,2,2019,9,1350,721,2071,2019-02-03 08:00:00,2019-03-02 00:00:00,LABORABLE
3,2,2019,10,1229,725,1954,2019-02-03 09:00:00,2019-03-02 00:00:00,LABORABLE
3,2,2019,11,1235,676,1911,2019-02-03 10:00:00,2019-03-02 00:00:00,LABORABLE
3,2,2019,12,1198,718,1916,2019-02-03 11:00:00,2019-03-02 00:00:00,LABORABLE
3,2,2019,13,1367,783,2150,2019-02-03 12:00:00,2019-03-02 00:00:00,LABORABLE
3,2,2019,14,1334,779,2113,2019-02-03 13:00:00,2019-03-02 00:00:00,LABORABLE
3,2,2019,15,1317,801,2118,2019-02-03 14:00:00,2019-03-02 00:00:00,LABORABLE
3,2,2019,16,1273,664,1937,2019-02-03 15:00:00,2019-03-02 00:00:00,LABORABLE
3,2,2019,17,1383,785,2168,2019-02-03 16:00:00,2019-03-02 00:00:00,LABORABLE
3,2,2019,18,1315,787,2102,2019-02-03 17:00:00,2019-03-02 00:00:00,LABORABLE
3,2,2019,19,1387,825,2212,2019-02-03 18:00:00,2019-03-02 00:00:00,LABORABLE
3,2,2019,20,1422,783,2205,2019-02-03 19:00:00,2019-03-02 00:00:00,LABORABLE
3,2,2019,21,1385,802,2187,2019-02-03 20:00:00,2019-03-02 00:00:00,LABORABLE
3,2,2019,22,1296,881,2177,2019-02-03 21:00:00,2019-03-02 00:00:00,LABORABLE
3,2,2019,23,949,667,1616,2019-02-03 22:00:00,2019-03-02 00:00:00,LABORABLE
3,2,2019,24,678,479,1157,2019-02-03 23:00:00,2019-03-02 00:00:00,LABORABLE
4,2,2019,1,165,310,475,2019-02-04 00:00:00,2019-04-02 00:00:00,LABORABLE
4,2,2019,2,84,220,304,2019-02-04 01:00:00,2019-04-02 00:00:00,LABORABLE
4,2,2019,3,67,165,232,2019-02-04 02:00:00,2019-04-02 00:00:00,LABORABLE
4,2,2019,4,58,132,190,2019-02-04 03:00:00,2019-04-02 00:00:00,LABORABLE
4,2,2019,5,72,104,176,2019-02-04 04:00:00,2019-04-02 00:00:00,LABORABLE
4,2,2019,6,138,136,274,2019-02-04 05:00:00,2019-04-02 00:00:00,LABORABLE
4,2,2019,7,400,356,756,2019-02-04 06:00:00,2019-04-02 00:00:00,LABORABLE
4,2,2019,8,669,598,1267,2019-02-04 07:00:00,2019-04-02 00:00:00,LABORABLE
4,2,2019,9,680,618,1298,2019-02-04 08:00:00,2019-04-02 00:00:00,LABORABLE
4,2,2019,10,600,596,1196,2019-02-04 09:00:00,2019-04-02 00:00:00,LABORABLE
4,2,2019,11,509,637,1146,2019-02-04 10:00:00,2019-04-02 00:00:00,LABORABLE
4,2,2019,12,557,642,1199,2019-02-04 11:00:00,2019-04-02 00:00:00,LABORABLE
4,2,2019,13,464,835,1299,2019-02-04 12:00:00,2019-04-02 00:00:00,LABORABLE
4,2,2019,14,621,669,1290,2019-02-04 13:00:00,2019-04-02 00:00:00,LABORABLE
4,2,2019,15,664,622,1286,2019-02-04 14:00:00,2019-04-02 00:00:00,LABORABLE
4,2,2019,16,640,618,1258,2019-02-04 15:00:00,2019-04-02 00:00:00,LABORABLE
4,2,2019,17,641,704,1345,2019-02-04 16:00:00,2019-04-02 00:00:00,LABORABLE
4,2,2019,18,624,680,1304,2019-02-04 17:00:00,2019-04-02 00:00:00,LABORABLE
4,2,2019,19,667,760,1427,2019-02-04 18:00:00,2019-04-02 00:00:00,LABORABLE
4,2,2019,20,638,699,1337,2019-02-04 19:00:00,2019-04-02 00:00:00,LABORABLE
4,2,2019,21,600,797,1397,2019-02-04 20:00:00,2019-04-02 00:00:00,LABORABLE
4,2,2019,22,492,529,1021,2019-02-04 21:00:00,2019-04-02 00:00:00,LABORABLE
4,2,2019,23,317,412,729,2019-02-04 22:00:00,2019-04-02 00:00:00,LABORABLE
4,2,2019,24,206,283,489,2019-02-04 23:00:00,2019-04-02 00:00:00,LABORABLE
5,2,2019,1,132,205,337,2019-02-05 00:00:00,2019-05-02 00:00:00,LABORABLE
5,2,2019,2,92,144,236,2019-02-05 01:00:00,2019-05-02 00:00:00,LABORABLE
5,2,2019,3,59,120,179,2019-02-05 02:00:00,2019-05-02 00:00:00,LABORABLE
5,2,2019,4,50,117,167,2019-02-05 03:00:00,2019-05-02 00:00:00,LABORABLE
5,2,2019,5,61,80,141,2019-02-05 04:00:00,2019-05-02 00:00:00,LABORABLE
5,2,2019,6,145,143,288,2019-02-05 05:00:00,2019-05-02 00:00:00,LABORABLE
5,2,2019,7,392,376,768,2019-02-05 06:00:00,2019-05-02 00:00:00,LABORABLE
5,2,2019,8,643,560,1203,2019-02-05 07:00:00,2019-05-02 00:00:00,LABORABLE
5,2,2019,9,674,631,1305,2019-02-05 08:00:00,2019-05-02 00:00:00,LABORABLE
5,2,2019,10,620,666,1286,2019-02-05 09:00:00,2019-05-02 00:00:00,LABORABLE
5,2,2019,11,534,558,1092,2019-02-05 10:00:00,2019-05-02 00:00:00,LABORABLE
5,2,2019,12,541,633,1174,2019-02-05 11:00:00,2019-05-02 00:00:00,LABORABLE
5,2,2019,13,593,670,1263,2019-02-05 12:00:00,2019-05-02 00:00:00,LABORABLE
5,2,2019,14,666,625,1291,2019-02-05 13:00:00,2019-05-02 00:00:00,LABORABLE
5,2,2019,15,637,627,1264,2019-02-05 14:00:00,2019-05-02 00:00:00,LABORABLE
5,2,2019,16,598,623,1221,2019-02-05 15:00:00,2019-05-02 00:00:00,LABORABLE
5,2,2019,17,613,643,1256,2019-02-05 16:00:00,2019-05-02 00:00:00,LABORABLE
5,2,2019,18,654,680,1334,2019-02-05 17:00:00,2019-05-02 00:00:00,LABORABLE
5,2,2019,19,652,728,1380,2019-02-05 18:00:00,2019-05-02 00:00:00,LABORABLE
5,2,2019,20,620,718,1338,2019-02-05 19:00:00,2019-05-02 00:00:00,LABORABLE
5,2,2019,21,621,643,1264,2019-02-05 20:00:00,2019-05-02 00:00:00,LABORABLE
5,2,2019,22,490,530,1020,2019-02-05 21:00:00,2019-05-02 00:00:00,LABORABLE
5,2,2019,23,376,419,795,2019-02-05 22:00:00,2019-05-02 00:00:00,LABORABLE
5,2,2019,24,224,293,517,2019-02-05 23:00:00,2019-05-02 00:00:00,LABORABLE
6,2,2019,1,145,230,375,2019-02-06 00:00:00,2019-06-02 00:00:00,LABORABLE
6,2,2019,2,91,187,278,2019-02-06 01:00:00,2019-06-02 00:00:00,LABORABLE
6,2,2019,3,66,131,197,2019-02-06 02:00:00,2019-06-02 00:00:00,LABORABLE
6,2,2019,4,65,103,168,2019-02-06 03:00:00,2019-06-02 00:00:00,LABORABLE
6,2,2019,5,77,90,167,2019-02-06 04:00:00,2019-06-02 00:00:00,LABORABLE
6,2,2019,6,168,152,320,2019-02-06 05:00:00,2019-06-02 00:00:00,LABORABLE
6,2,2019,7,437,405,842,2019-02-06 06:00:00,2019-06-02 00:00:00,LABORABLE
6,2,2019,8,675,608,1283,2019-02-06 07:00:00,2019-06-02 00:00:00,LABORABLE
6,2,2019,9,696,712,1408,2019-02-06 08:00:00,2019-06-02 00:00:00,LABORABLE
6,2,2019,10,670,690,1360,2019-02-06 09:00:00,2019-06-02 00:00:00,LABORABLE
6,2,2019,11,594,695,1289,2019-02-06 10:00:00,2019-06-02 00:00:00,LABORABLE
6,2,2019,12,621,695,1316,2019-02-06 11:00:00,2019-06-02 00:00:00,LABORABLE
6,2,2019,13,605,765,1370,2019-02-06 12:00:00,2019-06-02 00:00:00,LABORABLE
6,2,2019,14,611,713,1324,2019-02-06 13:00:00,2019-06-02 00:00:00,LABORABLE
6,2,2019,15,667,670,1337,2019-02-06 14:00:00,2019-06-02 00:00:00,LABORABLE
6,2,2019,16,638,624,1262,2019-02-06 15:00:00,2019-06-02 00:00:00,LABORABLE
6,2,2019,17,655,771,1426,2019-02-06 16:00:00,2019-06-02 00:00:00,LABORABLE
6,2,2019,18,665,744,1409,2019-02-06 17:00:00,2019-06-02 00:00:00,LABORABLE
6,2,2019,19,724,777,1501,2019-02-06 18:00:00,2019-06-02 00:00:00,LABORABLE
6,2,2019,20,640,772,1412,2019-02-06 19:00:00,2019-06-02 00:00:00,LABORABLE
6,2,2019,21,640,756,1396,2019-02-06 20:00:00,2019-06-02 00:00:00,LABORABLE
6,2,2019,22,446,559,1005,2019-02-06 21:00:00,2019-06-02 00:00:00,LABORABLE
6,2,2019,23,358,373,731,2019-02-06 22:00:00,2019-06-02 00:00:00,LABORABLE
6,2,2019,24,297,353,650,2019-02-06 23:00:00,2019-06-02 00:00:00,LABORABLE
7,2,2019,1,199,273,472,2019-02-07 00:00:00,2019-07-02 00:00:00,LABORABLE
7,2,2019,2,117,194,311,2019-02-07 01:00:00,2019-07-02 00:00:00,LABORABLE
7,2,2019,3,90,145,235,2019-02-07 02:00:00,2019-07-02 00:00:00,LABORABLE
7,2,2019,4,65,93,158,2019-02-07 03:00:00,2019-07-02 00:00:00,LABORABLE
7,2,2019,5,81,103,184,2019-02-07 04:00:00,2019-07-02 00:00:00,LABORABLE
7,2,2019,6,151,162,313,2019-02-07 05:00:00,2019-07-02 00:00:00,LABORABLE
7,2,2019,7,421,397,818,2019-02-07 06:00:00,2019-07-02 00:00:00,LABORABLE
7,2,2019,8,695,627,1322,2019-02-07 07:00:00,2019-07-02 00:00:00,LABORABLE
7,2,2019,9,691,703,1394,2019-02-07 08:00:00,2019-07-02 00:00:00,LABORABLE
7,2,2019,10,713,678,1391,2019-02-07 09:00:00,2019-07-02 00:00:00,LABORABLE
7,2,2019,11,579,612,1191,2019-02-07 10:00:00,2019-07-02 00:00:00,LABORABLE
7,2,2019,12,608,708,1316,2019-02-07 11:00:00,2019-07-02 00:00:00,LABORABLE
7,2,2019,13,623,708,1331,2019-02-07 12:00:00,2019-07-02 00:00:00,LABORABLE
7,2,2019,14,680,760,1440,2019-02-07 13:00:00,2019-07-02 00:00:00,LABORABLE
7,2,2019,15,656,694,1350,2019-02-07 14:00:00,2019-07-02 00:00:00,LABORABLE
7,2,2019,16,683,697,1380,2019-02-07 15:00:00,2019-07-02 00:00:00,LABORABLE
7,2,2019,17,668,694,1362,2019-02-07 16:00:00,2019-07-02 00:00:00,LABORABLE
7,2,2019,18,743,787,1530,2019-02-07 17:00:00,2019-07-02 00:00:00,LABORABLE
7,2,2019,19,703,783,1486,2019-02-07 18:00:00,2019-07-02 00:00:00,LABORABLE
7,2,2019,20,668,761,1429,2019-02-07 19:00:00,2019-07-02 00:00:00,LABORABLE
7,2,2019,21,625,706,1331,2019-02-07 20:00:00,2019-07-02 00:00:00,LABORABLE
7,2,2019,22,575,636,1211,2019-02-07 21:00:00,2019-07-02 00:00:00,LABORABLE
7,2,2019,23,431,504,935,2019-02-07 22:00:00,2019-07-02 00:00:00,LABORABLE
7,2,2019,24,260,368,628,2019-02-07 23:00:00,2019-07-02 00:00:00,LABORABLE
8,2,2019,1,184,390,574,2019-02-08 00:00:00,2019-08-02 00:00:00,LABORABLE
8,2,2019,2,124,223,347,2019-02-08 01:00:00,2019-08-02 00:00:00,LABORABLE
8,2,2019,3,85,203,288,2019-02-08 02:00:00,2019-08-02 00:00:00,LABORABLE
8,2,2019,4,67,129,196,2019-02-08 03:00:00,2019-08-02 00:00:00,LABORABLE
8,2,2019,5,95,130,225,2019-02-08 04:00:00,2019-08-02 00:00:00,LABORABLE
8,2,2019,6,158,171,329,2019-02-08 05:00:00,2019-08-02 00:00:00,LABORABLE
8,2,2019,7,238,416,654,2019-02-08 06:00:00,2019-08-02 00:00:00,LABORABLE
8,2,2019,8,373,546,919,2019-02-08 07:00:00,2019-08-02 00:00:00,LABORABLE
8,2,2019,9,481,718,1199,2019-02-08 08:00:00,2019-08-02 00:00:00,LABORABLE
8,2,2019,10,669,738,1407,2019-02-08 09:00:00,2019-08-02 00:00:00,LABORABLE
8,2,2019,11,613,676,1289,2019-02-08 10:00:00,2019-08-02 00:00:00,LABORABLE
8,2,2019,12,627,743,1370,2019-02-08 11:00:00,2019-08-02 00:00:00,LABORABLE
8,2,2019,13,516,573,1089,2019-02-08 12:00:00,2019-08-02 00:00:00,LABORABLE
8,2,2019,14,727,674,1401,2019-02-08 13:00:00,2019-08-02 00:00:00,LABORABLE
8,2,2019,15,643,775,1418,2019-02-08 14:00:00,2019-08-02 00:00:00,LABORABLE
8,2,2019,16,647,679,1326,2019-02-08 15:00:00,2019-08-02 00:00:00,LABORABLE
8,2,2019,17,666,755,1421,2019-02-08 16:00:00,2019-08-02 00:00:00,LABORABLE
8,2,2019,18,704,747,1451,2019-02-08 17:00:00,2019-08-02 00:00:00,LABORABLE
8,2,2019,19,658,808,1466,2019-02-08 18:00:00,2019-08-02 00:00:00,LABORABLE
8,2,2019,20,689,843,1532,2019-02-08 19:00:00,2019-08-02 00:00:00,LABORABLE
8,2,2019,21,718,893,1611,2019-02-08 20:00:00,2019-08-02 00:00:00,LABORABLE
8,2,2019,22,660,737,1397,2019-02-08 21:00:00,2019-08-02 00:00:00,LABORABLE
8,2,2019,23,542,568,1110,2019-02-08 22:00:00,2019-08-02 00:00:00,LABORABLE
8,2,2019,24,411,508,919,2019-02-08 23:00:00,2019-08-02 00:00:00,LABORABLE
9,2,2019,1,336,285,621,2019-02-09 00:00:00,2019-09-02 00:00:00,LABORABLE
9,2,2019,2,242,185,427,2019-02-09 01:00:00,2019-09-02 00:00:00,LABORABLE
9,2,2019,3,137,131,268,2019-02-09 02:00:00,2019-09-02 00:00:00,LABORABLE
9,2,2019,4,117,106,223,2019-02-09 03:00:00,2019-09-02 00:00:00,LABORABLE
9,2,2019,5,152,79,231,2019-02-09 04:00:00,2019-09-02 00:00:00,LABORABLE
9,2,2019,6,228,102,330,2019-02-09 05:00:00,2019-09-02 00:00:00,LABORABLE
9,2,2019,7,524,272,796,2019-02-09 06:00:00,2019-09-02 00:00:00,LABORABLE
9,2,2019,8,1026,551,1577,2019-02-09 07:00:00,2019-09-02 00:00:00,LABORABLE
9,2,2019,9,1347,726,2073,2019-02-09 08:00:00,2019-09-02 00:00:00,LABORABLE
9,2,2019,10,1278,731,2009,2019-02-09 09:00:00,2019-09-02 00:00:00,LABORABLE
9,2,2019,11,1172,663,1835,2019-02-09 10:00:00,2019-09-02 00:00:00,LABORABLE
9,2,2019,12,1182,742,1924,2019-02-09 11:00:00,2019-09-02 00:00:00,LABORABLE
9,2,2019,13,902,793,1695,2019-02-09 12:00:00,2019-09-02 00:00:00,LABORABLE
9,2,2019,14,1343,809,2152,2019-02-09 13:00:00,2019-09-02 00:00:00,LABORABLE
9,2,2019,15,1303,767,2070,2019-02-09 14:00:00,2019-09-02 00:00:00,LABORABLE
9,2,2019,16,1285,732,2017,2019-02-09 15:00:00,2019-09-02 00:00:00,LABORABLE
9,2,2019,17,1375,744,2119,2019-02-09 16:00:00,2019-09-02 00:00:00,LABORABLE
9,2,2019,18,1410,761,2171,2019-02-09 17:00:00,2019-09-02 00:00:00,LABORABLE
9,2,2019,19,1376,791,2167,2019-02-09 18:00:00,2019-09-02 00:00:00,LABORABLE
9,2,2019,20,1457,765,2222,2019-02-09 19:00:00,2019-09-02 00:00:00,LABORABLE
9,2,2019,21,1349,806,2155,2019-02-09 20:00:00,2019-09-02 00:00:00,LABORABLE
9,2,2019,22,1113,708,1821,2019-02-09 21:00:00,2019-09-02 00:00:00,LABORABLE
9,2,2019,23,790,515,1305,2019-02-09 22:00:00,2019-09-02 00:00:00,LABORABLE
9,2,2019,24,520,368,888,2019-02-09 23:00:00,2019-09-02 00:00:00,LABORABLE
10,2,2019,1,392,302,694,2019-02-10 00:00:00,2019-10-02 00:00:00,LABORABLE
10,2,2019,2,286,220,506,2019-02-10 01:00:00,2019-10-02 00:00:00,LABORABLE
10,2,2019,3,184,161,345,2019-02-10 02:00:00,2019-10-02 00:00:00,LABORABLE
10,2,2019,4,153,141,294,2019-02-10 03:00:00,2019-10-02 00:00:00,LABORABLE
10,2,2019,5,135,97,232,2019-02-10 04:00:00,2019-10-02 00:00:00,LABORABLE
10,2,2019,6,242,118,360,2019-02-10 05:00:00,2019-10-02 00:00:00,LABORABLE
10,2,2019,7,557,358,915,2019-02-10 06:00:00,2019-10-02 00:00:00,LABORABLE
10,2,2019,8,1011,572,1583,2019-02-10 07:00:00,2019-10-02 00:00:00,LABORABLE
10,2,2019,9,1294,702,1996,2019-02-10 08:00:00,2019-10-02 00:00:00,LABORABLE
10,2,2019,10,1255,730,1985,2019-02-10 09:00:00,2019-10-02 00:00:00,LABORABLE
10,2,2019,11,1202,723,1925,2019-02-10 10:00:00,2019-10-02 00:00:00,LABORABLE
10,2,2019,12,1238,713,1951,2019-02-10 11:00:00,2019-10-02 00:00:00,LABORABLE
10,2,2019,13,1356,770,2126,2019-02-10 12:00:00,2019-10-02 00:00:00,LABORABLE
10,2,2019,14,1289,788,2077,2019-02-10 13:00:00,2019-10-02 00:00:00,LABORABLE
10,2,2019,15,1410,774,2184,2019-02-10 14:00:00,2019-10-02 00:00:00,LABORABLE
10,2,2019,16,1241,753,1994,2019-02-10 15:00:00,2019-10-02 00:00:00,LABORABLE
10,2,2019,17,1400,730,2130,2019-02-10 16:00:00,2019-10-02 00:00:00,LABORABLE
10,2,2019,18,1441,754,2195,2019-02-10 17:00:00,2019-10-02 00:00:00,LABORABLE
10,2,2019,19,1495,892,2387,2019-02-10 18:00:00,2019-10-02 00:00:00,LABORABLE
10,2,2019,20,1379,830,2209,2019-02-10 19:00:00,2019-10-02 00:00:00,LABORABLE
10,2,2019,21,1407,797,2204,2019-02-10 20:00:00,2019-10-02 00:00:00,LABORABLE
10,2,2019,22,1391,828,2219,2019-02-10 21:00:00,2019-10-02 00:00:00,LABORABLE
10,2,2019,23,994,639,1633,2019-02-10 22:00:00,2019-10-02 00:00:00,LABORABLE
10,2,2019,24,723,495,1218,2019-02-10 23:00:00,2019-10-02 00:00:00,LABORABLE
11,2,2019,1,161,263,424,2019-02-11 00:00:00,2019-11-02 00:00:00,LABORABLE
11,2,2019,2,96,215,311,2019-02-11 01:00:00,2019-11-02 00:00:00,LABORABLE
11,2,2019,3,71,167,238,2019-02-11 02:00:00,2019-11-02 00:00:00,LABORABLE
11,2,2019,4,74,115,189,2019-02-11 03:00:00,2019-11-02 00:00:00,LABORABLE
11,2,2019,5,65,110,175,2019-02-11 04:00:00,2019-11-02 00:00:00,LABORABLE
11,2,2019,6,119,175,294,2019-02-11 05:00:00,2019-11-02 00:00:00,LABORABLE
11,2,2019,7,444,437,881,2019-02-11 06:00:00,2019-11-02 00:00:00,LABORABLE
11,2,2019,8,678,619,1297,2019-02-11 07:00:00,2019-11-02 00:00:00,LABORABLE
11,2,2019,9,715,713,1428,2019-02-11 08:00:00,2019-11-02 00:00:00,LABORABLE
11,2,2019,10,628,698,1326,2019-02-11 09:00:00,2019-11-02 00:00:00,LABORABLE
11,2,2019,11,541,671,1212,2019-02-11 10:00:00,2019-11-02 00:00:00,LABORABLE
11,2,2019,12,542,722,1264,2019-02-11 11:00:00,2019-11-02 00:00:00,LABORABLE
11,2,2019,13,606,697,1303,2019-02-11 12:00:00,2019-11-02 00:00:00,LABORABLE
11,2,2019,14,640,767,1407,2019-02-11 13:00:00,2019-11-02 00:00:00,LABORABLE
11,2,2019,15,693,698,1391,2019-02-11 14:00:00,2019-11-02 00:00:00,LABORABLE
11,2,2019,16,632,664,1296,2019-02-11 15:00:00,2019-11-02 00:00:00,LABORABLE
11,2,2019,17,653,739,1392,2019-02-11 16:00:00,2019-11-02 00:00:00,LABORABLE
11,2,2019,18,720,679,1399,2019-02-11 17:00:00,2019-11-02 00:00:00,LABORABLE
11,2,2019,19,648,772,1420,2019-02-11 18:00:00,2019-11-02 00:00:00,LABORABLE
11,2,2019,20,620,819,1439,2019-02-11 19:00:00,2019-11-02 00:00:00,LABORABLE
11,2,2019,21,607,681,1288,2019-02-11 20:00:00,2019-11-02 00:00:00,LABORABLE
11,2,2019,22,519,560,1079,2019-02-11 21:00:00,2019-11-02 00:00:00,LABORABLE
11,2,2019,23,352,472,824,2019-02-11 22:00:00,2019-11-02 00:00:00,LABORABLE
11,2,2019,24,238,305,543,2019-02-11 23:00:00,2019-11-02 00:00:00,LABORABLE
12,2,2019,1,143,230,373,2019-02-12 00:00:00,2019-12-02 00:00:00,LABORABLE
12,2,2019,2,98,178,276,2019-02-12 01:00:00,2019-12-02 00:00:00,LABORABLE
12,2,2019,3,74,131,205,2019-02-12 02:00:00,2019-12-02 00:00:00,LABORABLE
12,2,2019,4,60,110,170,2019-02-12 03:00:00,2019-12-02 00:00:00,LABORABLE
12,2,2019,5,68,102,170,2019-02-12 04:00:00,2019-12-02 00:00:00,LABORABLE
12,2,2019,6,148,154,302,2019-02-12 05:00:00,2019-12-02 00:00:00,LABORABLE
12,2,2019,7,421,464,885,2019-02-12 06:00:00,2019-12-02 00:00:00,LABORABLE
12,2,2019,8,695,622,1317,2019-02-12 07:00:00,2019-12-02 00:00:00,LABORABLE
12,2,2019,9,693,760,1453,2019-02-12 08:00:00,2019-12-02 00:00:00,LABORABLE
12,2,2019,10,677,771,1448,2019-02-12 09:00:00,2019-12-02 00:00:00,LABORABLE
12,2,2019,11,550,676,1226,2019-02-12 10:00:00,2019-12-02 00:00:00,LABORABLE
12,2,2019,12,535,625,1160,2019-02-12 11:00:00,2019-12-02 00:00:00,LABORABLE
12,2,2019,13,508,694,1202,2019-02-12 12:00:00,2019-12-02 00:00:00,LABORABLE
12,2,2019,14,685,726,1411,2019-02-12 13:00:00,2019-12-02 00:00:00,LABORABLE
12,2,2019,15,648,716,1364,2019-02-12 14:00:00,2019-12-02 00:00:00,LABORABLE
12,2,2019,16,670,715,1385,2019-02-12 15:00:00,2019-12-02 00:00:00,LABORABLE
12,2,2019,17,672,773,1445,2019-02-12 16:00:00,2019-12-02 00:00:00,LABORABLE
12,2,2019,18,701,725,1426,2019-02-12 17:00:00,2019-12-02 00:00:00,LABORABLE
12,2,2019,19,665,746,1411,2019-02-12 18:00:00,2019-12-02 00:00:00,LABORABLE
12,2,2019,20,611,792,1403,2019-02-12 19:00:00,2019-12-02 00:00:00,LABORABLE
12,2,2019,21,613,757,1370,2019-02-12 20:00:00,2019-12-02 00:00:00,LABORABLE
12,2,2019,22,530,616,1146,2019-02-12 21:00:00,2019-12-02 00:00:00,LABORABLE
12,2,2019,23,383,437,820,2019-02-12 22:00:00,2019-12-02 00:00:00,LABORABLE
12,2,2019,24,218,317,535,2019-02-12 23:00:00,2019-12-02 00:00:00,LABORABLE
13,2,2019,1,162,255,417,2019-02-13 00:00:00,2019-02-13 00:00:00,LABORABLE
13,2,2019,2,108,192,300,2019-02-13 01:00:00,2019-02-13 00:00:00,LABORABLE
13,2,2019,3,55,125,180,2019-02-13 02:00:00,2019-02-13 00:00:00,LABORABLE
13,2,2019,4,67,97,164,2019-02-13 03:00:00,2019-02-13 00:00:00,LABORABLE
13,2,2019,5,75,78,153,2019-02-13 04:00:00,2019-02-13 00:00:00,LABORABLE
13,2,2019,6,164,146,310,2019-02-13 05:00:00,2019-02-13 00:00:00,LABORABLE
13,2,2019,7,442,429,871,2019-02-13 06:00:00,2019-02-13 00:00:00,LABORABLE
13,2,2019,8,687,621,1308,2019-02-13 07:00:00,2019-02-13 00:00:00,LABORABLE
13,2,2019,9,683,703,1386,2019-02-13 08:00:00,2019-02-13 00:00:00,LABORABLE
13,2,2019,10,709,741,1450,2019-02-13 09:00:00,2019-02-13 00:00:00,LABORABLE
13,2,2019,11,574,628,1202,2019-02-13 10:00:00,2019-02-13 00:00:00,LABORABLE
13,2,2019,12,575,654,1229,2019-02-13 11:00:00,2019-02-13 00:00:00,LABORABLE
13,2,2019,13,503,754,1257,2019-02-13 12:00:00,2019-02-13 00:00:00,LABORABLE
13,2,2019,14,624,726,1350,2019-02-13 13:00:00,2019-02-13 00:00:00,LABORABLE
13,2,2019,15,680,687,1367,2019-02-13 14:00:00,2019-02-13 00:00:00,LABORABLE
13,2,2019,16,655,649,1304,2019-02-13 15:00:00,2019-02-13 00:00:00,LABORABLE
13,2,2019,17,683,687,1370,2019-02-13 16:00:00,2019-02-13 00:00:00,LABORABLE
13,2,2019,18,721,753,1474,2019-02-13 17:00:00,2019-02-13 00:00:00,LABORABLE
13,2,2019,19,687,759,1446,2019-02-13 18:00:00,2019-02-13 00:00:00,LABORABLE
13,2,2019,20,669,820,1489,2019-02-13 19:00:00,2019-02-13 00:00:00,LABORABLE
13,2,2019,21,686,745,1431,2019-02-13 20:00:00,2019-02-13 00:00:00,LABORABLE
13,2,2019,22,475,559,1034,2019-02-13 21:00:00,2019-02-13 00:00:00,LABORABLE
13,2,2019,23,373,455,828,2019-02-13 22:00:00,2019-02-13 00:00:00,LABORABLE
13,2,2019,24,281,336,617,2019-02-13 23:00:00,2019-02-13 00:00:00,LABORABLE
14,2,2019,1,175,257,432,2019-02-14 00:00:00,2019-02-14 00:00:00,LABORABLE
14,2,2019,2,121,195,316,2019-02-14 01:00:00,2019-02-14 00:00:00,LABORABLE
14,2,2019,3,68,140,208,2019-02-14 02:00:00,2019-02-14 00:00:00,LABORABLE
14,2,2019,4,65,110,175,2019-02-14 03:00:00,2019-02-14 00:00:00,LABORABLE
14,2,2019,5,70,114,184,2019-02-14 04:00:00,2019-02-14 00:00:00,LABORABLE
14,2,2019,6,164,183,347,2019-02-14 05:00:00,2019-02-14 00:00:00,LABORABLE
14,2,2019,7,431,403,834,2019-02-14 06:00:00,2019-02-14 00:00:00,LABORABLE
14,2,2019,8,690,623,1313,2019-02-14 07:00:00,2019-02-14 00:00:00,LABORABLE
14,2,2019,9,669,711,1380,2019-02-14 08:00:00,2019-02-14 00:00:00,LABORABLE
14,2,2019,10,736,728,1464,2019-02-14 09:00:00,2019-02-14 00:00:00,LABORABLE
14,2,2019,11,612,672,1284,2019-02-14 10:00:00,2019-02-14 00:00:00,LABORABLE
14,2,2019,12,628,750,1378,2019-02-14 11:00:00,2019-02-14 00:00:00,LABORABLE
14,2,2019,13,685,712,1397,2019-02-14 12:00:00,2019-02-14 00:00:00,LABORABLE
14,2,2019,14,688,757,1445,2019-02-14 13:00:00,2019-02-14 00:00:00,LABORABLE
14,2,2019,15,660,728,1388,2019-02-14 14:00:00,2019-02-14 00:00:00,LABORABLE
14,2,2019,16,641,674,1315,2019-02-14 15:00:00,2019-02-14 00:00:00,LABORABLE
14,2,2019,17,745,692,1437,2019-02-14 16:00:00,2019-02-14 00:00:00,LABORABLE
14,2,2019,18,767,728,1495,2019-02-14 17:00:00,2019-02-14 00:00:00,LABORABLE
14,2,2019,19,728,770,1498,2019-02-14 18:00:00,2019-02-14 00:00:00,LABORABLE
14,2,2019,20,692,825,1517,2019-02-14 19:00:00,2019-02-14 00:00:00,LABORABLE
14,2,2019,21,731,808,1539,2019-02-14 20:00:00,2019-02-14 00:00:00,LABORABLE
14,2,2019,22,543,688,1231,2019-02-14 21:00:00,2019-02-14 00:00:00,LABORABLE
14,2,2019,23,448,506,954,2019-02-14 22:00:00,2019-02-14 00:00:00,LABORABLE
14,2,2019,24,315,424,739,2019-02-14 23:00:00,2019-02-14 00:00:00,LABORABLE
15,2,2019,1,224,416,640,2019-02-15 00:00:00,2019-02-15 00:00:00,LABORABLE
15,2,2019,2,160,287,447,2019-02-15 01:00:00,2019-02-15 00:00:00,LABORABLE
15,2,2019,3,121,203,324,2019-02-15 02:00:00,2019-02-15 00:00:00,LABORABLE
15,2,2019,4,82,165,247,2019-02-15 03:00:00,2019-02-15 00:00:00,LABORABLE
15,2,2019,5,84,131,215,2019-02-15 04:00:00,2019-02-15 00:00:00,LABORABLE
15,2,2019,6,183,221,404,2019-02-15 05:00:00,2019-02-15 00:00:00,LABORABLE
15,2,2019,7,238,416,654,2019-02-15 06:00:00,2019-02-15 00:00:00,LABORABLE
15,2,2019,8,373,583,956,2019-02-15 07:00:00,2019-02-15 00:00:00,LABORABLE
15,2,2019,9,677,721,1398,2019-02-15 08:00:00,2019-02-15 00:00:00,LABORABLE
15,2,2019,10,654,695,1349,2019-02-15 09:00:00,2019-02-15 00:00:00,LABORABLE
15,2,2019,11,545,633,1178,2019-02-15 10:00:00,2019-02-15 00:00:00,LABORABLE
15,2,2019,12,499,720,1219,2019-02-15 11:00:00,2019-02-15 00:00:00,LABORABLE
15,2,2019,13,643,707,1350,2019-02-15 12:00:00,2019-02-15 00:00:00,LABORABLE
15,2,2019,14,620,764,1384,2019-02-15 13:00:00,2019-02-15 00:00:00,LABORABLE
15,2,2019,15,706,704,1410,2019-02-15 14:00:00,2019-02-15 00:00:00,LABORABLE
15,2,2019,16,663,738,1401,2019-02-15 15:00:00,2019-02-15 00:00:00,LABORABLE
15,2,2019,17,643,768,1411,2019-02-15 16:00:00,2019-02-15 00:00:00,LABORABLE
15,2,2019,18,730,752,1482,2019-02-15 17:00:00,2019-02-15 00:00:00,LABORABLE
15,2,2019,19,672,807,1479,2019-02-15 18:00:00,2019-02-15 00:00:00,LABORABLE
15,2,2019,20,676,807,1483,2019-02-15 19:00:00,2019-02-15 00:00:00,LABORABLE
15,2,2019,21,676,813,1489,2019-02-15 20:00:00,2019-02-15 00:00:00,LABORABLE
15,2,2019,22,588,681,1269,2019-02-15 21:00:00,2019-02-15 00:00:00,LABORABLE
15,2,2019,23,508,642,1150,2019-02-15 22:00:00,2019-02-15 00:00:00,LABORABLE
15,2,2019,24,393,507,900,2019-02-15 23:00:00,2019-02-15 00:00:00,LABORABLE
16,2,2019,1,334,314,648,2019-02-16 00:00:00,2019-02-16 00:00:00,LABORABLE
16,2,2019,2,222,209,431,2019-02-16 01:00:00,2019-02-16 00:00:00,LABORABLE
16,2,2019,3,161,140,301,2019-02-16 02:00:00,2019-02-16 00:00:00,LABORABLE
16,2,2019,4,131,88,219,2019-02-16 03:00:00,2019-02-16 00:00:00,LABORABLE
16,2,2019,5,133,99,232,2019-02-16 04:00:00,2019-02-16 00:00:00,LABORABLE
16,2,2019,6,215,116,331,2019-02-16 05:00:00,2019-02-16 00:00:00,LABORABLE
16,2,2019,7,555,323,878,2019-02-16 06:00:00,2019-02-16 00:00:00,LABORABLE
16,2,2019,8,1045,553,1598,2019-02-16 07:00:00,2019-02-16 00:00:00,LABORABLE
16,2,2019,9,1318,709,2027,2019-02-16 08:00:00,2019-02-16 00:00:00,LABORABLE
16,2,2019,10,1330,786,2116,2019-02-16 09:00:00,2019-02-16 00:00:00,LABORABLE
16,2,2019,11,1229,706,1935,2019-02-16 10:00:00,2019-02-16 00:00:00,LABORABLE
16,2,2019,12,1226,710,1936,2019-02-16 11:00:00,2019-02-16 00:00:00,LABORABLE
16,2,2019,13,1262,772,2034,2019-02-16 12:00:00,2019-02-16 00:00:00,LABORABLE
16,2,2019,14,1249,713,1962,2019-02-16 13:00:00,2019-02-16 00:00:00,LABORABLE
16,2,2019,15,1333,751,2084,2019-02-16 14:00:00,2019-02-16 00:00:00,LABORABLE
16,2,2019,16,1272,645,1917,2019-02-16 15:00:00,2019-02-16 00:00:00,LABORABLE
16,2,2019,17,1251,760,2011,2019-02-16 16:00:00,2019-02-16 00:00:00,LABORABLE
16,2,2019,18,1322,773,2095,2019-02-16 17:00:00,2019-02-16 00:00:00,LABORABLE
16,2,2019,19,1362,854,2216,2019-02-16 18:00:00,2019-02-16 00:00:00,LABORABLE
16,2,2019,20,1411,841,2252,2019-02-16 19:00:00,2019-02-16 00:00:00,LABORABLE
16,2,2019,21,1373,785,2158,2019-02-16 20:00:00,2019-02-16 00:00:00,LABORABLE
16,2,2019,22,1131,674,1805,2019-02-16 21:00:00,2019-02-16 00:00:00,LABORABLE
16,2,2019,23,890,515,1405,2019-02-16 22:00:00,2019-02-16 00:00:00,LABORABLE
16,2,2019,24,630,353,983,2019-02-16 23:00:00,2019-02-16 00:00:00,LABORABLE
17,2,2019,1,441,329,770,2019-02-17 00:00:00,2019-02-17 00:00:00,LABORABLE
17,2,2019,2,284,220,504,2019-02-17 01:00:00,2019-02-17 00:00:00,LABORABLE
17,2,2019,3,179,185,364,2019-02-17 02:00:00,2019-02-17 00:00:00,LABORABLE
17,2,2019,4,158,125,283,2019-02-17 03:00:00,2019-02-17 00:00:00,LABORABLE
17,2,2019,5,132,106,238,2019-02-17 04:00:00,2019-02-17 00:00:00,LABORABLE
17,2,2019,6,248,144,392,2019-02-17 05:00:00,2019-02-17 00:00:00,LABORABLE
17,2,2019,7,568,319,887,2019-02-17 06:00:00,2019-02-17 00:00:00,LABORABLE
17,2,2019,8,972,534,1506,2019-02-17 07:00:00,2019-02-17 00:00:00,LABORABLE
17,2,2019,9,1216,588,1804,2019-02-17 08:00:00,2019-02-17 00:00:00,LABORABLE
17,2,2019,10,1199,677,1876,2019-02-17 09:00:00,2019-02-17 00:00:00,LABORABLE
17,2,2019,11,1239,665,1904,2019-02-17 10:00:00,2019-02-17 00:00:00,LABORABLE
17,2,2019,12,1222,708,1930,2019-02-17 11:00:00,2019-02-17 00:00:00,LABORABLE
17,2,2019,13,1285,804,2089,2019-02-17 12:00:00,2019-02-17 00:00:00,LABORABLE
17,2,2019,14,1348,824,2172,2019-02-17 13:00:00,2019-02-17 00:00:00,LABORABLE
17,2,2019,15,1340,781,2121,2019-02-17 14:00:00,2019-02-17 00:00:00,LABORABLE
17,2,2019,16,1267,686,1953,2019-02-17 15:00:00,2019-02-17 00:00:00,LABORABLE
17,2,2019,17,1254,732,1986,2019-02-17 16:00:00,2019-02-17 00:00:00,LABORABLE
17,2,2019,18,1381,775,2156,2019-02-17 17:00:00,2019-02-17 00:00:00,LABORABLE
17,2,2019,19,1335,807,2142,2019-02-17 18:00:00,2019-02-17 00:00:00,LABORABLE
17,2,2019,20,1460,834,2294,2019-02-17 19:00:00,2019-02-17 00:00:00,LABORABLE
17,2,2019,21,1383,878,2261,2019-02-17 20:00:00,2019-02-17 00:00:00,LABORABLE
17,2,2019,22,1281,791,2072,2019-02-17 21:00:00,2019-02-17 00:00:00,LABORABLE
17,2,2019,23,1055,616,1671,2019-02-17 22:00:00,2019-02-17 00:00:00,LABORABLE
17,2,2019,24,709,502,1211,2019-02-17 23:00:00,2019-02-17 00:00:00,LABORABLE
18,2,2019,1,186,267,453,2019-02-18 00:00:00,2019-02-18 00:00:00,LABORABLE
18,2,2019,2,120,207,327,2019-02-18 01:00:00,2019-02-18 00:00:00,LABORABLE
18,2,2019,3,83,131,214,2019-02-18 02:00:00,2019-02-18 00:00:00,LABORABLE
18,2,2019,4,64,107,171,2019-02-18 03:00:00,2019-02-18 00:00:00,LABORABLE
18,2,2019,5,63,109,172,2019-02-18 04:00:00,2019-02-18 00:00:00,LABORABLE
18,2,2019,6,145,169,314,2019-02-18 05:00:00,2019-02-18 00:00:00,LABORABLE
18,2,2019,7,440,411,851,2019-02-18 06:00:00,2019-02-18 00:00:00,LABORABLE
18,2,2019,8,666,629,1295,2019-02-18 07:00:00,2019-02-18 00:00:00,LABORABLE
18,2,2019,9,708,714,1422,2019-02-18 08:00:00,2019-02-18 00:00:00,LABORABLE
18,2,2019,10,630,730,1360,2019-02-18 09:00:00,2019-02-18 00:00:00,LABORABLE
18,2,2019,11,546,651,1197,2019-02-18 10:00:00,2019-02-18 00:00:00,LABORABLE
18,2,2019,12,568,663,1231,2019-02-18 11:00:00,2019-02-18 00:00:00,LABORABLE
18,2,2019,13,593,668,1261,2019-02-18 12:00:00,2019-02-18 00:00:00,LABORABLE
18,2,2019,14,613,714,1327,2019-02-18 13:00:00,2019-02-18 00:00:00,LABORABLE
18,2,2019,15,674,670,1344,2019-02-18 14:00:00,2019-02-18 00:00:00,LABORABLE
18,2,2019,16,673,680,1353,2019-02-18 15:00:00,2019-02-18 00:00:00,LABORABLE
18,2,2019,17,665,717,1382,2019-02-18 16:00:00,2019-02-18 00:00:00,LABORABLE
18,2,2019,18,725,758,1483,2019-02-18 17:00:00,2019-02-18 00:00:00,LABORABLE
18,2,2019,19,625,747,1372,2019-02-18 18:00:00,2019-02-18 00:00:00,LABORABLE
18,2,2019,20,680,764,1444,2019-02-18 19:00:00,2019-02-18 00:00:00,LABORABLE
18,2,2019,21,571,672,1243,2019-02-18 20:00:00,2019-02-18 00:00:00,LABORABLE
18,2,2019,22,515,541,1056,2019-02-18 21:00:00,2019-02-18 00:00:00,LABORABLE
18,2,2019,23,347,413,760,2019-02-18 22:00:00,2019-02-18 00:00:00,LABORABLE
18,2,2019,24,228,284,512,2019-02-18 23:00:00,2019-02-18 00:00:00,LABORABLE
19,2,2019,1,154,223,377,2019-02-19 00:00:00,2019-02-19 00:00:00,LABORABLE
19,2,2019,2,93,181,274,2019-02-19 01:00:00,2019-02-19 00:00:00,LABORABLE
19,2,2019,3,78,130,208,2019-02-19 02:00:00,2019-02-19 00:00:00,LABORABLE
19,2,2019,4,67,84,151,2019-02-19 03:00:00,2019-02-19 00:00:00,LABORABLE
19,2,2019,5,66,88,154,2019-02-19 04:00:00,2019-02-19 00:00:00,LABORABLE
19,2,2019,6,157,164,321,2019-02-19 05:00:00,2019-02-19 00:00:00,LABORABLE
19,2,2019,7,398,400,798,2019-02-19 06:00:00,2019-02-19 00:00:00,LABORABLE
19,2,2019,8,686,617,1303,2019-02-19 07:00:00,2019-02-19 00:00:00,LABORABLE
19,2,2019,9,734,675,1409,2019-02-19 08:00:00,2019-02-19 00:00:00,LABORABLE
19,2,2019,10,687,729,1416,2019-02-19 09:00:00,2019-02-19 00:00:00,LABORABLE
19,2,2019,11,554,708,1262,2019-02-19 10:00:00,2019-02-19 00:00:00,LABORABLE
19,2,2019,12,546,657,1203,2019-02-19 11:00:00,2019-02-19 00:00:00,LABORABLE
19,2,2019,13,597,719,1316,2019-02-19 12:00:00,2019-02-19 00:00:00,LABORABLE
19,2,2019,14,621,681,1302,2019-02-19 13:00:00,2019-02-19 00:00:00,LABORABLE
19,2,2019,15,616,676,1292,2019-02-19 14:00:00,2019-02-19 00:00:00,LABORABLE
19,2,2019,16,579,655,1234,2019-02-19 15:00:00,2019-02-19 00:00:00,LABORABLE
19,2,2019,17,653,748,1401,2019-02-19 16:00:00,2019-02-19 00:00:00,LABORABLE
19,2,2019,18,653,758,1411,2019-02-19 17:00:00,2019-02-19 00:00:00,LABORABLE
19,2,2019,19,666,741,1407,2019-02-19 18:00:00,2019-02-19 00:00:00,LABORABLE
19,2,2019,20,635,743,1378,2019-02-19 19:00:00,2019-02-19 00:00:00,LABORABLE
19,2,2019,21,623,755,1378,2019-02-19 20:00:00,2019-02-19 00:00:00,LABORABLE
19,2,2019,22,462,599,1061,2019-02-19 21:00:00,2019-02-19 00:00:00,LABORABLE
19,2,2019,23,346,482,828,2019-02-19 22:00:00,2019-02-19 00:00:00,LABORABLE
19,2,2019,24,226,304,530,2019-02-19 23:00:00,2019-02-19 00:00:00,LABORABLE
20,2,2019,1,178,267,445,2019-02-20 00:00:00,2019-02-20 00:00:00,LABORABLE
20,2,2019,2,107,182,289,2019-02-20 01:00:00,2019-02-20 00:00:00,LABORABLE
20,2,2019,3,72,119,191,2019-02-20 02:00:00,2019-02-20 00:00:00,LABORABLE
20,2,2019,4,68,88,156,2019-02-20 03:00:00,2019-02-20 00:00:00,LABORABLE
20,2,2019,5,73,82,155,2019-02-20 04:00:00,2019-02-20 00:00:00,LABORABLE
20,2,2019,6,145,142,287,2019-02-20 05:00:00,2019-02-20 00:00:00,LABORABLE
20,2,2019,7,430,404,834,2019-02-20 06:00:00,2019-02-20 00:00:00,LABORABLE
20,2,2019,8,664,620,1284,2019-02-20 07:00:00,2019-02-20 00:00:00,LABORABLE
20,2,2019,9,686,736,1422,2019-02-20 08:00:00,2019-02-20 00:00:00,LABORABLE
20,2,2019,10,658,728,1386,2019-02-20 09:00:00,2019-02-20 00:00:00,LABORABLE
20,2,2019,11,572,634,1206,2019-02-20 10:00:00,2019-02-20 00:00:00,LABORABLE
20,2,2019,12,555,673,1228,2019-02-20 11:00:00,2019-02-20 00:00:00,LABORABLE
20,2,2019,13,576,703,1279,2019-02-20 12:00:00,2019-02-20 00:00:00,LABORABLE
20,2,2019,14,431,738,1169,2019-02-20 13:00:00,2019-02-20 00:00:00,LABORABLE
20,2,2019,15,604,699,1303,2019-02-20 14:00:00,2019-02-20 00:00:00,LABORABLE
20,2,2019,16,652,652,1304,2019-02-20 15:00:00,2019-02-20 00:00:00,LABORABLE
20,2,2019,17,646,741,1387,2019-02-20 16:00:00,2019-02-20 00:00:00,LABORABLE
20,2,2019,18,705,747,1452,2019-02-20 17:00:00,2019-02-20 00:00:00,LABORABLE
20,2,2019,19,692,762,1454,2019-02-20 18:00:00,2019-02-20 00:00:00,LABORABLE
20,2,2019,20,646,741,1387,2019-02-20 19:00:00,2019-02-20 00:00:00,LABORABLE
20,2,2019,21,643,664,1307,2019-02-20 20:00:00,2019-02-20 00:00:00,LABORABLE
20,2,2019,22,473,581,1054,2019-02-20 21:00:00,2019-02-20 00:00:00,LABORABLE
20,2,2019,23,359,429,788,2019-02-20 22:00:00,2019-02-20 00:00:00,LABORABLE
20,2,2019,24,251,311,562,2019-02-20 23:00:00,2019-02-20 00:00:00,LABORABLE
21,2,2019,1,197,257,454,2019-02-21 00:00:00,2019-02-21 00:00:00,LABORABLE
21,2,2019,2,130,178,308,2019-02-21 01:00:00,2019-02-21 00:00:00,LABORABLE
21,2,2019,3,77,119,196,2019-02-21 02:00:00,2019-02-21 00:00:00,LABORABLE
21,2,2019,4,80,116,196,2019-02-21 03:00:00,2019-02-21 00:00:00,LABORABLE
21,2,2019,5,76,100,176,2019-02-21 04:00:00,2019-02-21 00:00:00,LABORABLE
21,2,2019,6,139,153,292,2019-02-21 05:00:00,2019-02-21 00:00:00,LABORABLE
21,2,2019,7,443,410,853,2019-02-21 06:00:00,2019-02-21 00:00:00,LABORABLE
21,2,2019,8,729,616,1345,2019-02-21 07:00:00,2019-02-21 00:00:00,LABORABLE
21,2,2019,9,692,701,1393,2019-02-21 08:00:00,2019-02-21 00:00:00,LABORABLE
21,2,2019,10,675,676,1351,2019-02-21 09:00:00,2019-02-21 00:00:00,LABORABLE
21,2,2019,11,572,683,1255,2019-02-21 10:00:00,2019-02-21 00:00:00,LABORABLE
21,2,2019,12,610,644,1254,2019-02-21 11:00:00,2019-02-21 00:00:00,LABORABLE
21,2,2019,13,580,738,1318,2019-02-21 12:00:00,2019-02-21 00:00:00,LABORABLE
21,2,2019,14,590,740,1330,2019-02-21 13:00:00,2019-02-21 00:00:00,LABORABLE
21,2,2019,15,665,692,1357,2019-02-21 14:00:00,2019-02-21 00:00:00,LABORABLE
21,2,2019,16,614,664,1278,2019-02-21 15:00:00,2019-02-21 00:00:00,LABORABLE
21,2,2019,17,670,709,1379,2019-02-21 16:00:00,2019-02-21 00:00:00,LABORABLE
21,2,2019,18,710,746,1456,2019-02-21 17:00:00,2019-02-21 00:00:00,LABORABLE
21,2,2019,19,657,754,1411,2019-02-21 18:00:00,2019-02-21 00:00:00,LABORABLE
21,2,2019,20,659,764,1423,2019-02-21 19:00:00,2019-02-21 00:00:00,LABORABLE
21,2,2019,21,635,733,1368,2019-02-21 20:00:00,2019-02-21 00:00:00,LABORABLE
21,2,2019,22,561,606,1167,2019-02-21 21:00:00,2019-02-21 00:00:00,LABORABLE
21,2,2019,23,435,517,952,2019-02-21 22:00:00,2019-02-21 00:00:00,LABORABLE
21,2,2019,24,277,393,670,2019-02-21 23:00:00,2019-02-21 00:00:00,LABORABLE
22,2,2019,1,183,316,499,2019-02-22 00:00:00,2019-02-22 00:00:00,LABORABLE
22,2,2019,2,138,223,361,2019-02-22 01:00:00,2019-02-22 00:00:00,LABORABLE
22,2,2019,3,88,223,311,2019-02-22 02:00:00,2019-02-22 00:00:00,LABORABLE
22,2,2019,4,68,172,240,2019-02-22 03:00:00,2019-02-22 00:00:00,LABORABLE
22,2,2019,5,77,128,205,2019-02-22 04:00:00,2019-02-22 00:00:00,LABORABLE
22,2,2019,6,151,172,323,2019-02-22 05:00:00,2019-02-22 00:00:00,LABORABLE
22,2,2019,7,238,402,640,2019-02-22 06:00:00,2019-02-22 00:00:00,LABORABLE
22,2,2019,8,373,586,959,2019-02-22 07:00:00,2019-02-22 00:00:00,LABORABLE
22,2,2019,9,699,726,1425,2019-02-22 08:00:00,2019-02-22 00:00:00,LABORABLE
22,2,2019,10,658,716,1374,2019-02-22 09:00:00,2019-02-22 00:00:00,LABORABLE
22,2,2019,11,618,722,1340,2019-02-22 10:00:00,2019-02-22 00:00:00,LABORABLE
22,2,2019,12,559,733,1292,2019-02-22 11:00:00,2019-02-22 00:00:00,LABORABLE
22,2,2019,13,677,689,1366,2019-02-22 12:00:00,2019-02-22 00:00:00,LABORABLE
22,2,2019,14,485,769,1254,2019-02-22 13:00:00,2019-02-22 00:00:00,LABORABLE
22,2,2019,15,695,808,1503,2019-02-22 14:00:00,2019-02-22 00:00:00,LABORABLE
22,2,2019,16,693,681,1374,2019-02-22 15:00:00,2019-02-22 00:00:00,LABORABLE
22,2,2019,17,706,722,1428,2019-02-22 16:00:00,2019-02-22 00:00:00,LABORABLE
22,2,2019,18,688,779,1467,2019-02-22 17:00:00,2019-02-22 00:00:00,LABORABLE
22,2,2019,19,664,826,1490,2019-02-22 18:00:00,2019-02-22 00:00:00,LABORABLE
22,2,2019,20,689,823,1512,2019-02-22 19:00:00,2019-02-22 00:00:00,LABORABLE
22,2,2019,21,702,803,1505,2019-02-22 20:00:00,2019-02-22 00:00:00,LABORABLE
22,2,2019,22,618,667,1285,2019-02-22 21:00:00,2019-02-22 00:00:00,LABORABLE
22,2,2019,23,525,612,1137,2019-02-22 22:00:00,2019-02-22 00:00:00,LABORABLE
22,2,2019,24,447,489,936,2019-02-22 23:00:00,2019-02-22 00:00:00,LABORABLE
23,2,2019,1,323,251,574,2019-02-23 00:00:00,2019-02-23 00:00:00,LABORABLE
23,2,2019,2,254,187,441,2019-02-23 01:00:00,2019-02-23 00:00:00,LABORABLE
23,2,2019,3,114,119,233,2019-02-23 02:00:00,2019-02-23 00:00:00,LABORABLE
23,2,2019,4,125,110,235,2019-02-23 03:00:00,2019-02-23 00:00:00,LABORABLE
23,2,2019,5,111,73,184,2019-02-23 04:00:00,2019-02-23 00:00:00,LABORABLE
23,2,2019,6,220,108,328,2019-02-23 05:00:00,2019-02-23 00:00:00,LABORABLE
23,2,2019,7,542,318,860,2019-02-23 06:00:00,2019-02-23 00:00:00,LABORABLE
23,2,2019,8,1070,534,1604,2019-02-23 07:00:00,2019-02-23 00:00:00,LABORABLE
23,2,2019,9,1338,714,2052,2019-02-23 08:00:00,2019-02-23 00:00:00,LABORABLE
23,2,2019,10,1334,765,2099,2019-02-23 09:00:00,2019-02-23 00:00:00,LABORABLE
23,2,2019,11,1242,661,1903,2019-02-23 10:00:00,2019-02-23 00:00:00,LABORABLE
23,2,2019,12,1265,725,1990,2019-02-23 11:00:00,2019-02-23 00:00:00,LABORABLE
23,2,2019,13,1267,730,1997,2019-02-23 12:00:00,2019-02-23 00:00:00,LABORABLE
23,2,2019,14,974,726,1700,2019-02-23 13:00:00,2019-02-23 00:00:00,LABORABLE
23,2,2019,15,1245,690,1935,2019-02-23 14:00:00,2019-02-23 00:00:00,LABORABLE
23,2,2019,16,1251,673,1924,2019-02-23 15:00:00,2019-02-23 00:00:00,LABORABLE
23,2,2019,17,1343,711,2054,2019-02-23 16:00:00,2019-02-23 00:00:00,LABORABLE
23,2,2019,18,1411,794,2205,2019-02-23 17:00:00,2019-02-23 00:00:00,LABORABLE
23,2,2019,19,1357,798,2155,2019-02-23 18:00:00,2019-02-23 00:00:00,LABORABLE
23,2,2019,20,1443,772,2215,2019-02-23 19:00:00,2019-02-23 00:00:00,LABORABLE
23,2,2019,21,1330,724,2054,2019-02-23 20:00:00,2019-02-23 00:00:00,LABORABLE
23,2,2019,22,1132,675,1807,2019-02-23 21:00:00,2019-02-23 00:00:00,LABORABLE
23,2,2019,23,795,526,1321,2019-02-23 22:00:00,2019-02-23 00:00:00,LABORABLE
23,2,2019,24,621,354,975,2019-02-23 23:00:00,2019-02-23 00:00:00,LABORABLE
24,2,2019,1,412,271,683,2019-02-24 00:00:00,2019-02-24 00:00:00,LABORABLE
24,2,2019,2,208,195,403,2019-02-24 01:00:00,2019-02-24 00:00:00,LABORABLE
24,2,2019,3,170,135,305,2019-02-24 02:00:00,2019-02-24 00:00:00,LABORABLE
24,2,2019,4,146,110,256,2019-02-24 03:00:00,2019-02-24 00:00:00,LABORABLE
24,2,2019,5,135,98,233,2019-02-24 04:00:00,2019-02-24 00:00:00,LABORABLE
24,2,2019,6,209,114,323,2019-02-24 05:00:00,2019-02-24 00:00:00,LABORABLE
24,2,2019,7,558,339,897,2019-02-24 06:00:00,2019-02-24 00:00:00,LABORABLE
24,2,2019,8,977,589,1566,2019-02-24 07:00:00,2019-02-24 00:00:00,LABORABLE
24,2,2019,9,1263,754,2017,2019-02-24 08:00:00,2019-02-24 00:00:00,LABORABLE
24,2,2019,10,1238,774,2012,2019-02-24 09:00:00,2019-02-24 00:00:00,LABORABLE
24,2,2019,11,1171,713,1884,2019-02-24 10:00:00,2019-02-24 00:00:00,LABORABLE
24,2,2019,12,1192,701,1893,2019-02-24 11:00:00,2019-02-24 00:00:00,LABORABLE
24,2,2019,13,1319,735,2054,2019-02-24 12:00:00,2019-02-24 00:00:00,LABORABLE
24,2,2019,14,1339,785,2124,2019-02-24 13:00:00,2019-02-24 00:00:00,LABORABLE
24,2,2019,15,1387,720,2107,2019-02-24 14:00:00,2019-02-24 00:00:00,LABORABLE
24,2,2019,16,1245,703,1948,2019-02-24 15:00:00,2019-02-24 00:00:00,LABORABLE
24,2,2019,17,1369,777,2146,2019-02-24 16:00:00,2019-02-24 00:00:00,LABORABLE
24,2,2019,18,1401,803,2204,2019-02-24 17:00:00,2019-02-24 00:00:00,LABORABLE
24,2,2019,19,1446,801,2247,2019-02-24 18:00:00,2019-02-24 00:00:00,LABORABLE
24,2,2019,20,1457,818,2275,2019-02-24 19:00:00,2019-02-24 00:00:00,LABORABLE
24,2,2019,21,1413,847,2260,2019-02-24 20:00:00,2019-02-24 00:00:00,LABORABLE
24,2,2019,22,1269,810,2079,2019-02-24 21:00:00,2019-02-24 00:00:00,LABORABLE
24,2,2019,23,1064,648,1712,2019-02-24 22:00:00,2019-02-24 00:00:00,LABORABLE
24,2,2019,24,804,492,1296,2019-02-24 23:00:00,2019-02-24 00:00:00,LABORABLE
25,2,2019,1,181,301,482,2019-02-25 00:00:00,2019-02-25 00:00:00,LABORABLE
25,2,2019,2,94,199,293,2019-02-25 01:00:00,2019-02-25 00:00:00,LABORABLE
25,2,2019,3,96,136,232,2019-02-25 02:00:00,2019-02-25 00:00:00,LABORABLE
25,2,2019,4,93,128,221,2019-02-25 03:00:00,2019-02-25 00:00:00,LABORABLE
25,2,2019,5,68,114,182,2019-02-25 04:00:00,2019-02-25 00:00:00,LABORABLE
25,2,2019,6,152,152,304,2019-02-25 05:00:00,2019-02-25 00:00:00,LABORABLE
25,2,2019,7,419,418,837,2019-02-25 06:00:00,2019-02-25 00:00:00,LABORABLE
25,2,2019,8,700,600,1300,2019-02-25 07:00:00,2019-02-25 00:00:00,LABORABLE
25,2,2019,9,683,673,1356,2019-02-25 08:00:00,2019-02-25 00:00:00,LABORABLE
25,2,2019,10,633,709,1342,2019-02-25 09:00:00,2019-02-25 00:00:00,LABORABLE
25,2,2019,11,546,673,1219,2019-02-25 10:00:00,2019-02-25 00:00:00,LABORABLE
25,2,2019,12,585,710,1295,2019-02-25 11:00:00,2019-02-25 00:00:00,LABORABLE
25,2,2019,13,599,726,1325,2019-02-25 12:00:00,2019-02-25 00:00:00,LABORABLE
25,2,2019,14,631,689,1320,2019-02-25 13:00:00,2019-02-25 00:00:00,LABORABLE
25,2,2019,15,500,854,1354,2019-02-25 14:00:00,2019-02-25 00:00:00,LABORABLE
25,2,2019,16,628,672,1300,2019-02-25 15:00:00,2019-02-25 00:00:00,LABORABLE
25,2,2019,17,648,724,1372,2019-02-25 16:00:00,2019-02-25 00:00:00,LABORABLE
25,2,2019,18,668,725,1393,2019-02-25 17:00:00,2019-02-25 00:00:00,LABORABLE
25,2,2019,19,647,788,1435,2019-02-25 18:00:00,2019-02-25 00:00:00,LABORABLE
25,2,2019,20,605,784,1389,2019-02-25 19:00:00,2019-02-25 00:00:00,LABORABLE
25,2,2019,21,609,713,1322,2019-02-25 20:00:00,2019-02-25 00:00:00,LABORABLE
25,2,2019,22,520,578,1098,2019-02-25 21:00:00,2019-02-25 00:00:00,LABORABLE
25,2,2019,23,363,454,817,2019-02-25 22:00:00,2019-02-25 00:00:00,LABORABLE
25,2,2019,24,211,313,524,2019-02-25 23:00:00,2019-02-25 00:00:00,LABORABLE
26,2,2019,1,165,270,435,2019-02-26 00:00:00,2019-02-26 00:00:00,LABORABLE
26,2,2019,2,94,162,256,2019-02-26 01:00:00,2019-02-26 00:00:00,LABORABLE
26,2,2019,3,75,122,197,2019-02-26 02:00:00,2019-02-26 00:00:00,LABORABLE
26,2,2019,4,55,88,143,2019-02-26 03:00:00,2019-02-26 00:00:00,LABORABLE
26,2,2019,5,79,112,191,2019-02-26 04:00:00,2019-02-26 00:00:00,LABORABLE
26,2,2019,6,157,145,302,2019-02-26 05:00:00,2019-02-26 00:00:00,LABORABLE
26,2,2019,7,445,424,869,2019-02-26 06:00:00,2019-02-26 00:00:00,LABORABLE
26,2,2019,8,694,625,1319,2019-02-26 07:00:00,2019-02-26 00:00:00,LABORABLE
26,2,2019,9,673,718,1391,2019-02-26 08:00:00,2019-02-26 00:00:00,LABORABLE
26,2,2019,10,652,696,1348,2019-02-26 09:00:00,2019-02-26 00:00:00,LABORABLE
26,2,2019,11,492,658,1150,2019-02-26 10:00:00,2019-02-26 00:00:00,LABORABLE
26,2,2019,12,491,656,1147,2019-02-26 11:00:00,2019-02-26 00:00:00,LABORABLE
26,2,2019,13,574,710,1284,2019-02-26 12:00:00,2019-02-26 00:00:00,LABORABLE
26,2,2019,14,614,726,1340,2019-02-26 13:00:00,2019-02-26 00:00:00,LABORABLE
26,2,2019,15,618,739,1357,2019-02-26 14:00:00,2019-02-26 00:00:00,LABORABLE
26,2,2019,16,630,663,1293,2019-02-26 15:00:00,2019-02-26 00:00:00,LABORABLE
26,2,2019,17,599,670,1269,2019-02-26 16:00:00,2019-02-26 00:00:00,LABORABLE
26,2,2019,18,646,757,1403,2019-02-26 17:00:00,2019-02-26 00:00:00,LABORABLE
26,2,2019,19,754,780,1534,2019-02-26 18:00:00,2019-02-26 00:00:00,LABORABLE
26,2,2019,20,734,803,1537,2019-02-26 19:00:00,2019-02-26 00:00:00,LABORABLE
26,2,2019,21,600,672,1272,2019-02-26 20:00:00,2019-02-26 00:00:00,LABORABLE
26,2,2019,22,477,603,1080,2019-02-26 21:00:00,2019-02-26 00:00:00,LABORABLE
26,2,2019,23,363,460,823,2019-02-26 22:00:00,2019-02-26 00:00:00,LABORABLE
26,2,2019,24,220,313,533,2019-02-26 23:00:00,2019-02-26 00:00:00,LABORABLE
27,2,2019,1,156,234,390,2019-02-27 00:00:00,2019-02-27 00:00:00,LABORABLE
27,2,2019,2,110,176,286,2019-02-27 01:00:00,2019-02-27 00:00:00,LABORABLE
27,2,2019,3,59,110,169,2019-02-27 02:00:00,2019-02-27 00:00:00,LABORABLE
27,2,2019,4,59,93,152,2019-02-27 03:00:00,2019-02-27 00:00:00,LABORABLE
27,2,2019,5,69,92,161,2019-02-27 04:00:00,2019-02-27 00:00:00,LABORABLE
27,2,2019,6,147,149,296,2019-02-27 05:00:00,2019-02-27 00:00:00,LABORABLE
27,2,2019,7,303,433,736,2019-02-27 06:00:00,2019-02-27 00:00:00,LABORABLE
27,2,2019,8,671,655,1326,2019-02-27 07:00:00,2019-02-27 00:00:00,LABORABLE
27,2,2019,9,669,705,1374,2019-02-27 08:00:00,2019-02-27 00:00:00,LABORABLE
27,2,2019,10,608,713,1321,2019-02-27 09:00:00,2019-02-27 00:00:00,LABORABLE
27,2,2019,11,541,675,1216,2019-02-27 10:00:00,2019-02-27 00:00:00,LABORABLE
27,2,2019,12,597,654,1251,2019-02-27 11:00:00,2019-02-27 00:00:00,LABORABLE
27,2,2019,13,559,702,1261,2019-02-27 12:00:00,2019-02-27 00:00:00,LABORABLE
27,2,2019,14,442,741,1183,2019-02-27 13:00:00,2019-02-27 00:00:00,LABORABLE
27,2,2019,15,558,677,1235,2019-02-27 14:00:00,2019-02-27 00:00:00,LABORABLE
27,2,2019,16,611,669,1280,2019-02-27 15:00:00,2019-02-27 00:00:00,LABORABLE
27,2,2019,17,640,656,1296,2019-02-27 16:00:00,2019-02-27 00:00:00,LABORABLE
27,2,2019,18,695,695,1390,2019-02-27 17:00:00,2019-02-27 00:00:00,LABORABLE
27,2,2019,19,651,749,1400,2019-02-27 18:00:00,2019-02-27 00:00:00,LABORABLE
27,2,2019,20,650,701,1351,2019-02-27 19:00:00,2019-02-27 00:00:00,LABORABLE
27,2,2019,21,667,733,1400,2019-02-27 20:00:00,2019-02-27 00:00:00,LABORABLE
27,2,2019,22,483,533,1016,2019-02-27 21:00:00,2019-02-27 00:00:00,LABORABLE
27,2,2019,23,340,420,760,2019-02-27 22:00:00,2019-02-27 00:00:00,LABORABLE
27,2,2019,24,300,372,672,2019-02-27 23:00:00,2019-02-27 00:00:00,LABORABLE
28,2,2019,1,178,261,439,2019-02-28 00:00:00,2019-02-28 00:00:00,LABORABLE
28,2,2019,2,123,192,315,2019-02-28 01:00:00,2019-02-28 00:00:00,LABORABLE
28,2,2019,3,83,137,220,2019-02-28 02:00:00,2019-02-28 00:00:00,LABORABLE
28,2,2019,4,72,118,190,2019-02-28 03:00:00,2019-02-28 00:00:00,LABORABLE
28,2,2019,5,78,109,187,2019-02-28 04:00:00,2019-02-28 00:00:00,LABORABLE
28,2,2019,6,152,170,322,2019-02-28 05:00:00,2019-02-28 00:00:00,LABORABLE
28,2,2019,7,431,433,864,2019-02-28 06:00:00,2019-02-28 00:00:00,LABORABLE
28,2,2019,8,657,581,1238,2019-02-28 07:00:00,2019-02-28 00:00:00,LABORABLE
28,2,2019,9,711,793,1504,2019-02-28 08:00:00,2019-02-28 00:00:00,LABORABLE
28,2,2019,10,658,678,1336,2019-02-28 09:00:00,2019-02-28 00:00:00,LABORABLE
28,2,2019,11,589,659,1248,2019-02-28 10:00:00,2019-02-28 00:00:00,LABORABLE
28,2,2019,12,578,702,1280,2019-02-28 11:00:00,2019-02-28 00:00:00,LABORABLE
28,2,2019,13,575,688,1263,2019-02-28 12:00:00,2019-02-28 00:00:00,LABORABLE
28,2,2019,14,604,725,1329,2019-02-28 13:00:00,2019-02-28 00:00:00,LABORABLE
28,2,2019,15,671,707,1378,2019-02-28 14:00:00,2019-02-28 00:00:00,LABORABLE
28,2,2019,16,602,622,1224,2019-02-28 15:00:00,2019-02-28 00:00:00,LABORABLE
28,2,2019,17,615,726,1341,2019-02-28 16:00:00,2019-02-28 00:00:00,LABORABLE
28,2,2019,18,680,776,1456,2019-02-28 17:00:00,2019-02-28 00:00:00,LABORABLE
28,2,2019,19,661,764,1425,2019-02-28 18:00:00,2019-02-28 00:00:00,LABORABLE
28,2,2019,20,664,769,1433,2019-02-28 19:00:00,2019-02-28 00:00:00,LABORABLE
28,2,2019,21,644,767,1411,2019-02-28 20:00:00,2019-02-28 00:00:00,LABORABLE
28,2,2019,22,630,707,1337,2019-02-28 21:00:00,2019-02-28 00:00:00,LABORABLE
28,2,2019,23,436,522,958,2019-02-28 22:00:00,2019-02-28 00:00:00,LABORABLE
28,2,2019,24,370,400,770,2019-02-28 23:00:00,2019-02-28 00:00:00,LABORABLE
1,3,2019,1,203,348,551,2019-03-01 00:00:00,2019-01-03 00:00:00,LABORABLE
1,3,2019,2,159,228,387,2019-03-01 01:00:00,2019-01-03 00:00:00,LABORABLE
1,3,2019,3,107,174,281,2019-03-01 02:00:00,2019-01-03 00:00:00,LABORABLE
1,3,2019,4,89,154,243,2019-03-01 03:00:00,2019-01-03 00:00:00,LABORABLE
1,3,2019,5,98,127,225,2019-03-01 04:00:00,2019-01-03 00:00:00,LABORABLE
1,3,2019,6,160,193,353,2019-03-01 05:00:00,2019-01-03 00:00:00,LABORABLE
1,3,2019,7,410,399,809,2019-03-01 06:00:00,2019-01-03 00:00:00,LABORABLE
1,3,2019,8,654,603,1257,2019-03-01 07:00:00,2019-01-03 00:00:00,LABORABLE
1,3,2019,9,556,654,1210,2019-03-01 08:00:00,2019-01-03 00:00:00,LABORABLE
1,3,2019,10,595,704,1299,2019-03-01 09:00:00,2019-01-03 00:00:00,LABORABLE
1,3,2019,11,564,645,1209,2019-03-01 10:00:00,2019-01-03 00:00:00,LABORABLE
1,3,2019,12,606,736,1342,2019-03-01 11:00:00,2019-01-03 00:00:00,LABORABLE
1,3,2019,13,643,755,1398,2019-03-01 12:00:00,2019-01-03 00:00:00,LABORABLE
1,3,2019,14,515,618,1133,2019-03-01 13:00:00,2019-01-03 00:00:00,LABORABLE
1,3,2019,15,653,738,1391,2019-03-01 14:00:00,2019-01-03 00:00:00,LABORABLE
1,3,2019,16,632,686,1318,2019-03-01 15:00:00,2019-01-03 00:00:00,LABORABLE
1,3,2019,17,649,778,1427,2019-03-01 16:00:00,2019-01-03 00:00:00,LABORABLE
1,3,2019,18,690,786,1476,2019-03-01 17:00:00,2019-01-03 00:00:00,LABORABLE
1,3,2019,19,700,782,1482,2019-03-01 18:00:00,2019-01-03 00:00:00,LABORABLE
1,3,2019,20,665,848,1513,2019-03-01 19:00:00,2019-01-03 00:00:00,LABORABLE
1,3,2019,21,674,833,1507,2019-03-01 20:00:00,2019-01-03 00:00:00,LABORABLE
1,3,2019,22,590,776,1366,2019-03-01 21:00:00,2019-01-03 00:00:00,LABORABLE
1,3,2019,23,458,593,1051,2019-03-01 22:00:00,2019-01-03 00:00:00,LABORABLE
1,3,2019,24,428,542,970,2019-03-01 23:00:00,2019-01-03 00:00:00,LABORABLE
2,3,2019,1,317,478,795,2019-03-02 00:00:00,2019-02-03 00:00:00,LABORABLE
2,3,2019,2,240,389,629,2019-03-02 01:00:00,2019-02-03 00:00:00,LABORABLE
2,3,2019,3,211,321,532,2019-03-02 02:00:00,2019-02-03 00:00:00,LABORABLE
2,3,2019,4,162,268,430,2019-03-02 03:00:00,2019-02-03 00:00:00,LABORABLE
2,3,2019,5,138,253,391,2019-03-02 04:00:00,2019-02-03 00:00:00,LABORABLE
2,3,2019,6,150,232,382,2019-03-02 05:00:00,2019-02-03 00:00:00,LABORABLE
2,3,2019,7,222,287,509,2019-03-02 06:00:00,2019-02-03 00:00:00,LABORABLE
2,3,2019,8,271,287,558,2019-03-02 07:00:00,2019-02-03 00:00:00,LABORABLE
2,3,2019,9,360,383,743,2019-03-02 08:00:00,2019-02-03 00:00:00,LABORABLE
2,3,2019,10,442,536,978,2019-03-02 09:00:00,2019-02-03 00:00:00,LABORABLE
2,3,2019,11,583,649,1232,2019-03-02 10:00:00,2019-02-03 00:00:00,LABORABLE
2,3,2019,12,668,655,1323,2019-03-02 11:00:00,2019-02-03 00:00:00,LABORABLE
2,3,2019,13,669,782,1451,2019-03-02 12:00:00,2019-02-03 00:00:00,LABORABLE
2,3,2019,14,662,793,1455,2019-03-02 13:00:00,2019-02-03 00:00:00,LABORABLE
2,3,2019,15,637,772,1409,2019-03-02 14:00:00,2019-02-03 00:00:00,LABORABLE
2,3,2019,16,477,690,1167,2019-03-02 15:00:00,2019-02-03 00:00:00,LABORABLE
2,3,2019,17,515,737,1252,2019-03-02 16:00:00,2019-02-03 00:00:00,LABORABLE
2,3,2019,18,527,747,1274,2019-03-02 17:00:00,2019-02-03 00:00:00,LABORABLE
2,3,2019,19,617,726,1343,2019-03-02 18:00:00,2019-02-03 00:00:00,LABORABLE
2,3,2019,20,578,733,1311,2019-03-02 19:00:00,2019-02-03 00:00:00,LABORABLE
2,3,2019,21,547,685,1232,2019-03-02 20:00:00,2019-02-03 00:00:00,LABORABLE
2,3,2019,22,526,623,1149,2019-03-02 21:00:00,2019-02-03 00:00:00,LABORABLE
2,3,2019,23,478,562,1040,2019-03-02 22:00:00,2019-02-03 00:00:00,LABORABLE
2,3,2019,24,451,503,954,2019-03-02 23:00:00,2019-02-03 00:00:00,LABORABLE
3,3,2019,1,359,529,888,2019-03-03 00:00:00,2019-03-03 00:00:00,LABORABLE
3,3,2019,2,298,494,792,2019-03-03 01:00:00,2019-03-03 00:00:00,LABORABLE
3,3,2019,3,232,387,619,2019-03-03 02:00:00,2019-03-03 00:00:00,LABORABLE
3,3,2019,4,193,330,523,2019-03-03 03:00:00,2019-03-03 00:00:00,LABORABLE
3,3,2019,5,176,296,472,2019-03-03 04:00:00,2019-03-03 00:00:00,LABORABLE
3,3,2019,6,158,278,436,2019-03-03 05:00:00,2019-03-03 00:00:00,LABORABLE
3,3,2019,7,187,261,448,2019-03-03 06:00:00,2019-03-03 00:00:00,LABORABLE
3,3,2019,8,182,227,409,2019-03-03 07:00:00,2019-03-03 00:00:00,LABORABLE
3,3,2019,9,240,263,503,2019-03-03 08:00:00,2019-03-03 00:00:00,LABORABLE
3,3,2019,10,336,394,730,2019-03-03 09:00:00,2019-03-03 00:00:00,LABORABLE
3,3,2019,11,491,518,1009,2019-03-03 10:00:00,2019-03-03 00:00:00,LABORABLE
3,3,2019,12,512,579,1091,2019-03-03 11:00:00,2019-03-03 00:00:00,LABORABLE
3,3,2019,13,555,643,1198,2019-03-03 12:00:00,2019-03-03 00:00:00,LABORABLE
3,3,2019,14,569,671,1240,2019-03-03 13:00:00,2019-03-03 00:00:00,LABORABLE
3,3,2019,15,530,773,1303,2019-03-03 14:00:00,2019-03-03 00:00:00,LABORABLE
3,3,2019,16,438,661,1099,2019-03-03 15:00:00,2019-03-03 00:00:00,LABORABLE
3,3,2019,17,474,728,1202,2019-03-03 16:00:00,2019-03-03 00:00:00,LABORABLE
3,3,2019,18,562,706,1268,2019-03-03 17:00:00,2019-03-03 00:00:00,LABORABLE
3,3,2019,19,528,681,1209,2019-03-03 18:00:00,2019-03-03 00:00:00,LABORABLE
3,3,2019,20,550,728,1278,2019-03-03 19:00:00,2019-03-03 00:00:00,LABORABLE
3,3,2019,21,551,685,1236,2019-03-03 20:00:00,2019-03-03 00:00:00,LABORABLE
3,3,2019,22,537,616,1153,2019-03-03 21:00:00,2019-03-03 00:00:00,LABORABLE
3,3,2019,23,436,460,896,2019-03-03 22:00:00,2019-03-03 00:00:00,LABORABLE
3,3,2019,24,278,387,665,2019-03-03 23:00:00,2019-03-03 00:00:00,LABORABLE
4,3,2019,1,185,320,505,2019-03-04 00:00:00,2019-04-03 00:00:00,LABORABLE
4,3,2019,2,128,234,362,2019-03-04 01:00:00,2019-04-03 00:00:00,LABORABLE
4,3,2019,3,111,164,275,2019-03-04 02:00:00,2019-04-03 00:00:00,LABORABLE
4,3,2019,4,88,127,215,2019-03-04 03:00:00,2019-04-03 00:00:00,LABORABLE
4,3,2019,5,86,129,215,2019-03-04 04:00:00,2019-04-03 00:00:00,LABORABLE
4,3,2019,6,156,180,336,2019-03-04 05:00:00,2019-04-03 00:00:00,LABORABLE
4,3,2019,7,405,404,809,2019-03-04 06:00:00,2019-04-03 00:00:00,LABORABLE
4,3,2019,8,636,590,1226,2019-03-04 07:00:00,2019-04-03 00:00:00,LABORABLE
4,3,2019,9,532,633,1165,2019-03-04 08:00:00,2019-04-03 00:00:00,LABORABLE
4,3,2019,10,576,630,1206,2019-03-04 09:00:00,2019-04-03 00:00:00,LABORABLE
4,3,2019,11,574,699,1273,2019-03-04 10:00:00,2019-04-03 00:00:00,LABORABLE
4,3,2019,12,560,695,1255,2019-03-04 11:00:00,2019-04-03 00:00:00,LABORABLE
4,3,2019,13,640,723,1363,2019-03-04 12:00:00,2019-04-03 00:00:00,LABORABLE
4,3,2019,14,638,691,1329,2019-03-04 13:00:00,2019-04-03 00:00:00,LABORABLE
4,3,2019,15,583,697,1280,2019-03-04 14:00:00,2019-04-03 00:00:00,LABORABLE
4,3,2019,16,611,665,1276,2019-03-04 15:00:00,2019-04-03 00:00:00,LABORABLE
4,3,2019,17,624,655,1279,2019-03-04 16:00:00,2019-04-03 00:00:00,LABORABLE
4,3,2019,18,692,770,1462,2019-03-04 17:00:00,2019-04-03 00:00:00,LABORABLE
4,3,2019,19,666,764,1430,2019-03-04 18:00:00,2019-04-03 00:00:00,LABORABLE
4,3,2019,20,623,780,1403,2019-03-04 19:00:00,2019-04-03 00:00:00,LABORABLE
4,3,2019,21,651,738,1389,2019-03-04 20:00:00,2019-04-03 00:00:00,LABORABLE
4,3,2019,22,500,581,1081,2019-03-04 21:00:00,2019-04-03 00:00:00,LABORABLE
4,3,2019,23,361,423,784,2019-03-04 22:00:00,2019-04-03 00:00:00,LABORABLE
4,3,2019,24,231,341,572,2019-03-04 23:00:00,2019-04-03 00:00:00,LABORABLE
5,3,2019,1,155,241,396,2019-03-05 00:00:00,2019-05-03 00:00:00,LABORABLE
5,3,2019,2,95,181,276,2019-03-05 01:00:00,2019-05-03 00:00:00,LABORABLE
5,3,2019,3,66,126,192,2019-03-05 02:00:00,2019-05-03 00:00:00,LABORABLE
5,3,2019,4,52,83,135,2019-03-05 03:00:00,2019-05-03 00:00:00,LABORABLE
5,3,2019,5,58,112,170,2019-03-05 04:00:00,2019-05-03 00:00:00,LABORABLE
5,3,2019,6,169,151,320,2019-03-05 05:00:00,2019-05-03 00:00:00,LABORABLE
5,3,2019,7,406,416,822,2019-03-05 06:00:00,2019-05-03 00:00:00,LABORABLE
5,3,2019,8,683,653,1336,2019-03-05 07:00:00,2019-05-03 00:00:00,LABORABLE
5,3,2019,9,678,701,1379,2019-03-05 08:00:00,2019-05-03 00:00:00,LABORABLE
5,3,2019,10,612,720,1332,2019-03-05 09:00:00,2019-05-03 00:00:00,LABORABLE
5,3,2019,11,534,597,1131,2019-03-05 10:00:00,2019-05-03 00:00:00,LABORABLE
5,3,2019,12,573,678,1251,2019-03-05 11:00:00,2019-05-03 00:00:00,LABORABLE
5,3,2019,13,625,719,1344,2019-03-05 12:00:00,2019-05-03 00:00:00,LABORABLE
5,3,2019,14,599,724,1323,2019-03-05 13:00:00,2019-05-03 00:00:00,LABORABLE
5,3,2019,15,664,728,1392,2019-03-05 14:00:00,2019-05-03 00:00:00,LABORABLE
5,3,2019,16,624,673,1297,2019-03-05 15:00:00,2019-05-03 00:00:00,LABORABLE
5,3,2019,17,599,758,1357,2019-03-05 16:00:00,2019-05-03 00:00:00,LABORABLE
5,3,2019,18,661,729,1390,2019-03-05 17:00:00,2019-05-03 00:00:00,LABORABLE
5,3,2019,19,662,834,1496,2019-03-05 18:00:00,2019-05-03 00:00:00,LABORABLE
5,3,2019,20,640,859,1499,2019-03-05 19:00:00,2019-05-03 00:00:00,LABORABLE
5,3,2019,21,638,744,1382,2019-03-05 20:00:00,2019-05-03 00:00:00,LABORABLE
5,3,2019,22,476,571,1047,2019-03-05 21:00:00,2019-05-03 00:00:00,LABORABLE
5,3,2019,23,341,425,766,2019-03-05 22:00:00,2019-05-03 00:00:00,LABORABLE
5,3,2019,24,261,314,575,2019-03-05 23:00:00,2019-05-03 00:00:00,LABORABLE
6,3,2019,1,151,223,374,2019-03-06 00:00:00,2019-06-03 00:00:00,LABORABLE
6,3,2019,2,113,162,275,2019-03-06 01:00:00,2019-06-03 00:00:00,LABORABLE
6,3,2019,3,62,111,173,2019-03-06 02:00:00,2019-06-03 00:00:00,LABORABLE
6,3,2019,4,76,117,193,2019-03-06 03:00:00,2019-06-03 00:00:00,LABORABLE
6,3,2019,5,66,85,151,2019-03-06 04:00:00,2019-06-03 00:00:00,LABORABLE
6,3,2019,6,157,148,305,2019-03-06 05:00:00,2019-06-03 00:00:00,LABORABLE
6,3,2019,7,417,427,844,2019-03-06 06:00:00,2019-06-03 00:00:00,LABORABLE
6,3,2019,8,693,642,1335,2019-03-06 07:00:00,2019-06-03 00:00:00,LABORABLE
6,3,2019,9,680,724,1404,2019-03-06 08:00:00,2019-06-03 00:00:00,LABORABLE
6,3,2019,10,648,670,1318,2019-03-06 09:00:00,2019-06-03 00:00:00,LABORABLE
6,3,2019,11,489,627,1116,2019-03-06 10:00:00,2019-06-03 00:00:00,LABORABLE
6,3,2019,12,589,727,1316,2019-03-06 11:00:00,2019-06-03 00:00:00,LABORABLE
6,3,2019,13,568,752,1320,2019-03-06 12:00:00,2019-06-03 00:00:00,LABORABLE
6,3,2019,14,509,592,1101,2019-03-06 13:00:00,2019-06-03 00:00:00,LABORABLE
6,3,2019,15,634,707,1341,2019-03-06 14:00:00,2019-06-03 00:00:00,LABORABLE
6,3,2019,16,605,644,1249,2019-03-06 15:00:00,2019-06-03 00:00:00,LABORABLE
6,3,2019,17,639,696,1335,2019-03-06 16:00:00,2019-06-03 00:00:00,LABORABLE
6,3,2019,18,657,740,1397,2019-03-06 17:00:00,2019-06-03 00:00:00,LABORABLE
6,3,2019,19,705,780,1485,2019-03-06 18:00:00,2019-06-03 00:00:00,LABORABLE
6,3,2019,20,602,774,1376,2019-03-06 19:00:00,2019-06-03 00:00:00,LABORABLE
6,3,2019,21,653,723,1376,2019-03-06 20:00:00,2019-06-03 00:00:00,LABORABLE
6,3,2019,22,511,594,1105,2019-03-06 21:00:00,2019-06-03 00:00:00,LABORABLE
6,3,2019,23,390,493,883,2019-03-06 22:00:00,2019-06-03 00:00:00,LABORABLE
6,3,2019,24,231,355,586,2019-03-06 23:00:00,2019-06-03 00:00:00,LABORABLE
7,3,2019,1,196,261,457,2019-03-07 00:00:00,2019-07-03 00:00:00,LABORABLE
7,3,2019,2,101,158,259,2019-03-07 01:00:00,2019-07-03 00:00:00,LABORABLE
7,3,2019,3,89,164,253,2019-03-07 02:00:00,2019-07-03 00:00:00,LABORABLE
7,3,2019,4,68,113,181,2019-03-07 03:00:00,2019-07-03 00:00:00,LABORABLE
7,3,2019,5,74,107,181,2019-03-07 04:00:00,2019-07-03 00:00:00,LABORABLE
7,3,2019,6,154,155,309,2019-03-07 05:00:00,2019-07-03 00:00:00,LABORABLE
7,3,2019,7,455,434,889,2019-03-07 06:00:00,2019-07-03 00:00:00,LABORABLE
7,3,2019,8,688,595,1283,2019-03-07 07:00:00,2019-07-03 00:00:00,LABORABLE
7,3,2019,9,652,719,1371,2019-03-07 08:00:00,2019-07-03 00:00:00,LABORABLE
7,3,2019,10,649,720,1369,2019-03-07 09:00:00,2019-07-03 00:00:00,LABORABLE
7,3,2019,11,529,704,1233,2019-03-07 10:00:00,2019-07-03 00:00:00,LABORABLE
7,3,2019,12,488,577,1065,2019-03-07 11:00:00,2019-07-03 00:00:00,LABORABLE
7,3,2019,13,625,751,1376,2019-03-07 12:00:00,2019-07-03 00:00:00,LABORABLE
7,3,2019,14,604,685,1289,2019-03-07 13:00:00,2019-07-03 00:00:00,LABORABLE
7,3,2019,15,601,719,1320,2019-03-07 14:00:00,2019-07-03 00:00:00,LABORABLE
7,3,2019,16,639,693,1332,2019-03-07 15:00:00,2019-07-03 00:00:00,LABORABLE
7,3,2019,17,673,757,1430,2019-03-07 16:00:00,2019-07-03 00:00:00,LABORABLE
7,3,2019,18,653,819,1472,2019-03-07 17:00:00,2019-07-03 00:00:00,LABORABLE
7,3,2019,19,681,729,1410,2019-03-07 18:00:00,2019-07-03 00:00:00,LABORABLE
7,3,2019,20,677,782,1459,2019-03-07 19:00:00,2019-07-03 00:00:00,LABORABLE
7,3,2019,21,662,801,1463,2019-03-07 20:00:00,2019-07-03 00:00:00,LABORABLE
7,3,2019,22,584,664,1248,2019-03-07 21:00:00,2019-07-03 00:00:00,LABORABLE
7,3,2019,23,455,512,967,2019-03-07 22:00:00,2019-07-03 00:00:00,LABORABLE
7,3,2019,24,281,383,664,2019-03-07 23:00:00,2019-07-03 00:00:00,LABORABLE
8,3,2019,1,216,306,522,2019-03-08 00:00:00,2019-08-03 00:00:00,LABORABLE
8,3,2019,2,140,226,366,2019-03-08 01:00:00,2019-08-03 00:00:00,LABORABLE
8,3,2019,3,86,182,268,2019-03-08 02:00:00,2019-08-03 00:00:00,LABORABLE
8,3,2019,4,79,163,242,2019-03-08 03:00:00,2019-08-03 00:00:00,LABORABLE
8,3,2019,5,89,134,223,2019-03-08 04:00:00,2019-08-03 00:00:00,LABORABLE
8,3,2019,6,164,174,338,2019-03-08 05:00:00,2019-08-03 00:00:00,LABORABLE
8,3,2019,7,453,438,891,2019-03-08 06:00:00,2019-08-03 00:00:00,LABORABLE
8,3,2019,8,676,634,1310,2019-03-08 07:00:00,2019-08-03 00:00:00,LABORABLE
8,3,2019,9,625,748,1373,2019-03-08 08:00:00,2019-08-03 00:00:00,LABORABLE
8,3,2019,10,586,691,1277,2019-03-08 09:00:00,2019-08-03 00:00:00,LABORABLE
8,3,2019,11,249,324,573,2019-03-08 10:00:00,2019-08-03 00:00:00,LABORABLE
8,3,2019,12,610,703,1313,2019-03-08 11:00:00,2019-08-03 00:00:00,LABORABLE
8,3,2019,13,698,673,1371,2019-03-08 12:00:00,2019-08-03 00:00:00,LABORABLE
8,3,2019,14,744,781,1525,2019-03-08 13:00:00,2019-08-03 00:00:00,LABORABLE
8,3,2019,15,630,687,1317,2019-03-08 14:00:00,2019-08-03 00:00:00,LABORABLE
8,3,2019,16,643,721,1364,2019-03-08 15:00:00,2019-08-03 00:00:00,LABORABLE
8,3,2019,17,641,711,1352,2019-03-08 16:00:00,2019-08-03 00:00:00,LABORABLE
8,3,2019,18,718,795,1513,2019-03-08 17:00:00,2019-08-03 00:00:00,LABORABLE
8,3,2019,19,657,776,1433,2019-03-08 18:00:00,2019-08-03 00:00:00,LABORABLE
8,3,2019,20,634,823,1457,2019-03-08 19:00:00,2019-08-03 00:00:00,LABORABLE
8,3,2019,21,690,908,1598,2019-03-08 20:00:00,2019-08-03 00:00:00,LABORABLE
8,3,2019,22,641,769,1410,2019-03-08 21:00:00,2019-08-03 00:00:00,LABORABLE
8,3,2019,23,572,675,1247,2019-03-08 22:00:00,2019-08-03 00:00:00,LABORABLE
8,3,2019,24,365,548,913,2019-03-08 23:00:00,2019-08-03 00:00:00,LABORABLE
9,3,2019,1,326,516,842,2019-03-09 00:00:00,2019-09-03 00:00:00,LABORABLE
9,3,2019,2,258,373,631,2019-03-09 01:00:00,2019-09-03 00:00:00,LABORABLE
9,3,2019,3,212,310,522,2019-03-09 02:00:00,2019-09-03 00:00:00,LABORABLE
9,3,2019,4,155,249,404,2019-03-09 03:00:00,2019-09-03 00:00:00,LABORABLE
9,3,2019,5,119,210,329,2019-03-09 04:00:00,2019-09-03 00:00:00,LABORABLE
9,3,2019,6,151,247,398,2019-03-09 05:00:00,2019-09-03 00:00:00,LABORABLE
9,3,2019,7,211,266,477,2019-03-09 06:00:00,2019-09-03 00:00:00,LABORABLE
9,3,2019,8,300,319,619,2019-03-09 07:00:00,2019-09-03 00:00:00,LABORABLE
9,3,2019,9,379,407,786,2019-03-09 08:00:00,2019-09-03 00:00:00,LABORABLE
9,3,2019,10,455,498,953,2019-03-09 09:00:00,2019-09-03 00:00:00,LABORABLE
9,3,2019,11,625,624,1249,2019-03-09 10:00:00,2019-09-03 00:00:00,LABORABLE
9,3,2019,12,608,716,1324,2019-03-09 11:00:00,2019-09-03 00:00:00,LABORABLE
9,3,2019,13,695,791,1486,2019-03-09 12:00:00,2019-09-03 00:00:00,LABORABLE
9,3,2019,14,640,765,1405,2019-03-09 13:00:00,2019-09-03 00:00:00,LABORABLE
9,3,2019,15,651,792,1443,2019-03-09 14:00:00,2019-09-03 00:00:00,LABORABLE
9,3,2019,16,553,701,1254,2019-03-09 15:00:00,2019-09-03 00:00:00,LABORABLE
9,3,2019,17,487,712,1199,2019-03-09 16:00:00,2019-09-03 00:00:00,LABORABLE
9,3,2019,18,543,834,1377,2019-03-09 17:00:00,2019-09-03 00:00:00,LABORABLE
9,3,2019,19,607,764,1371,2019-03-09 18:00:00,2019-09-03 00:00:00,LABORABLE
9,3,2019,20,619,782,1401,2019-03-09 19:00:00,2019-09-03 00:00:00,LABORABLE
9,3,2019,21,578,757,1335,2019-03-09 20:00:00,2019-09-03 00:00:00,LABORABLE
9,3,2019,22,606,692,1298,2019-03-09 21:00:00,2019-09-03 00:00:00,LABORABLE
9,3,2019,23,594,613,1207,2019-03-09 22:00:00,2019-09-03 00:00:00,LABORABLE
9,3,2019,24,388,568,956,2019-03-09 23:00:00,2019-09-03 00:00:00,LABORABLE
10,3,2019,1,368,538,906,2019-03-10 00:00:00,2019-10-03 00:00:00,LABORABLE
10,3,2019,2,315,484,799,2019-03-10 01:00:00,2019-10-03 00:00:00,LABORABLE
10,3,2019,3,271,369,640,2019-03-10 02:00:00,2019-10-03 00:00:00,LABORABLE
10,3,2019,4,178,331,509,2019-03-10 03:00:00,2019-10-03 00:00:00,LABORABLE
10,3,2019,5,142,296,438,2019-03-10 04:00:00,2019-10-03 00:00:00,LABORABLE
10,3,2019,6,157,319,476,2019-03-10 05:00:00,2019-10-03 00:00:00,LABORABLE
10,3,2019,7,197,272,469,2019-03-10 06:00:00,2019-10-03 00:00:00,LABORABLE
10,3,2019,8,197,262,459,2019-03-10 07:00:00,2019-10-03 00:00:00,LABORABLE
10,3,2019,9,240,316,556,2019-03-10 08:00:00,2019-10-03 00:00:00,LABORABLE
10,3,2019,10,355,426,781,2019-03-10 09:00:00,2019-10-03 00:00:00,LABORABLE
10,3,2019,11,430,513,943,2019-03-10 10:00:00,2019-10-03 00:00:00,LABORABLE
10,3,2019,12,543,634,1177,2019-03-10 11:00:00,2019-10-03 00:00:00,LABORABLE
10,3,2019,13,578,646,1224,2019-03-10 12:00:00,2019-10-03 00:00:00,LABORABLE
10,3,2019,14,591,694,1285,2019-03-10 13:00:00,2019-10-03 00:00:00,LABORABLE
10,3,2019,15,600,683,1283,2019-03-10 14:00:00,2019-10-03 00:00:00,LABORABLE
10,3,2019,16,472,655,1127,2019-03-10 15:00:00,2019-10-03 00:00:00,LABORABLE
10,3,2019,17,478,472,950,2019-03-10 16:00:00,2019-10-03 00:00:00,LABORABLE
10,3,2019,18,521,747,1268,2019-03-10 17:00:00,2019-10-03 00:00:00,LABORABLE
10,3,2019,19,534,700,1234,2019-03-10 18:00:00,2019-10-03 00:00:00,LABORABLE
10,3,2019,20,555,732,1287,2019-03-10 19:00:00,2019-10-03 00:00:00,LABORABLE
10,3,2019,21,612,684,1296,2019-03-10 20:00:00,2019-10-03 00:00:00,LABORABLE
10,3,2019,22,542,597,1139,2019-03-10 21:00:00,2019-10-03 00:00:00,LABORABLE
10,3,2019,23,390,458,848,2019-03-10 22:00:00,2019-10-03 00:00:00,LABORABLE
10,3,2019,24,277,362,639,2019-03-10 23:00:00,2019-10-03 00:00:00,LABORABLE
11,3,2019,1,188,317,505,2019-03-11 00:00:00,2019-11-03 00:00:00,LABORABLE
11,3,2019,2,111,220,331,2019-03-11 01:00:00,2019-11-03 00:00:00,LABORABLE
11,3,2019,3,87,180,267,2019-03-11 02:00:00,2019-11-03 00:00:00,LABORABLE
11,3,2019,4,71,128,199,2019-03-11 03:00:00,2019-11-03 00:00:00,LABORABLE
11,3,2019,5,72,112,184,2019-03-11 04:00:00,2019-11-03 00:00:00,LABORABLE
11,3,2019,6,163,161,324,2019-03-11 05:00:00,2019-11-03 00:00:00,LABORABLE
11,3,2019,7,427,437,864,2019-03-11 06:00:00,2019-11-03 00:00:00,LABORABLE
11,3,2019,8,671,632,1303,2019-03-11 07:00:00,2019-11-03 00:00:00,LABORABLE
11,3,2019,9,652,661,1313,2019-03-11 08:00:00,2019-11-03 00:00:00,LABORABLE
11,3,2019,10,542,736,1278,2019-03-11 09:00:00,2019-11-03 00:00:00,LABORABLE
11,3,2019,11,519,665,1184,2019-03-11 10:00:00,2019-11-03 00:00:00,LABORABLE
11,3,2019,12,575,664,1239,2019-03-11 11:00:00,2019-11-03 00:00:00,LABORABLE
11,3,2019,13,496,543,1039,2019-03-11 12:00:00,2019-11-03 00:00:00,LABORABLE
11,3,2019,14,590,656,1246,2019-03-11 13:00:00,2019-11-03 00:00:00,LABORABLE
11,3,2019,15,661,715,1376,2019-03-11 14:00:00,2019-11-03 00:00:00,LABORABLE
11,3,2019,16,584,693,1277,2019-03-11 15:00:00,2019-11-03 00:00:00,LABORABLE
11,3,2019,17,635,715,1350,2019-03-11 16:00:00,2019-11-03 00:00:00,LABORABLE
11,3,2019,18,617,701,1318,2019-03-11 17:00:00,2019-11-03 00:00:00,LABORABLE
11,3,2019,19,646,805,1451,2019-03-11 18:00:00,2019-11-03 00:00:00,LABORABLE
11,3,2019,20,616,733,1349,2019-03-11 19:00:00,2019-11-03 00:00:00,LABORABLE
11,3,2019,21,616,719,1335,2019-03-11 20:00:00,2019-11-03 00:00:00,LABORABLE
11,3,2019,22,497,638,1135,2019-03-11 21:00:00,2019-11-03 00:00:00,LABORABLE
11,3,2019,23,366,426,792,2019-03-11 22:00:00,2019-11-03 00:00:00,LABORABLE
11,3,2019,24,216,331,547,2019-03-11 23:00:00,2019-11-03 00:00:00,LABORABLE
12,3,2019,1,153,246,399,2019-03-12 00:00:00,2019-12-03 00:00:00,LABORABLE
12,3,2019,2,108,189,297,2019-03-12 01:00:00,2019-12-03 00:00:00,LABORABLE
12,3,2019,3,68,123,191,2019-03-12 02:00:00,2019-12-03 00:00:00,LABORABLE
12,3,2019,4,61,93,154,2019-03-12 03:00:00,2019-12-03 00:00:00,LABORABLE
12,3,2019,5,74,101,175,2019-03-12 04:00:00,2019-12-03 00:00:00,LABORABLE
12,3,2019,6,154,172,326,2019-03-12 05:00:00,2019-12-03 00:00:00,LABORABLE
12,3,2019,7,416,410,826,2019-03-12 06:00:00,2019-12-03 00:00:00,LABORABLE
12,3,2019,8,685,615,1300,2019-03-12 07:00:00,2019-12-03 00:00:00,LABORABLE
12,3,2019,9,627,748,1375,2019-03-12 08:00:00,2019-12-03 00:00:00,LABORABLE
12,3,2019,10,585,696,1281,2019-03-12 09:00:00,2019-12-03 00:00:00,LABORABLE
12,3,2019,11,551,690,1241,2019-03-12 10:00:00,2019-12-03 00:00:00,LABORABLE
12,3,2019,12,570,668,1238,2019-03-12 11:00:00,2019-12-03 00:00:00,LABORABLE
12,3,2019,13,618,695,1313,2019-03-12 12:00:00,2019-12-03 00:00:00,LABORABLE
12,3,2019,14,615,731,1346,2019-03-12 13:00:00,2019-12-03 00:00:00,LABORABLE
12,3,2019,15,598,727,1325,2019-03-12 14:00:00,2019-12-03 00:00:00,LABORABLE
12,3,2019,16,595,647,1242,2019-03-12 15:00:00,2019-12-03 00:00:00,LABORABLE
12,3,2019,17,633,713,1346,2019-03-12 16:00:00,2019-12-03 00:00:00,LABORABLE
12,3,2019,18,669,760,1429,2019-03-12 17:00:00,2019-12-03 00:00:00,LABORABLE
12,3,2019,19,646,749,1395,2019-03-12 18:00:00,2019-12-03 00:00:00,LABORABLE
12,3,2019,20,576,761,1337,2019-03-12 19:00:00,2019-12-03 00:00:00,LABORABLE
12,3,2019,21,623,707,1330,2019-03-12 20:00:00,2019-12-03 00:00:00,LABORABLE
12,3,2019,22,429,575,1004,2019-03-12 21:00:00,2019-12-03 00:00:00,LABORABLE
12,3,2019,23,347,392,739,2019-03-12 22:00:00,2019-12-03 00:00:00,LABORABLE
12,3,2019,24,259,326,585,2019-03-12 23:00:00,2019-12-03 00:00:00,LABORABLE
13,3,2019,1,168,224,392,2019-03-13 00:00:00,2019-03-13 00:00:00,LABORABLE
13,3,2019,2,118,182,300,2019-03-13 01:00:00,2019-03-13 00:00:00,LABORABLE
13,3,2019,3,79,130,209,2019-03-13 02:00:00,2019-03-13 00:00:00,LABORABLE
13,3,2019,4,71,93,164,2019-03-13 03:00:00,2019-03-13 00:00:00,LABORABLE
13,3,2019,5,81,109,190,2019-03-13 04:00:00,2019-03-13 00:00:00,LABORABLE
13,3,2019,6,151,160,311,2019-03-13 05:00:00,2019-03-13 00:00:00,LABORABLE
13,3,2019,7,417,436,853,2019-03-13 06:00:00,2019-03-13 00:00:00,LABORABLE
13,3,2019,8,693,693,1386,2019-03-13 07:00:00,2019-03-13 00:00:00,LABORABLE
13,3,2019,9,651,778,1429,2019-03-13 08:00:00,2019-03-13 00:00:00,LABORABLE
13,3,2019,10,632,663,1295,2019-03-13 09:00:00,2019-03-13 00:00:00,LABORABLE
13,3,2019,11,540,676,1216,2019-03-13 10:00:00,2019-03-13 00:00:00,LABORABLE
13,3,2019,12,412,485,897,2019-03-13 11:00:00,2019-03-13 00:00:00,LABORABLE
13,3,2019,13,586,696,1282,2019-03-13 12:00:00,2019-03-13 00:00:00,LABORABLE
13,3,2019,14,603,684,1287,2019-03-13 13:00:00,2019-03-13 00:00:00,LABORABLE
13,3,2019,15,634,735,1369,2019-03-13 14:00:00,2019-03-13 00:00:00,LABORABLE
13,3,2019,16,577,699,1276,2019-03-13 15:00:00,2019-03-13 00:00:00,LABORABLE
13,3,2019,17,623,700,1323,2019-03-13 16:00:00,2019-03-13 00:00:00,LABORABLE
13,3,2019,18,679,719,1398,2019-03-13 17:00:00,2019-03-13 00:00:00,LABORABLE
13,3,2019,19,691,799,1490,2019-03-13 18:00:00,2019-03-13 00:00:00,LABORABLE
13,3,2019,20,641,755,1396,2019-03-13 19:00:00,2019-03-13 00:00:00,LABORABLE
13,3,2019,21,618,732,1350,2019-03-13 20:00:00,2019-03-13 00:00:00,LABORABLE
13,3,2019,22,527,604,1131,2019-03-13 21:00:00,2019-03-13 00:00:00,LABORABLE
13,3,2019,23,382,458,840,2019-03-13 22:00:00,2019-03-13 00:00:00,LABORABLE
13,3,2019,24,276,371,647,2019-03-13 23:00:00,2019-03-13 00:00:00,LABORABLE
14,3,2019,1,210,278,488,2019-03-14 00:00:00,2019-03-14 00:00:00,LABORABLE
14,3,2019,2,108,178,286,2019-03-14 01:00:00,2019-03-14 00:00:00,LABORABLE
14,3,2019,3,75,135,210,2019-03-14 02:00:00,2019-03-14 00:00:00,LABORABLE
14,3,2019,4,79,99,178,2019-03-14 03:00:00,2019-03-14 00:00:00,LABORABLE
14,3,2019,5,66,108,174,2019-03-14 04:00:00,2019-03-14 00:00:00,LABORABLE
14,3,2019,6,152,182,334,2019-03-14 05:00:00,2019-03-14 00:00:00,LABORABLE
14,3,2019,7,433,421,854,2019-03-14 06:00:00,2019-03-14 00:00:00,LABORABLE
14,3,2019,8,693,645,1338,2019-03-14 07:00:00,2019-03-14 00:00:00,LABORABLE
14,3,2019,9,680,702,1382,2019-03-14 08:00:00,2019-03-14 00:00:00,LABORABLE
14,3,2019,10,669,681,1350,2019-03-14 09:00:00,2019-03-14 00:00:00,LABORABLE
14,3,2019,11,582,650,1232,2019-03-14 10:00:00,2019-03-14 00:00:00,LABORABLE
14,3,2019,12,611,692,1303,2019-03-14 11:00:00,2019-03-14 00:00:00,LABORABLE
14,3,2019,13,531,578,1109,2019-03-14 12:00:00,2019-03-14 00:00:00,LABORABLE
14,3,2019,14,579,728,1307,2019-03-14 13:00:00,2019-03-14 00:00:00,LABORABLE
14,3,2019,15,651,672,1323,2019-03-14 14:00:00,2019-03-14 00:00:00,LABORABLE
14,3,2019,16,626,631,1257,2019-03-14 15:00:00,2019-03-14 00:00:00,LABORABLE
14,3,2019,17,642,734,1376,2019-03-14 16:00:00,2019-03-14 00:00:00,LABORABLE
14,3,2019,18,686,736,1422,2019-03-14 17:00:00,2019-03-14 00:00:00,LABORABLE
14,3,2019,19,667,755,1422,2019-03-14 18:00:00,2019-03-14 00:00:00,LABORABLE
14,3,2019,20,650,754,1404,2019-03-14 19:00:00,2019-03-14 00:00:00,LABORABLE
14,3,2019,21,647,738,1385,2019-03-14 20:00:00,2019-03-14 00:00:00,LABORABLE
14,3,2019,22,581,633,1214,2019-03-14 21:00:00,2019-03-14 00:00:00,LABORABLE
14,3,2019,23,426,458,884,2019-03-14 22:00:00,2019-03-14 00:00:00,LABORABLE
14,3,2019,24,286,415,701,2019-03-14 23:00:00,2019-03-14 00:00:00,LABORABLE
15,3,2019,1,205,274,479,2019-03-15 00:00:00,2019-03-15 00:00:00,LABORABLE
15,3,2019,2,127,226,353,2019-03-15 01:00:00,2019-03-15 00:00:00,LABORABLE
15,3,2019,3,99,181,280,2019-03-15 02:00:00,2019-03-15 00:00:00,LABORABLE
15,3,2019,4,104,112,216,2019-03-15 03:00:00,2019-03-15 00:00:00,LABORABLE
15,3,2019,5,85,126,211,2019-03-15 04:00:00,2019-03-15 00:00:00,LABORABLE
15,3,2019,6,165,181,346,2019-03-15 05:00:00,2019-03-15 00:00:00,LABORABLE
15,3,2019,7,446,450,896,2019-03-15 06:00:00,2019-03-15 00:00:00,LABORABLE
15,3,2019,8,682,605,1287,2019-03-15 07:00:00,2019-03-15 00:00:00,LABORABLE
15,3,2019,9,654,714,1368,2019-03-15 08:00:00,2019-03-15 00:00:00,LABORABLE
15,3,2019,10,612,684,1296,2019-03-15 09:00:00,2019-03-15 00:00:00,LABORABLE
15,3,2019,11,577,716,1293,2019-03-15 10:00:00,2019-03-15 00:00:00,LABORABLE
15,3,2019,12,625,667,1292,2019-03-15 11:00:00,2019-03-15 00:00:00,LABORABLE
15,3,2019,13,628,716,1344,2019-03-15 12:00:00,2019-03-15 00:00:00,LABORABLE
15,3,2019,14,668,724,1392,2019-03-15 13:00:00,2019-03-15 00:00:00,LABORABLE
15,3,2019,15,673,704,1377,2019-03-15 14:00:00,2019-03-15 00:00:00,LABORABLE
15,3,2019,16,663,693,1356,2019-03-15 15:00:00,2019-03-15 00:00:00,LABORABLE
15,3,2019,17,614,755,1369,2019-03-15 16:00:00,2019-03-15 00:00:00,LABORABLE
15,3,2019,18,667,775,1442,2019-03-15 17:00:00,2019-03-15 00:00:00,LABORABLE
15,3,2019,19,648,764,1412,2019-03-15 18:00:00,2019-03-15 00:00:00,LABORABLE
15,3,2019,20,621,790,1411,2019-03-15 19:00:00,2019-03-15 00:00:00,LABORABLE
15,3,2019,21,670,815,1485,2019-03-15 20:00:00,2019-03-15 00:00:00,LABORABLE
15,3,2019,22,598,703,1301,2019-03-15 21:00:00,2019-03-15 00:00:00,LABORABLE
15,3,2019,23,498,630,1128,2019-03-15 22:00:00,2019-03-15 00:00:00,LABORABLE
15,3,2019,24,371,485,856,2019-03-15 23:00:00,2019-03-15 00:00:00,LABORABLE
16,3,2019,1,314,496,810,2019-03-16 00:00:00,2019-03-16 00:00:00,LABORABLE
16,3,2019,2,267,354,621,2019-03-16 01:00:00,2019-03-16 00:00:00,LABORABLE
16,3,2019,3,214,311,525,2019-03-16 02:00:00,2019-03-16 00:00:00,LABORABLE
16,3,2019,4,146,228,374,2019-03-16 03:00:00,2019-03-16 00:00:00,LABORABLE
16,3,2019,5,147,219,366,2019-03-16 04:00:00,2019-03-16 00:00:00,LABORABLE
16,3,2019,6,157,236,393,2019-03-16 05:00:00,2019-03-16 00:00:00,LABORABLE
16,3,2019,7,214,285,499,2019-03-16 06:00:00,2019-03-16 00:00:00,LABORABLE
16,3,2019,8,281,312,593,2019-03-16 07:00:00,2019-03-16 00:00:00,LABORABLE
16,3,2019,9,368,380,748,2019-03-16 08:00:00,2019-03-16 00:00:00,LABORABLE
16,3,2019,10,455,520,975,2019-03-16 09:00:00,2019-03-16 00:00:00,LABORABLE
16,3,2019,11,586,690,1276,2019-03-16 10:00:00,2019-03-16 00:00:00,LABORABLE
16,3,2019,12,617,708,1325,2019-03-16 11:00:00,2019-03-16 00:00:00,LABORABLE
16,3,2019,13,622,733,1355,2019-03-16 12:00:00,2019-03-16 00:00:00,LABORABLE
16,3,2019,14,621,740,1361,2019-03-16 13:00:00,2019-03-16 00:00:00,LABORABLE
16,3,2019,15,601,790,1391,2019-03-16 14:00:00,2019-03-16 00:00:00,LABORABLE
16,3,2019,16,477,652,1129,2019-03-16 15:00:00,2019-03-16 00:00:00,LABORABLE
16,3,2019,17,495,642,1137,2019-03-16 16:00:00,2019-03-16 00:00:00,LABORABLE
16,3,2019,18,529,732,1261,2019-03-16 17:00:00,2019-03-16 00:00:00,LABORABLE
16,3,2019,19,541,700,1241,2019-03-16 18:00:00,2019-03-16 00:00:00,LABORABLE
16,3,2019,20,628,705,1333,2019-03-16 19:00:00,2019-03-16 00:00:00,LABORABLE
16,3,2019,21,593,681,1274,2019-03-16 20:00:00,2019-03-16 00:00:00,LABORABLE
16,3,2019,22,570,656,1226,2019-03-16 21:00:00,2019-03-16 00:00:00,LABORABLE
16,3,2019,23,508,634,1142,2019-03-16 22:00:00,2019-03-16 00:00:00,LABORABLE
16,3,2019,24,394,509,903,2019-03-16 23:00:00,2019-03-16 00:00:00,LABORABLE
17,3,2019,1,395,488,883,2019-03-17 00:00:00,2019-03-17 00:00:00,LABORABLE
17,3,2019,2,340,450,790,2019-03-17 01:00:00,2019-03-17 00:00:00,LABORABLE
17,3,2019,3,277,381,658,2019-03-17 02:00:00,2019-03-17 00:00:00,LABORABLE
17,3,2019,4,198,306,504,2019-03-17 03:00:00,2019-03-17 00:00:00,LABORABLE
17,3,2019,5,186,285,471,2019-03-17 04:00:00,2019-03-17 00:00:00,LABORABLE
17,3,2019,6,167,281,448,2019-03-17 05:00:00,2019-03-17 00:00:00,LABORABLE
17,3,2019,7,201,262,463,2019-03-17 06:00:00,2019-03-17 00:00:00,LABORABLE
17,3,2019,8,176,235,411,2019-03-17 07:00:00,2019-03-17 00:00:00,LABORABLE
17,3,2019,9,213,287,500,2019-03-17 08:00:00,2019-03-17 00:00:00,LABORABLE
17,3,2019,10,358,419,777,2019-03-17 09:00:00,2019-03-17 00:00:00,LABORABLE
17,3,2019,11,417,506,923,2019-03-17 10:00:00,2019-03-17 00:00:00,LABORABLE
17,3,2019,12,553,602,1155,2019-03-17 11:00:00,2019-03-17 00:00:00,LABORABLE
17,3,2019,13,600,632,1232,2019-03-17 12:00:00,2019-03-17 00:00:00,LABORABLE
17,3,2019,14,531,703,1234,2019-03-17 13:00:00,2019-03-17 00:00:00,LABORABLE
17,3,2019,15,529,814,1343,2019-03-17 14:00:00,2019-03-17 00:00:00,LABORABLE
17,3,2019,16,455,582,1037,2019-03-17 15:00:00,2019-03-17 00:00:00,LABORABLE
17,3,2019,17,481,630,1111,2019-03-17 16:00:00,2019-03-17 00:00:00,LABORABLE
17,3,2019,18,500,679,1179,2019-03-17 17:00:00,2019-03-17 00:00:00,LABORABLE
17,3,2019,19,566,655,1221,2019-03-17 18:00:00,2019-03-17 00:00:00,LABORABLE
17,3,2019,20,583,668,1251,2019-03-17 19:00:00,2019-03-17 00:00:00,LABORABLE
17,3,2019,21,558,693,1251,2019-03-17 20:00:00,2019-03-17 00:00:00,LABORABLE
17,3,2019,22,531,583,1114,2019-03-17 21:00:00,2019-03-17 00:00:00,LABORABLE
17,3,2019,23,402,485,887,2019-03-17 22:00:00,2019-03-17 00:00:00,LABORABLE
17,3,2019,24,278,406,684,2019-03-17 23:00:00,2019-03-17 00:00:00,LABORABLE
18,3,2019,1,199,282,481,2019-03-18 00:00:00,2019-03-18 00:00:00,LABORABLE
18,3,2019,2,132,217,349,2019-03-18 01:00:00,2019-03-18 00:00:00,LABORABLE
18,3,2019,3,92,172,264,2019-03-18 02:00:00,2019-03-18 00:00:00,LABORABLE
18,3,2019,4,84,112,196,2019-03-18 03:00:00,2019-03-18 00:00:00,LABORABLE
18,3,2019,5,76,112,188,2019-03-18 04:00:00,2019-03-18 00:00:00,LABORABLE
18,3,2019,6,140,176,316,2019-03-18 05:00:00,2019-03-18 00:00:00,LABORABLE
18,3,2019,7,433,400,833,2019-03-18 06:00:00,2019-03-18 00:00:00,LABORABLE
18,3,2019,8,663,629,1292,2019-03-18 07:00:00,2019-03-18 00:00:00,LABORABLE
18,3,2019,9,642,739,1381,2019-03-18 08:00:00,2019-03-18 00:00:00,LABORABLE
18,3,2019,10,709,745,1454,2019-03-18 09:00:00,2019-03-18 00:00:00,LABORABLE
18,3,2019,11,575,702,1277,2019-03-18 10:00:00,2019-03-18 00:00:00,LABORABLE
18,3,2019,12,589,735,1324,2019-03-18 11:00:00,2019-03-18 00:00:00,LABORABLE
18,3,2019,13,599,708,1307,2019-03-18 12:00:00,2019-03-18 00:00:00,LABORABLE
18,3,2019,14,611,746,1357,2019-03-18 13:00:00,2019-03-18 00:00:00,LABORABLE
18,3,2019,15,619,769,1388,2019-03-18 14:00:00,2019-03-18 00:00:00,LABORABLE
18,3,2019,16,624,671,1295,2019-03-18 15:00:00,2019-03-18 00:00:00,LABORABLE
18,3,2019,17,647,738,1385,2019-03-18 16:00:00,2019-03-18 00:00:00,LABORABLE
18,3,2019,18,638,776,1414,2019-03-18 17:00:00,2019-03-18 00:00:00,LABORABLE
18,3,2019,19,650,732,1382,2019-03-18 18:00:00,2019-03-18 00:00:00,LABORABLE
18,3,2019,20,634,785,1419,2019-03-18 19:00:00,2019-03-18 00:00:00,LABORABLE
18,3,2019,21,614,719,1333,2019-03-18 20:00:00,2019-03-18 00:00:00,LABORABLE
18,3,2019,22,480,665,1145,2019-03-18 21:00:00,2019-03-18 00:00:00,LABORABLE
18,3,2019,23,349,451,800,2019-03-18 22:00:00,2019-03-18 00:00:00,LABORABLE
18,3,2019,24,243,307,550,2019-03-18 23:00:00,2019-03-18 00:00:00,LABORABLE
19,3,2019,1,147,245,392,2019-03-19 00:00:00,2019-03-19 00:00:00,LABORABLE
19,3,2019,2,85,136,221,2019-03-19 01:00:00,2019-03-19 00:00:00,LABORABLE
19,3,2019,3,63,130,193,2019-03-19 02:00:00,2019-03-19 00:00:00,LABORABLE
19,3,2019,4,61,93,154,2019-03-19 03:00:00,2019-03-19 00:00:00,LABORABLE
19,3,2019,5,69,105,174,2019-03-19 04:00:00,2019-03-19 00:00:00,LABORABLE
19,3,2019,6,167,158,325,2019-03-19 05:00:00,2019-03-19 00:00:00,LABORABLE
19,3,2019,7,430,430,860,2019-03-19 06:00:00,2019-03-19 00:00:00,LABORABLE
19,3,2019,8,662,650,1312,2019-03-19 07:00:00,2019-03-19 00:00:00,LABORABLE
19,3,2019,9,677,701,1378,2019-03-19 08:00:00,2019-03-19 00:00:00,LABORABLE
19,3,2019,10,597,729,1326,2019-03-19 09:00:00,2019-03-19 00:00:00,LABORABLE
19,3,2019,11,383,464,847,2019-03-19 10:00:00,2019-03-19 00:00:00,LABORABLE
19,3,2019,12,585,738,1323,2019-03-19 11:00:00,2019-03-19 00:00:00,LABORABLE
19,3,2019,13,377,481,858,2019-03-19 12:00:00,2019-03-19 00:00:00,LABORABLE
19,3,2019,14,632,718,1350,2019-03-19 13:00:00,2019-03-19 00:00:00,LABORABLE
19,3,2019,15,618,689,1307,2019-03-19 14:00:00,2019-03-19 00:00:00,LABORABLE
19,3,2019,16,597,717,1314,2019-03-19 15:00:00,2019-03-19 00:00:00,LABORABLE
19,3,2019,17,636,741,1377,2019-03-19 16:00:00,2019-03-19 00:00:00,LABORABLE
19,3,2019,18,647,799,1446,2019-03-19 17:00:00,2019-03-19 00:00:00,LABORABLE
19,3,2019,19,666,783,1449,2019-03-19 18:00:00,2019-03-19 00:00:00,LABORABLE
19,3,2019,20,632,775,1407,2019-03-19 19:00:00,2019-03-19 00:00:00,LABORABLE
19,3,2019,21,623,764,1387,2019-03-19 20:00:00,2019-03-19 00:00:00,LABORABLE
19,3,2019,22,534,647,1181,2019-03-19 21:00:00,2019-03-19 00:00:00,LABORABLE
19,3,2019,23,403,463,866,2019-03-19 22:00:00,2019-03-19 00:00:00,LABORABLE
19,3,2019,24,230,339,569,2019-03-19 23:00:00,2019-03-19 00:00:00,LABORABLE
20,3,2019,1,170,256,426,2019-03-20 00:00:00,2019-03-20 00:00:00,LABORABLE
20,3,2019,2,110,151,261,2019-03-20 01:00:00,2019-03-20 00:00:00,LABORABLE
20,3,2019,3,69,142,211,2019-03-20 02:00:00,2019-03-20 00:00:00,LABORABLE
20,3,2019,4,69,103,172,2019-03-20 03:00:00,2019-03-20 00:00:00,LABORABLE
20,3,2019,5,82,92,174,2019-03-20 04:00:00,2019-03-20 00:00:00,LABORABLE
20,3,2019,6,149,174,323,2019-03-20 05:00:00,2019-03-20 00:00:00,LABORABLE
20,3,2019,7,412,391,803,2019-03-20 06:00:00,2019-03-20 00:00:00,LABORABLE
20,3,2019,8,672,614,1286,2019-03-20 07:00:00,2019-03-20 00:00:00,LABORABLE
20,3,2019,9,671,717,1388,2019-03-20 08:00:00,2019-03-20 00:00:00,LABORABLE
20,3,2019,10,622,726,1348,2019-03-20 09:00:00,2019-03-20 00:00:00,LABORABLE
20,3,2019,11,535,589,1124,2019-03-20 10:00:00,2019-03-20 00:00:00,LABORABLE
20,3,2019,12,475,584,1059,2019-03-20 11:00:00,2019-03-20 00:00:00,LABORABLE
20,3,2019,13,599,718,1317,2019-03-20 12:00:00,2019-03-20 00:00:00,LABORABLE
20,3,2019,14,622,761,1383,2019-03-20 13:00:00,2019-03-20 00:00:00,LABORABLE
20,3,2019,15,655,722,1377,2019-03-20 14:00:00,2019-03-20 00:00:00,LABORABLE
20,3,2019,16,675,697,1372,2019-03-20 15:00:00,2019-03-20 00:00:00,LABORABLE
20,3,2019,17,684,723,1407,2019-03-20 16:00:00,2019-03-20 00:00:00,LABORABLE
20,3,2019,18,727,712,1439,2019-03-20 17:00:00,2019-03-20 00:00:00,LABORABLE
20,3,2019,19,744,752,1496,2019-03-20 18:00:00,2019-03-20 00:00:00,LABORABLE
20,3,2019,20,664,768,1432,2019-03-20 19:00:00,2019-03-20 00:00:00,LABORABLE
20,3,2019,21,690,762,1452,2019-03-20 20:00:00,2019-03-20 00:00:00,LABORABLE
20,3,2019,22,550,692,1242,2019-03-20 21:00:00,2019-03-20 00:00:00,LABORABLE
20,3,2019,23,429,534,963,2019-03-20 22:00:00,2019-03-20 00:00:00,LABORABLE
20,3,2019,24,260,341,601,2019-03-20 23:00:00,2019-03-20 00:00:00,LABORABLE
21,3,2019,1,203,267,470,2019-03-21 00:00:00,2019-03-21 00:00:00,LABORABLE
21,3,2019,2,110,224,334,2019-03-21 01:00:00,2019-03-21 00:00:00,LABORABLE
21,3,2019,3,74,139,213,2019-03-21 02:00:00,2019-03-21 00:00:00,LABORABLE
21,3,2019,4,81,131,212,2019-03-21 03:00:00,2019-03-21 00:00:00,LABORABLE
21,3,2019,5,81,101,182,2019-03-21 04:00:00,2019-03-21 00:00:00,LABORABLE
21,3,2019,6,162,165,327,2019-03-21 05:00:00,2019-03-21 00:00:00,LABORABLE
21,3,2019,7,451,423,874,2019-03-21 06:00:00,2019-03-21 00:00:00,LABORABLE
21,3,2019,8,713,582,1295,2019-03-21 07:00:00,2019-03-21 00:00:00,LABORABLE
21,3,2019,9,732,746,1478,2019-03-21 08:00:00,2019-03-21 00:00:00,LABORABLE
21,3,2019,10,718,687,1405,2019-03-21 09:00:00,2019-03-21 00:00:00,LABORABLE
21,3,2019,11,484,527,1011,2019-03-21 10:00:00,2019-03-21 00:00:00,LABORABLE
21,3,2019,12,650,705,1355,2019-03-21 11:00:00,2019-03-21 00:00:00,LABORABLE
21,3,2019,13,652,673,1325,2019-03-21 12:00:00,2019-03-21 00:00:00,LABORABLE
21,3,2019,14,531,542,1073,2019-03-21 13:00:00,2019-03-21 00:00:00,LABORABLE
21,3,2019,15,676,731,1407,2019-03-21 14:00:00,2019-03-21 00:00:00,LABORABLE
21,3,2019,16,670,685,1355,2019-03-21 15:00:00,2019-03-21 00:00:00,LABORABLE
21,3,2019,17,698,732,1430,2019-03-21 16:00:00,2019-03-21 00:00:00,LABORABLE
21,3,2019,18,655,769,1424,2019-03-21 17:00:00,2019-03-21 00:00:00,LABORABLE
21,3,2019,19,653,783,1436,2019-03-21 18:00:00,2019-03-21 00:00:00,LABORABLE
21,3,2019,20,673,785,1458,2019-03-21 19:00:00,2019-03-21 00:00:00,LABORABLE
21,3,2019,21,682,735,1417,2019-03-21 20:00:00,2019-03-21 00:00:00,LABORABLE
21,3,2019,22,601,640,1241,2019-03-21 21:00:00,2019-03-21 00:00:00,LABORABLE
21,3,2019,23,453,494,947,2019-03-21 22:00:00,2019-03-21 00:00:00,LABORABLE
21,3,2019,24,431,350,781,2019-03-21 23:00:00,2019-03-21 00:00:00,LABORABLE
22,3,2019,1,216,296,512,2019-03-22 00:00:00,2019-03-22 00:00:00,LABORABLE
22,3,2019,2,124,227,351,2019-03-22 01:00:00,2019-03-22 00:00:00,LABORABLE
22,3,2019,3,97,191,288,2019-03-22 02:00:00,2019-03-22 00:00:00,LABORABLE
22,3,2019,4,82,122,204,2019-03-22 03:00:00,2019-03-22 00:00:00,LABORABLE
22,3,2019,5,97,124,221,2019-03-22 04:00:00,2019-03-22 00:00:00,LABORABLE
22,3,2019,6,174,170,344,2019-03-22 05:00:00,2019-03-22 00:00:00,LABORABLE
22,3,2019,7,438,421,859,2019-03-22 06:00:00,2019-03-22 00:00:00,LABORABLE
22,3,2019,8,693,663,1356,2019-03-22 07:00:00,2019-03-22 00:00:00,LABORABLE
22,3,2019,9,688,717,1405,2019-03-22 08:00:00,2019-03-22 00:00:00,LABORABLE
22,3,2019,10,648,695,1343,2019-03-22 09:00:00,2019-03-22 00:00:00,LABORABLE
22,3,2019,11,410,550,960,2019-03-22 10:00:00,2019-03-22 00:00:00,LABORABLE
22,3,2019,12,608,674,1282,2019-03-22 11:00:00,2019-03-22 00:00:00,LABORABLE
22,3,2019,13,660,781,1441,2019-03-22 12:00:00,2019-03-22 00:00:00,LABORABLE
22,3,2019,14,636,774,1410,2019-03-22 13:00:00,2019-03-22 00:00:00,LABORABLE
22,3,2019,15,688,730,1418,2019-03-22 14:00:00,2019-03-22 00:00:00,LABORABLE
22,3,2019,16,723,677,1400,2019-03-22 15:00:00,2019-03-22 00:00:00,LABORABLE
22,3,2019,17,650,747,1397,2019-03-22 16:00:00,2019-03-22 00:00:00,LABORABLE
22,3,2019,18,706,754,1460,2019-03-22 17:00:00,2019-03-22 00:00:00,LABORABLE
22,3,2019,19,737,788,1525,2019-03-22 18:00:00,2019-03-22 00:00:00,LABORABLE
22,3,2019,20,609,785,1394,2019-03-22 19:00:00,2019-03-22 00:00:00,LABORABLE
22,3,2019,21,690,799,1489,2019-03-22 20:00:00,2019-03-22 00:00:00,LABORABLE
22,3,2019,22,625,719,1344,2019-03-22 21:00:00,2019-03-22 00:00:00,LABORABLE
22,3,2019,23,564,645,1209,2019-03-22 22:00:00,2019-03-22 00:00:00,LABORABLE
22,3,2019,24,389,583,972,2019-03-22 23:00:00,2019-03-22 00:00:00,LABORABLE
23,3,2019,1,303,439,742,2019-03-23 00:00:00,2019-03-23 00:00:00,LABORABLE
23,3,2019,2,233,355,588,2019-03-23 01:00:00,2019-03-23 00:00:00,LABORABLE
23,3,2019,3,175,293,468,2019-03-23 02:00:00,2019-03-23 00:00:00,LABORABLE
23,3,2019,4,153,263,416,2019-03-23 03:00:00,2019-03-23 00:00:00,LABORABLE
23,3,2019,5,134,217,351,2019-03-23 04:00:00,2019-03-23 00:00:00,LABORABLE
23,3,2019,6,154,202,356,2019-03-23 05:00:00,2019-03-23 00:00:00,LABORABLE
23,3,2019,7,207,261,468,2019-03-23 06:00:00,2019-03-23 00:00:00,LABORABLE
23,3,2019,8,299,323,622,2019-03-23 07:00:00,2019-03-23 00:00:00,LABORABLE
23,3,2019,9,376,418,794,2019-03-23 08:00:00,2019-03-23 00:00:00,LABORABLE
23,3,2019,10,449,526,975,2019-03-23 09:00:00,2019-03-23 00:00:00,LABORABLE
23,3,2019,11,602,666,1268,2019-03-23 10:00:00,2019-03-23 00:00:00,LABORABLE
23,3,2019,12,615,674,1289,2019-03-23 11:00:00,2019-03-23 00:00:00,LABORABLE
23,3,2019,13,643,765,1408,2019-03-23 12:00:00,2019-03-23 00:00:00,LABORABLE
23,3,2019,14,671,730,1401,2019-03-23 13:00:00,2019-03-23 00:00:00,LABORABLE
23,3,2019,15,654,840,1494,2019-03-23 14:00:00,2019-03-23 00:00:00,LABORABLE
23,3,2019,16,514,710,1224,2019-03-23 15:00:00,2019-03-23 00:00:00,LABORABLE
23,3,2019,17,520,666,1186,2019-03-23 16:00:00,2019-03-23 00:00:00,LABORABLE
23,3,2019,18,554,769,1323,2019-03-23 17:00:00,2019-03-23 00:00:00,LABORABLE
23,3,2019,19,644,794,1438,2019-03-23 18:00:00,2019-03-23 00:00:00,LABORABLE
23,3,2019,20,644,707,1351,2019-03-23 19:00:00,2019-03-23 00:00:00,LABORABLE
23,3,2019,21,598,755,1353,2019-03-23 20:00:00,2019-03-23 00:00:00,LABORABLE
23,3,2019,22,672,658,1330,2019-03-23 21:00:00,2019-03-23 00:00:00,LABORABLE
23,3,2019,23,544,610,1154,2019-03-23 22:00:00,2019-03-23 00:00:00,LABORABLE
23,3,2019,24,443,498,941,2019-03-23 23:00:00,2019-03-23 00:00:00,LABORABLE
24,3,2019,1,340,465,805,2019-03-24 00:00:00,2019-03-24 00:00:00,LABORABLE
24,3,2019,2,309,382,691,2019-03-24 01:00:00,2019-03-24 00:00:00,LABORABLE
24,3,2019,3,276,357,633,2019-03-24 02:00:00,2019-03-24 00:00:00,LABORABLE
24,3,2019,4,197,305,502,2019-03-24 03:00:00,2019-03-24 00:00:00,LABORABLE
24,3,2019,5,144,283,427,2019-03-24 04:00:00,2019-03-24 00:00:00,LABORABLE
24,3,2019,6,154,280,434,2019-03-24 05:00:00,2019-03-24 00:00:00,LABORABLE
24,3,2019,7,207,258,465,2019-03-24 06:00:00,2019-03-24 00:00:00,LABORABLE
24,3,2019,8,194,266,460,2019-03-24 07:00:00,2019-03-24 00:00:00,LABORABLE
24,3,2019,9,247,321,568,2019-03-24 08:00:00,2019-03-24 00:00:00,LABORABLE
24,3,2019,10,364,395,759,2019-03-24 09:00:00,2019-03-24 00:00:00,LABORABLE
24,3,2019,11,492,538,1030,2019-03-24 10:00:00,2019-03-24 00:00:00,LABORABLE
24,3,2019,12,543,597,1140,2019-03-24 11:00:00,2019-03-24 00:00:00,LABORABLE
24,3,2019,13,547,636,1183,2019-03-24 12:00:00,2019-03-24 00:00:00,LABORABLE
24,3,2019,14,575,691,1266,2019-03-24 13:00:00,2019-03-24 00:00:00,LABORABLE
24,3,2019,15,581,660,1241,2019-03-24 14:00:00,2019-03-24 00:00:00,LABORABLE
24,3,2019,16,473,592,1065,2019-03-24 15:00:00,2019-03-24 00:00:00,LABORABLE
24,3,2019,17,489,675,1164,2019-03-24 16:00:00,2019-03-24 00:00:00,LABORABLE
24,3,2019,18,528,747,1275,2019-03-24 17:00:00,2019-03-24 00:00:00,LABORABLE
24,3,2019,19,564,692,1256,2019-03-24 18:00:00,2019-03-24 00:00:00,LABORABLE
24,3,2019,20,535,707,1242,2019-03-24 19:00:00,2019-03-24 00:00:00,LABORABLE
24,3,2019,21,600,712,1312,2019-03-24 20:00:00,2019-03-24 00:00:00,LABORABLE
24,3,2019,22,564,626,1190,2019-03-24 21:00:00,2019-03-24 00:00:00,LABORABLE
24,3,2019,23,417,443,860,2019-03-24 22:00:00,2019-03-24 00:00:00,LABORABLE
24,3,2019,24,266,343,609,2019-03-24 23:00:00,2019-03-24 00:00:00,LABORABLE
25,3,2019,1,191,286,477,2019-03-25 00:00:00,2019-03-25 00:00:00,LABORABLE
25,3,2019,2,113,183,296,2019-03-25 01:00:00,2019-03-25 00:00:00,LABORABLE
25,3,2019,3,79,155,234,2019-03-25 02:00:00,2019-03-25 00:00:00,LABORABLE
25,3,2019,4,67,131,198,2019-03-25 03:00:00,2019-03-25 00:00:00,LABORABLE
25,3,2019,5,74,123,197,2019-03-25 04:00:00,2019-03-25 00:00:00,LABORABLE
25,3,2019,6,173,151,324,2019-03-25 05:00:00,2019-03-25 00:00:00,LABORABLE
25,3,2019,7,430,429,859,2019-03-25 06:00:00,2019-03-25 00:00:00,LABORABLE
25,3,2019,8,713,649,1362,2019-03-25 07:00:00,2019-03-25 00:00:00,LABORABLE
25,3,2019,9,669,716,1385,2019-03-25 08:00:00,2019-03-25 00:00:00,LABORABLE
25,3,2019,10,606,725,1331,2019-03-25 09:00:00,2019-03-25 00:00:00,LABORABLE
25,3,2019,11,551,641,1192,2019-03-25 10:00:00,2019-03-25 00:00:00,LABORABLE
25,3,2019,12,555,712,1267,2019-03-25 11:00:00,2019-03-25 00:00:00,LABORABLE
25,3,2019,13,598,706,1304,2019-03-25 12:00:00,2019-03-25 00:00:00,LABORABLE
25,3,2019,14,578,680,1258,2019-03-25 13:00:00,2019-03-25 00:00:00,LABORABLE
25,3,2019,15,619,679,1298,2019-03-25 14:00:00,2019-03-25 00:00:00,LABORABLE
25,3,2019,16,594,646,1240,2019-03-25 15:00:00,2019-03-25 00:00:00,LABORABLE
25,3,2019,17,682,708,1390,2019-03-25 16:00:00,2019-03-25 00:00:00,LABORABLE
25,3,2019,18,680,725,1405,2019-03-25 17:00:00,2019-03-25 00:00:00,LABORABLE
25,3,2019,19,671,799,1470,2019-03-25 18:00:00,2019-03-25 00:00:00,LABORABLE
25,3,2019,20,587,777,1364,2019-03-25 19:00:00,2019-03-25 00:00:00,LABORABLE
25,3,2019,21,593,731,1324,2019-03-25 20:00:00,2019-03-25 00:00:00,LABORABLE
25,3,2019,22,446,619,1065,2019-03-25 21:00:00,2019-03-25 00:00:00,LABORABLE
25,3,2019,23,377,367,744,2019-03-25 22:00:00,2019-03-25 00:00:00,LABORABLE
25,3,2019,24,235,306,541,2019-03-25 23:00:00,2019-03-25 00:00:00,LABORABLE
26,3,2019,1,155,238,393,2019-03-26 00:00:00,2019-03-26 00:00:00,LABORABLE
26,3,2019,2,102,149,251,2019-03-26 01:00:00,2019-03-26 00:00:00,LABORABLE
26,3,2019,3,91,123,214,2019-03-26 02:00:00,2019-03-26 00:00:00,LABORABLE
26,3,2019,4,71,97,168,2019-03-26 03:00:00,2019-03-26 00:00:00,LABORABLE
26,3,2019,5,54,122,176,2019-03-26 04:00:00,2019-03-26 00:00:00,LABORABLE
26,3,2019,6,156,169,325,2019-03-26 05:00:00,2019-03-26 00:00:00,LABORABLE
26,3,2019,7,428,390,818,2019-03-26 06:00:00,2019-03-26 00:00:00,LABORABLE
26,3,2019,8,711,645,1356,2019-03-26 07:00:00,2019-03-26 00:00:00,LABORABLE
26,3,2019,9,685,731,1416,2019-03-26 08:00:00,2019-03-26 00:00:00,LABORABLE
26,3,2019,10,608,710,1318,2019-03-26 09:00:00,2019-03-26 00:00:00,LABORABLE
26,3,2019,11,570,655,1225,2019-03-26 10:00:00,2019-03-26 00:00:00,LABORABLE
26,3,2019,12,538,681,1219,2019-03-26 11:00:00,2019-03-26 00:00:00,LABORABLE
26,3,2019,13,621,683,1304,2019-03-26 12:00:00,2019-03-26 00:00:00,LABORABLE
26,3,2019,14,523,601,1124,2019-03-26 13:00:00,2019-03-26 00:00:00,LABORABLE
26,3,2019,15,628,692,1320,2019-03-26 14:00:00,2019-03-26 00:00:00,LABORABLE
26,3,2019,16,613,685,1298,2019-03-26 15:00:00,2019-03-26 00:00:00,LABORABLE
26,3,2019,17,655,719,1374,2019-03-26 16:00:00,2019-03-26 00:00:00,LABORABLE
26,3,2019,18,689,785,1474,2019-03-26 17:00:00,2019-03-26 00:00:00,LABORABLE
26,3,2019,19,650,776,1426,2019-03-26 18:00:00,2019-03-26 00:00:00,LABORABLE
26,3,2019,20,645,784,1429,2019-03-26 19:00:00,2019-03-26 00:00:00,LABORABLE
26,3,2019,21,669,708,1377,2019-03-26 20:00:00,2019-03-26 00:00:00,LABORABLE
26,3,2019,22,487,619,1106,2019-03-26 21:00:00,2019-03-26 00:00:00,LABORABLE
26,3,2019,23,372,434,806,2019-03-26 22:00:00,2019-03-26 00:00:00,LABORABLE
26,3,2019,24,232,281,513,2019-03-26 23:00:00,2019-03-26 00:00:00,LABORABLE
27,3,2019,1,155,238,393,2019-03-27 00:00:00,2019-03-27 00:00:00,LABORABLE
27,3,2019,2,112,196,308,2019-03-27 01:00:00,2019-03-27 00:00:00,LABORABLE
27,3,2019,3,64,137,201,2019-03-27 02:00:00,2019-03-27 00:00:00,LABORABLE
27,3,2019,4,64,104,168,2019-03-27 03:00:00,2019-03-27 00:00:00,LABORABLE
27,3,2019,5,88,90,178,2019-03-27 04:00:00,2019-03-27 00:00:00,LABORABLE
27,3,2019,6,154,181,335,2019-03-27 05:00:00,2019-03-27 00:00:00,LABORABLE
27,3,2019,7,424,419,843,2019-03-27 06:00:00,2019-03-27 00:00:00,LABORABLE
27,3,2019,8,679,662,1341,2019-03-27 07:00:00,2019-03-27 00:00:00,LABORABLE
27,3,2019,9,689,748,1437,2019-03-27 08:00:00,2019-03-27 00:00:00,LABORABLE
27,3,2019,10,631,774,1405,2019-03-27 09:00:00,2019-03-27 00:00:00,LABORABLE
27,3,2019,11,528,653,1181,2019-03-27 10:00:00,2019-03-27 00:00:00,LABORABLE
27,3,2019,12,608,721,1329,2019-03-27 11:00:00,2019-03-27 00:00:00,LABORABLE
27,3,2019,13,342,405,747,2019-03-27 12:00:00,2019-03-27 00:00:00,LABORABLE
27,3,2019,14,588,697,1285,2019-03-27 13:00:00,2019-03-27 00:00:00,LABORABLE
27,3,2019,15,620,732,1352,2019-03-27 14:00:00,2019-03-27 00:00:00,LABORABLE
27,3,2019,16,598,628,1226,2019-03-27 15:00:00,2019-03-27 00:00:00,LABORABLE
27,3,2019,17,670,713,1383,2019-03-27 16:00:00,2019-03-27 00:00:00,LABORABLE
27,3,2019,18,681,701,1382,2019-03-27 17:00:00,2019-03-27 00:00:00,LABORABLE
27,3,2019,19,688,781,1469,2019-03-27 18:00:00,2019-03-27 00:00:00,LABORABLE
27,3,2019,20,640,767,1407,2019-03-27 19:00:00,2019-03-27 00:00:00,LABORABLE
27,3,2019,21,645,728,1373,2019-03-27 20:00:00,2019-03-27 00:00:00,LABORABLE
27,3,2019,22,551,689,1240,2019-03-27 21:00:00,2019-03-27 00:00:00,LABORABLE
27,3,2019,23,420,460,880,2019-03-27 22:00:00,2019-03-27 00:00:00,LABORABLE
27,3,2019,24,263,316,579,2019-03-27 23:00:00,2019-03-27 00:00:00,LABORABLE
28,3,2019,1,223,245,468,2019-03-28 00:00:00,2019-03-28 00:00:00,LABORABLE
28,3,2019,2,134,210,344,2019-03-28 01:00:00,2019-03-28 00:00:00,LABORABLE
28,3,2019,3,79,141,220,2019-03-28 02:00:00,2019-03-28 00:00:00,LABORABLE
28,3,2019,4,74,126,200,2019-03-28 03:00:00,2019-03-28 00:00:00,LABORABLE
28,3,2019,5,86,118,204,2019-03-28 04:00:00,2019-03-28 00:00:00,LABORABLE
28,3,2019,6,141,160,301,2019-03-28 05:00:00,2019-03-28 00:00:00,LABORABLE
28,3,2019,7,434,424,858,2019-03-28 06:00:00,2019-03-28 00:00:00,LABORABLE
28,3,2019,8,704,641,1345,2019-03-28 07:00:00,2019-03-28 00:00:00,LABORABLE
28,3,2019,9,708,743,1451,2019-03-28 08:00:00,2019-03-28 00:00:00,LABORABLE
28,3,2019,10,699,720,1419,2019-03-28 09:00:00,2019-03-28 00:00:00,LABORABLE
28,3,2019,11,545,648,1193,2019-03-28 10:00:00,2019-03-28 00:00:00,LABORABLE
28,3,2019,12,610,723,1333,2019-03-28 11:00:00,2019-03-28 00:00:00,LABORABLE
28,3,2019,13,644,711,1355,2019-03-28 12:00:00,2019-03-28 00:00:00,LABORABLE
28,3,2019,14,609,671,1280,2019-03-28 13:00:00,2019-03-28 00:00:00,LABORABLE
28,3,2019,15,599,765,1364,2019-03-28 14:00:00,2019-03-28 00:00:00,LABORABLE
28,3,2019,16,623,633,1256,2019-03-28 15:00:00,2019-03-28 00:00:00,LABORABLE
28,3,2019,17,664,733,1397,2019-03-28 16:00:00,2019-03-28 00:00:00,LABORABLE
28,3,2019,18,709,785,1494,2019-03-28 17:00:00,2019-03-28 00:00:00,LABORABLE
28,3,2019,19,716,736,1452,2019-03-28 18:00:00,2019-03-28 00:00:00,LABORABLE
28,3,2019,20,662,764,1426,2019-03-28 19:00:00,2019-03-28 00:00:00,LABORABLE
28,3,2019,21,635,730,1365,2019-03-28 20:00:00,2019-03-28 00:00:00,LABORABLE
28,3,2019,22,563,707,1270,2019-03-28 21:00:00,2019-03-28 00:00:00,LABORABLE
28,3,2019,23,466,463,929,2019-03-28 22:00:00,2019-03-28 00:00:00,LABORABLE
28,3,2019,24,272,333,605,2019-03-28 23:00:00,2019-03-28 00:00:00,LABORABLE
29,3,2019,1,189,292,481,2019-03-29 00:00:00,2019-03-29 00:00:00,LABORABLE
29,3,2019,2,120,224,344,2019-03-29 01:00:00,2019-03-29 00:00:00,LABORABLE
29,3,2019,3,99,155,254,2019-03-29 02:00:00,2019-03-29 00:00:00,LABORABLE
29,3,2019,4,73,137,210,2019-03-29 03:00:00,2019-03-29 00:00:00,LABORABLE
29,3,2019,5,90,107,197,2019-03-29 04:00:00,2019-03-29 00:00:00,LABORABLE
29,3,2019,6,137,160,297,2019-03-29 05:00:00,2019-03-29 00:00:00,LABORABLE
29,3,2019,7,438,449,887,2019-03-29 06:00:00,2019-03-29 00:00:00,LABORABLE
29,3,2019,8,676,640,1316,2019-03-29 07:00:00,2019-03-29 00:00:00,LABORABLE
29,3,2019,9,679,701,1380,2019-03-29 08:00:00,2019-03-29 00:00:00,LABORABLE
29,3,2019,10,588,741,1329,2019-03-29 09:00:00,2019-03-29 00:00:00,LABORABLE
29,3,2019,11,627,715,1342,2019-03-29 10:00:00,2019-03-29 00:00:00,LABORABLE
29,3,2019,12,590,718,1308,2019-03-29 11:00:00,2019-03-29 00:00:00,LABORABLE
29,3,2019,13,621,821,1442,2019-03-29 12:00:00,2019-03-29 00:00:00,LABORABLE
29,3,2019,14,501,611,1112,2019-03-29 13:00:00,2019-03-29 00:00:00,LABORABLE
29,3,2019,15,685,767,1452,2019-03-29 14:00:00,2019-03-29 00:00:00,LABORABLE
29,3,2019,16,642,694,1336,2019-03-29 15:00:00,2019-03-29 00:00:00,LABORABLE
29,3,2019,17,665,837,1502,2019-03-29 16:00:00,2019-03-29 00:00:00,LABORABLE
29,3,2019,18,786,830,1616,2019-03-29 17:00:00,2019-03-29 00:00:00,LABORABLE
29,3,2019,19,664,791,1455,2019-03-29 18:00:00,2019-03-29 00:00:00,LABORABLE
29,3,2019,20,718,849,1567,2019-03-29 19:00:00,2019-03-29 00:00:00,LABORABLE
29,3,2019,21,659,771,1430,2019-03-29 20:00:00,2019-03-29 00:00:00,LABORABLE
29,3,2019,22,626,815,1441,2019-03-29 21:00:00,2019-03-29 00:00:00,LABORABLE
29,3,2019,23,589,592,1181,2019-03-29 22:00:00,2019-03-29 00:00:00,LABORABLE
29,3,2019,24,384,537,921,2019-03-29 23:00:00,2019-03-29 00:00:00,LABORABLE
30,3,2019,1,313,429,742,2019-03-30 00:00:00,2019-03-30 00:00:00,LABORABLE
30,3,2019,2,254,367,621,2019-03-30 01:00:00,2019-03-30 00:00:00,LABORABLE
30,3,2019,3,178,328,506,2019-03-30 02:00:00,2019-03-30 00:00:00,LABORABLE
30,3,2019,4,132,246,378,2019-03-30 03:00:00,2019-03-30 00:00:00,LABORABLE
30,3,2019,5,125,214,339,2019-03-30 04:00:00,2019-03-30 00:00:00,LABORABLE
30,3,2019,6,158,222,380,2019-03-30 05:00:00,2019-03-30 00:00:00,LABORABLE
30,3,2019,7,228,266,494,2019-03-30 06:00:00,2019-03-30 00:00:00,LABORABLE
30,3,2019,8,358,345,703,2019-03-30 07:00:00,2019-03-30 00:00:00,LABORABLE
30,3,2019,9,376,421,797,2019-03-30 08:00:00,2019-03-30 00:00:00,LABORABLE
30,3,2019,10,483,589,1072,2019-03-30 09:00:00,2019-03-30 00:00:00,LABORABLE
30,3,2019,11,611,633,1244,2019-03-30 10:00:00,2019-03-30 00:00:00,LABORABLE
30,3,2019,12,645,709,1354,2019-03-30 11:00:00,2019-03-30 00:00:00,LABORABLE
30,3,2019,13,659,774,1433,2019-03-30 12:00:00,2019-03-30 00:00:00,LABORABLE
30,3,2019,14,621,769,1390,2019-03-30 13:00:00,2019-03-30 00:00:00,LABORABLE
30,3,2019,15,634,803,1437,2019-03-30 14:00:00,2019-03-30 00:00:00,LABORABLE
30,3,2019,16,523,724,1247,2019-03-30 15:00:00,2019-03-30 00:00:00,LABORABLE
30,3,2019,17,505,715,1220,2019-03-30 16:00:00,2019-03-30 00:00:00,LABORABLE
30,3,2019,18,566,746,1312,2019-03-30 17:00:00,2019-03-30 00:00:00,LABORABLE
30,3,2019,19,643,847,1490,2019-03-30 18:00:00,2019-03-30 00:00:00,LABORABLE
30,3,2019,20,596,729,1325,2019-03-30 19:00:00,2019-03-30 00:00:00,LABORABLE
30,3,2019,21,605,794,1399,2019-03-30 20:00:00,2019-03-30 00:00:00,LABORABLE
30,3,2019,22,660,720,1380,2019-03-30 21:00:00,2019-03-30 00:00:00,LABORABLE
30,3,2019,23,543,622,1165,2019-03-30 22:00:00,2019-03-30 00:00:00,LABORABLE
30,3,2019,24,415,527,942,2019-03-30 23:00:00,2019-03-30 00:00:00,LABORABLE
31,3,2019,1,417,487,904,2019-03-31 00:00:00,2019-03-31 00:00:00,LABORABLE
31,3,2019,2,362,453,815,2019-03-31 01:00:00,2019-03-31 00:00:00,LABORABLE
31,3,2019,3,0,0,0,2019-03-31 02:00:00,2019-03-31 00:00:00,LABORABLE
31,3,2019,4,273,272,545,2019-03-31 03:00:00,2019-03-31 00:00:00,LABORABLE
31,3,2019,5,191,308,499,2019-03-31 04:00:00,2019-03-31 00:00:00,LABORABLE
31,3,2019,6,160,288,448,2019-03-31 05:00:00,2019-03-31 00:00:00,LABORABLE
31,3,2019,7,198,296,494,2019-03-31 06:00:00,2019-03-31 00:00:00,LABORABLE
31,3,2019,8,174,320,494,2019-03-31 07:00:00,2019-03-31 00:00:00,LABORABLE
31,3,2019,9,229,303,532,2019-03-31 08:00:00,2019-03-31 00:00:00,LABORABLE
31,3,2019,10,341,393,734,2019-03-31 09:00:00,2019-03-31 00:00:00,LABORABLE
31,3,2019,11,401,466,867,2019-03-31 10:00:00,2019-03-31 00:00:00,LABORABLE
31,3,2019,12,481,520,1001,2019-03-31 11:00:00,2019-03-31 00:00:00,LABORABLE
31,3,2019,13,550,612,1162,2019-03-31 12:00:00,2019-03-31 00:00:00,LABORABLE
31,3,2019,14,589,677,1266,2019-03-31 13:00:00,2019-03-31 00:00:00,LABORABLE
31,3,2019,15,565,680,1245,2019-03-31 14:00:00,2019-03-31 00:00:00,LABORABLE
31,3,2019,16,491,581,1072,2019-03-31 15:00:00,2019-03-31 00:00:00,LABORABLE
31,3,2019,17,491,612,1103,2019-03-31 16:00:00,2019-03-31 00:00:00,LABORABLE
31,3,2019,18,529,751,1280,2019-03-31 17:00:00,2019-03-31 00:00:00,LABORABLE
31,3,2019,19,559,675,1234,2019-03-31 18:00:00,2019-03-31 00:00:00,LABORABLE
31,3,2019,20,548,712,1260,2019-03-31 19:00:00,2019-03-31 00:00:00,LABORABLE
31,3,2019,21,542,718,1260,2019-03-31 20:00:00,2019-03-31 00:00:00,LABORABLE
31,3,2019,22,528,636,1164,2019-03-31 21:00:00,2019-03-31 00:00:00,LABORABLE
31,3,2019,23,457,546,1003,2019-03-31 22:00:00,2019-03-31 00:00:00,LABORABLE
31,3,2019,24,323,467,790,2019-03-31 23:00:00,2019-03-31 00:00:00,LABORABLE
1,4,2019,1,202,332,534,2019-04-01 00:00:00,2019-01-04 00:00:00,LABORABLE
1,4,2019,2,130,249,379,2019-04-01 01:00:00,2019-01-04 00:00:00,LABORABLE
1,4,2019,3,100,193,293,2019-04-01 02:00:00,2019-01-04 00:00:00,LABORABLE
1,4,2019,4,61,137,198,2019-04-01 03:00:00,2019-01-04 00:00:00,LABORABLE
1,4,2019,5,81,137,218,2019-04-01 04:00:00,2019-01-04 00:00:00,LABORABLE
1,4,2019,6,150,167,317,2019-04-01 05:00:00,2019-01-04 00:00:00,LABORABLE
1,4,2019,7,446,444,890,2019-04-01 06:00:00,2019-01-04 00:00:00,LABORABLE
1,4,2019,8,660,606,1266,2019-04-01 07:00:00,2019-01-04 00:00:00,LABORABLE
1,4,2019,9,726,695,1421,2019-04-01 08:00:00,2019-01-04 00:00:00,LABORABLE
1,4,2019,10,614,669,1283,2019-04-01 09:00:00,2019-01-04 00:00:00,LABORABLE
1,4,2019,11,568,648,1216,2019-04-01 10:00:00,2019-01-04 00:00:00,LABORABLE
1,4,2019,12,629,719,1348,2019-04-01 11:00:00,2019-01-04 00:00:00,LABORABLE
1,4,2019,13,595,770,1365,2019-04-01 12:00:00,2019-01-04 00:00:00,LABORABLE
1,4,2019,14,635,736,1371,2019-04-01 13:00:00,2019-01-04 00:00:00,LABORABLE
1,4,2019,15,656,765,1421,2019-04-01 14:00:00,2019-01-04 00:00:00,LABORABLE
1,4,2019,16,658,751,1409,2019-04-01 15:00:00,2019-01-04 00:00:00,LABORABLE
1,4,2019,17,639,786,1425,2019-04-01 16:00:00,2019-01-04 00:00:00,LABORABLE
1,4,2019,18,683,785,1468,2019-04-01 17:00:00,2019-01-04 00:00:00,LABORABLE
1,4,2019,19,662,760,1422,2019-04-01 18:00:00,2019-01-04 00:00:00,LABORABLE
1,4,2019,20,599,716,1315,2019-04-01 19:00:00,2019-01-04 00:00:00,LABORABLE
1,4,2019,21,626,746,1372,2019-04-01 20:00:00,2019-01-04 00:00:00,LABORABLE
1,4,2019,22,548,586,1134,2019-04-01 21:00:00,2019-01-04 00:00:00,LABORABLE
1,4,2019,23,450,475,925,2019-04-01 22:00:00,2019-01-04 00:00:00,LABORABLE
1,4,2019,24,248,359,607,2019-04-01 23:00:00,2019-01-04 00:00:00,LABORABLE
2,4,2019,1,133,290,423,2019-04-02 00:00:00,2019-02-04 00:00:00,LABORABLE
2,4,2019,2,102,173,275,2019-04-02 01:00:00,2019-02-04 00:00:00,LABORABLE
2,4,2019,3,76,165,241,2019-04-02 02:00:00,2019-02-04 00:00:00,LABORABLE
2,4,2019,4,64,109,173,2019-04-02 03:00:00,2019-02-04 00:00:00,LABORABLE
2,4,2019,5,82,110,192,2019-04-02 04:00:00,2019-02-04 00:00:00,LABORABLE
2,4,2019,6,167,161,328,2019-04-02 05:00:00,2019-02-04 00:00:00,LABORABLE
2,4,2019,7,423,435,858,2019-04-02 06:00:00,2019-02-04 00:00:00,LABORABLE
2,4,2019,8,710,658,1368,2019-04-02 07:00:00,2019-02-04 00:00:00,LABORABLE
2,4,2019,9,675,729,1404,2019-04-02 08:00:00,2019-02-04 00:00:00,LABORABLE
2,4,2019,10,608,779,1387,2019-04-02 09:00:00,2019-02-04 00:00:00,LABORABLE
2,4,2019,11,450,475,925,2019-04-02 10:00:00,2019-02-04 00:00:00,LABORABLE
2,4,2019,12,574,703,1277,2019-04-02 11:00:00,2019-02-04 00:00:00,LABORABLE
2,4,2019,13,595,696,1291,2019-04-02 12:00:00,2019-02-04 00:00:00,LABORABLE
2,4,2019,14,626,703,1329,2019-04-02 13:00:00,2019-02-04 00:00:00,LABORABLE
2,4,2019,15,642,715,1357,2019-04-02 14:00:00,2019-02-04 00:00:00,LABORABLE
2,4,2019,16,624,702,1326,2019-04-02 15:00:00,2019-02-04 00:00:00,LABORABLE
2,4,2019,17,613,751,1364,2019-04-02 16:00:00,2019-02-04 00:00:00,LABORABLE
2,4,2019,18,643,743,1386,2019-04-02 17:00:00,2019-02-04 00:00:00,LABORABLE
2,4,2019,19,663,758,1421,2019-04-02 18:00:00,2019-02-04 00:00:00,LABORABLE
2,4,2019,20,573,796,1369,2019-04-02 19:00:00,2019-02-04 00:00:00,LABORABLE
2,4,2019,21,604,751,1355,2019-04-02 20:00:00,2019-02-04 00:00:00,LABORABLE
2,4,2019,22,521,669,1190,2019-04-02 21:00:00,2019-02-04 00:00:00,LABORABLE
2,4,2019,23,390,510,900,2019-04-02 22:00:00,2019-02-04 00:00:00,LABORABLE
2,4,2019,24,274,365,639,2019-04-02 23:00:00,2019-02-04 00:00:00,LABORABLE
3,4,2019,1,190,288,478,2019-04-03 00:00:00,2019-03-04 00:00:00,LABORABLE
3,4,2019,2,106,201,307,2019-04-03 01:00:00,2019-03-04 00:00:00,LABORABLE
3,4,2019,3,73,166,239,2019-04-03 02:00:00,2019-03-04 00:00:00,LABORABLE
3,4,2019,4,62,122,184,2019-04-03 03:00:00,2019-03-04 00:00:00,LABORABLE
3,4,2019,5,70,101,171,2019-04-03 04:00:00,2019-03-04 00:00:00,LABORABLE
3,4,2019,6,156,154,310,2019-04-03 05:00:00,2019-03-04 00:00:00,LABORABLE
3,4,2019,7,395,426,821,2019-04-03 06:00:00,2019-03-04 00:00:00,LABORABLE
3,4,2019,8,712,641,1353,2019-04-03 07:00:00,2019-03-04 00:00:00,LABORABLE
3,4,2019,9,702,712,1414,2019-04-03 08:00:00,2019-03-04 00:00:00,LABORABLE
3,4,2019,10,619,687,1306,2019-04-03 09:00:00,2019-03-04 00:00:00,LABORABLE
3,4,2019,11,518,669,1187,2019-04-03 10:00:00,2019-03-04 00:00:00,LABORABLE
3,4,2019,12,573,719,1292,2019-04-03 11:00:00,2019-03-04 00:00:00,LABORABLE
3,4,2019,13,607,740,1347,2019-04-03 12:00:00,2019-03-04 00:00:00,LABORABLE
3,4,2019,14,642,730,1372,2019-04-03 13:00:00,2019-03-04 00:00:00,LABORABLE
3,4,2019,15,612,738,1350,2019-04-03 14:00:00,2019-03-04 00:00:00,LABORABLE
3,4,2019,16,620,666,1286,2019-04-03 15:00:00,2019-03-04 00:00:00,LABORABLE
3,4,2019,17,665,751,1416,2019-04-03 16:00:00,2019-03-04 00:00:00,LABORABLE
3,4,2019,18,721,732,1453,2019-04-03 17:00:00,2019-03-04 00:00:00,LABORABLE
3,4,2019,19,696,787,1483,2019-04-03 18:00:00,2019-03-04 00:00:00,LABORABLE
3,4,2019,20,618,793,1411,2019-04-03 19:00:00,2019-03-04 00:00:00,LABORABLE
3,4,2019,21,633,722,1355,2019-04-03 20:00:00,2019-03-04 00:00:00,LABORABLE
3,4,2019,22,529,636,1165,2019-04-03 21:00:00,2019-03-04 00:00:00,LABORABLE
3,4,2019,23,448,499,947,2019-04-03 22:00:00,2019-03-04 00:00:00,LABORABLE
3,4,2019,24,312,335,647,2019-04-03 23:00:00,2019-03-04 00:00:00,LABORABLE
4,4,2019,1,191,303,494,2019-04-04 00:00:00,2019-04-04 00:00:00,LABORABLE
4,4,2019,2,125,210,335,2019-04-04 01:00:00,2019-04-04 00:00:00,LABORABLE
4,4,2019,3,73,158,231,2019-04-04 02:00:00,2019-04-04 00:00:00,LABORABLE
4,4,2019,4,90,113,203,2019-04-04 03:00:00,2019-04-04 00:00:00,LABORABLE
4,4,2019,5,90,107,197,2019-04-04 04:00:00,2019-04-04 00:00:00,LABORABLE
4,4,2019,6,163,180,343,2019-04-04 05:00:00,2019-04-04 00:00:00,LABORABLE
4,4,2019,7,422,394,816,2019-04-04 06:00:00,2019-04-04 00:00:00,LABORABLE
4,4,2019,8,694,662,1356,2019-04-04 07:00:00,2019-04-04 00:00:00,LABORABLE
4,4,2019,9,732,728,1460,2019-04-04 08:00:00,2019-04-04 00:00:00,LABORABLE
4,4,2019,10,680,671,1351,2019-04-04 09:00:00,2019-04-04 00:00:00,LABORABLE
4,4,2019,11,482,559,1041,2019-04-04 10:00:00,2019-04-04 00:00:00,LABORABLE
4,4,2019,12,493,604,1097,2019-04-04 11:00:00,2019-04-04 00:00:00,LABORABLE
4,4,2019,13,631,729,1360,2019-04-04 12:00:00,2019-04-04 00:00:00,LABORABLE
4,4,2019,14,647,701,1348,2019-04-04 13:00:00,2019-04-04 00:00:00,LABORABLE
4,4,2019,15,671,720,1391,2019-04-04 14:00:00,2019-04-04 00:00:00,LABORABLE
4,4,2019,16,570,679,1249,2019-04-04 15:00:00,2019-04-04 00:00:00,LABORABLE
4,4,2019,17,624,740,1364,2019-04-04 16:00:00,2019-04-04 00:00:00,LABORABLE
4,4,2019,18,734,772,1506,2019-04-04 17:00:00,2019-04-04 00:00:00,LABORABLE
4,4,2019,19,713,762,1475,2019-04-04 18:00:00,2019-04-04 00:00:00,LABORABLE
4,4,2019,20,684,807,1491,2019-04-04 19:00:00,2019-04-04 00:00:00,LABORABLE
4,4,2019,21,661,788,1449,2019-04-04 20:00:00,2019-04-04 00:00:00,LABORABLE
4,4,2019,22,598,657,1255,2019-04-04 21:00:00,2019-04-04 00:00:00,LABORABLE
4,4,2019,23,522,534,1056,2019-04-04 22:00:00,2019-04-04 00:00:00,LABORABLE
4,4,2019,24,287,433,720,2019-04-04 23:00:00,2019-04-04 00:00:00,LABORABLE
5,4,2019,1,225,309,534,2019-04-05 00:00:00,2019-05-04 00:00:00,LABORABLE
5,4,2019,2,137,268,405,2019-04-05 01:00:00,2019-05-04 00:00:00,LABORABLE
5,4,2019,3,105,176,281,2019-04-05 02:00:00,2019-05-04 00:00:00,LABORABLE
5,4,2019,4,88,145,233,2019-04-05 03:00:00,2019-05-04 00:00:00,LABORABLE
5,4,2019,5,90,121,211,2019-04-05 04:00:00,2019-05-04 00:00:00,LABORABLE
5,4,2019,6,149,184,333,2019-04-05 05:00:00,2019-05-04 00:00:00,LABORABLE
5,4,2019,7,278,312,590,2019-04-05 06:00:00,2019-05-04 00:00:00,LABORABLE
5,4,2019,8,434,509,943,2019-04-05 07:00:00,2019-05-04 00:00:00,LABORABLE
5,4,2019,9,694,520,1214,2019-04-05 08:00:00,2019-05-04 00:00:00,LABORABLE
5,4,2019,10,628,695,1323,2019-04-05 09:00:00,2019-05-04 00:00:00,LABORABLE
5,4,2019,11,522,669,1191,2019-04-05 10:00:00,2019-05-04 00:00:00,LABORABLE
5,4,2019,12,551,693,1244,2019-04-05 11:00:00,2019-05-04 00:00:00,LABORABLE
5,4,2019,13,591,723,1314,2019-04-05 12:00:00,2019-05-04 00:00:00,LABORABLE
5,4,2019,14,652,743,1395,2019-04-05 13:00:00,2019-05-04 00:00:00,LABORABLE
5,4,2019,15,666,725,1391,2019-04-05 14:00:00,2019-05-04 00:00:00,LABORABLE
5,4,2019,16,621,674,1295,2019-04-05 15:00:00,2019-05-04 00:00:00,LABORABLE
5,4,2019,17,603,799,1402,2019-04-05 16:00:00,2019-05-04 00:00:00,LABORABLE
5,4,2019,18,702,790,1492,2019-04-05 17:00:00,2019-05-04 00:00:00,LABORABLE
5,4,2019,19,670,825,1495,2019-04-05 18:00:00,2019-05-04 00:00:00,LABORABLE
5,4,2019,20,697,828,1525,2019-04-05 19:00:00,2019-05-04 00:00:00,LABORABLE
5,4,2019,21,687,824,1511,2019-04-05 20:00:00,2019-05-04 00:00:00,LABORABLE
5,4,2019,22,670,679,1349,2019-04-05 21:00:00,2019-05-04 00:00:00,LABORABLE
5,4,2019,23,562,625,1187,2019-04-05 22:00:00,2019-05-04 00:00:00,LABORABLE
5,4,2019,24,399,554,953,2019-04-05 23:00:00,2019-05-04 00:00:00,LABORABLE
6,4,2019,1,415,302,717,2019-04-06 00:00:00,2019-06-04 00:00:00,LABORABLE
6,4,2019,2,264,220,484,2019-04-06 01:00:00,2019-06-04 00:00:00,LABORABLE
6,4,2019,3,178,121,299,2019-04-06 02:00:00,2019-06-04 00:00:00,LABORABLE
6,4,2019,4,106,106,212,2019-04-06 03:00:00,2019-06-04 00:00:00,LABORABLE
6,4,2019,5,146,92,238,2019-04-06 04:00:00,2019-06-04 00:00:00,LABORABLE
6,4,2019,6,252,150,402,2019-04-06 05:00:00,2019-06-04 00:00:00,LABORABLE
6,4,2019,7,587,410,997,2019-04-06 06:00:00,2019-06-04 00:00:00,LABORABLE
6,4,2019,8,1001,592,1593,2019-04-06 07:00:00,2019-06-04 00:00:00,LABORABLE
6,4,2019,9,1273,709,1982,2019-04-06 08:00:00,2019-06-04 00:00:00,LABORABLE
6,4,2019,10,1201,719,1920,2019-04-06 09:00:00,2019-06-04 00:00:00,LABORABLE
6,4,2019,11,1283,640,1923,2019-04-06 10:00:00,2019-06-04 00:00:00,LABORABLE
6,4,2019,12,1327,733,2060,2019-04-06 11:00:00,2019-06-04 00:00:00,LABORABLE
6,4,2019,13,1430,773,2203,2019-04-06 12:00:00,2019-06-04 00:00:00,LABORABLE
6,4,2019,14,1357,804,2161,2019-04-06 13:00:00,2019-06-04 00:00:00,LABORABLE
6,4,2019,15,1361,708,2069,2019-04-06 14:00:00,2019-06-04 00:00:00,LABORABLE
6,4,2019,16,1392,755,2147,2019-04-06 15:00:00,2019-06-04 00:00:00,LABORABLE
6,4,2019,17,1351,786,2137,2019-04-06 16:00:00,2019-06-04 00:00:00,LABORABLE
6,4,2019,18,1452,763,2215,2019-04-06 17:00:00,2019-06-04 00:00:00,LABORABLE
6,4,2019,19,1562,806,2368,2019-04-06 18:00:00,2019-06-04 00:00:00,LABORABLE
6,4,2019,20,1428,794,2222,2019-04-06 19:00:00,2019-06-04 00:00:00,LABORABLE
6,4,2019,21,1477,717,2194,2019-04-06 20:00:00,2019-06-04 00:00:00,LABORABLE
6,4,2019,22,1287,714,2001,2019-04-06 21:00:00,2019-06-04 00:00:00,LABORABLE
6,4,2019,23,1088,557,1645,2019-04-06 22:00:00,2019-06-04 00:00:00,LABORABLE
6,4,2019,24,647,418,1065,2019-04-06 23:00:00,2019-06-04 00:00:00,LABORABLE
7,4,2019,1,474,305,779,2019-04-07 00:00:00,2019-07-04 00:00:00,LABORABLE
7,4,2019,2,273,237,510,2019-04-07 01:00:00,2019-07-04 00:00:00,LABORABLE
7,4,2019,3,210,160,370,2019-04-07 02:00:00,2019-07-04 00:00:00,LABORABLE
7,4,2019,4,155,140,295,2019-04-07 03:00:00,2019-07-04 00:00:00,LABORABLE
7,4,2019,5,166,109,275,2019-04-07 04:00:00,2019-07-04 00:00:00,LABORABLE
7,4,2019,6,251,164,415,2019-04-07 05:00:00,2019-07-04 00:00:00,LABORABLE
7,4,2019,7,626,422,1048,2019-04-07 06:00:00,2019-07-04 00:00:00,LABORABLE
7,4,2019,8,1078,577,1655,2019-04-07 07:00:00,2019-07-04 00:00:00,LABORABLE
7,4,2019,9,1163,657,1820,2019-04-07 08:00:00,2019-07-04 00:00:00,LABORABLE
7,4,2019,10,1094,661,1755,2019-04-07 09:00:00,2019-07-04 00:00:00,LABORABLE
7,4,2019,11,1188,710,1898,2019-04-07 10:00:00,2019-07-04 00:00:00,LABORABLE
7,4,2019,12,1418,767,2185,2019-04-07 11:00:00,2019-07-04 00:00:00,LABORABLE
7,4,2019,13,1356,811,2167,2019-04-07 12:00:00,2019-07-04 00:00:00,LABORABLE
7,4,2019,14,1348,812,2160,2019-04-07 13:00:00,2019-07-04 00:00:00,LABORABLE
7,4,2019,15,1388,788,2176,2019-04-07 14:00:00,2019-07-04 00:00:00,LABORABLE
7,4,2019,16,1267,768,2035,2019-04-07 15:00:00,2019-07-04 00:00:00,LABORABLE
7,4,2019,17,1309,801,2110,2019-04-07 16:00:00,2019-07-04 00:00:00,LABORABLE
7,4,2019,18,1459,788,2247,2019-04-07 17:00:00,2019-07-04 00:00:00,LABORABLE
7,4,2019,19,1434,832,2266,2019-04-07 18:00:00,2019-07-04 00:00:00,LABORABLE
7,4,2019,20,1432,805,2237,2019-04-07 19:00:00,2019-07-04 00:00:00,LABORABLE
7,4,2019,21,1416,909,2325,2019-04-07 20:00:00,2019-07-04 00:00:00,LABORABLE
7,4,2019,22,1363,781,2144,2019-04-07 21:00:00,2019-07-04 00:00:00,LABORABLE
7,4,2019,23,1157,665,1822,2019-04-07 22:00:00,2019-07-04 00:00:00,LABORABLE
7,4,2019,24,888,545,1433,2019-04-07 23:00:00,2019-07-04 00:00:00,LABORABLE
8,4,2019,1,203,298,501,2019-04-08 00:00:00,2019-08-04 00:00:00,LABORABLE
8,4,2019,2,129,204,333,2019-04-08 01:00:00,2019-08-04 00:00:00,LABORABLE
8,4,2019,3,95,164,259,2019-04-08 02:00:00,2019-08-04 00:00:00,LABORABLE
8,4,2019,4,63,115,178,2019-04-08 03:00:00,2019-08-04 00:00:00,LABORABLE
8,4,2019,5,77,125,202,2019-04-08 04:00:00,2019-08-04 00:00:00,LABORABLE
8,4,2019,6,152,153,305,2019-04-08 05:00:00,2019-08-04 00:00:00,LABORABLE
8,4,2019,7,434,407,841,2019-04-08 06:00:00,2019-08-04 00:00:00,LABORABLE
8,4,2019,8,602,661,1263,2019-04-08 07:00:00,2019-08-04 00:00:00,LABORABLE
8,4,2019,9,695,709,1404,2019-04-08 08:00:00,2019-08-04 00:00:00,LABORABLE
8,4,2019,10,585,728,1313,2019-04-08 09:00:00,2019-08-04 00:00:00,LABORABLE
8,4,2019,11,536,674,1210,2019-04-08 10:00:00,2019-08-04 00:00:00,LABORABLE
8,4,2019,12,555,683,1238,2019-04-08 11:00:00,2019-08-04 00:00:00,LABORABLE
8,4,2019,13,484,702,1186,2019-04-08 12:00:00,2019-08-04 00:00:00,LABORABLE
8,4,2019,14,628,783,1411,2019-04-08 13:00:00,2019-08-04 00:00:00,LABORABLE
8,4,2019,15,645,760,1405,2019-04-08 14:00:00,2019-08-04 00:00:00,LABORABLE
8,4,2019,16,599,678,1277,2019-04-08 15:00:00,2019-08-04 00:00:00,LABORABLE
8,4,2019,17,636,761,1397,2019-04-08 16:00:00,2019-08-04 00:00:00,LABORABLE
8,4,2019,18,660,741,1401,2019-04-08 17:00:00,2019-08-04 00:00:00,LABORABLE
8,4,2019,19,648,769,1417,2019-04-08 18:00:00,2019-08-04 00:00:00,LABORABLE
8,4,2019,20,596,781,1377,2019-04-08 19:00:00,2019-08-04 00:00:00,LABORABLE
8,4,2019,21,604,740,1344,2019-04-08 20:00:00,2019-08-04 00:00:00,LABORABLE
8,4,2019,22,562,670,1232,2019-04-08 21:00:00,2019-08-04 00:00:00,LABORABLE
8,4,2019,23,395,471,866,2019-04-08 22:00:00,2019-08-04 00:00:00,LABORABLE
8,4,2019,24,218,356,574,2019-04-08 23:00:00,2019-08-04 00:00:00,LABORABLE
9,4,2019,1,170,261,431,2019-04-09 00:00:00,2019-09-04 00:00:00,LABORABLE
9,4,2019,2,85,180,265,2019-04-09 01:00:00,2019-09-04 00:00:00,LABORABLE
9,4,2019,3,58,101,159,2019-04-09 02:00:00,2019-09-04 00:00:00,LABORABLE
9,4,2019,4,75,86,161,2019-04-09 03:00:00,2019-09-04 00:00:00,LABORABLE
9,4,2019,5,66,116,182,2019-04-09 04:00:00,2019-09-04 00:00:00,LABORABLE
9,4,2019,6,146,154,300,2019-04-09 05:00:00,2019-09-04 00:00:00,LABORABLE
9,4,2019,7,429,422,851,2019-04-09 06:00:00,2019-09-04 00:00:00,LABORABLE
9,4,2019,8,656,639,1295,2019-04-09 07:00:00,2019-09-04 00:00:00,LABORABLE
9,4,2019,9,707,764,1471,2019-04-09 08:00:00,2019-09-04 00:00:00,LABORABLE
9,4,2019,10,599,743,1342,2019-04-09 09:00:00,2019-09-04 00:00:00,LABORABLE
9,4,2019,11,535,675,1210,2019-04-09 10:00:00,2019-09-04 00:00:00,LABORABLE
9,4,2019,12,515,553,1068,2019-04-09 11:00:00,2019-09-04 00:00:00,LABORABLE
9,4,2019,13,609,731,1340,2019-04-09 12:00:00,2019-09-04 00:00:00,LABORABLE
9,4,2019,14,612,748,1360,2019-04-09 13:00:00,2019-09-04 00:00:00,LABORABLE
9,4,2019,15,651,760,1411,2019-04-09 14:00:00,2019-09-04 00:00:00,LABORABLE
9,4,2019,16,624,662,1286,2019-04-09 15:00:00,2019-09-04 00:00:00,LABORABLE
9,4,2019,17,605,734,1339,2019-04-09 16:00:00,2019-09-04 00:00:00,LABORABLE
9,4,2019,18,680,689,1369,2019-04-09 17:00:00,2019-09-04 00:00:00,LABORABLE
9,4,2019,19,665,751,1416,2019-04-09 18:00:00,2019-09-04 00:00:00,LABORABLE
9,4,2019,20,660,791,1451,2019-04-09 19:00:00,2019-09-04 00:00:00,LABORABLE
9,4,2019,21,607,752,1359,2019-04-09 20:00:00,2019-09-04 00:00:00,LABORABLE
9,4,2019,22,557,611,1168,2019-04-09 21:00:00,2019-09-04 00:00:00,LABORABLE
9,4,2019,23,424,479,903,2019-04-09 22:00:00,2019-09-04 00:00:00,LABORABLE
9,4,2019,24,250,378,628,2019-04-09 23:00:00,2019-09-04 00:00:00,LABORABLE
10,4,2019,1,202,265,467,2019-04-10 00:00:00,2019-10-04 00:00:00,LABORABLE
10,4,2019,2,107,179,286,2019-04-10 01:00:00,2019-10-04 00:00:00,LABORABLE
10,4,2019,3,79,131,210,2019-04-10 02:00:00,2019-10-04 00:00:00,LABORABLE
10,4,2019,4,66,89,155,2019-04-10 03:00:00,2019-10-04 00:00:00,LABORABLE
10,4,2019,5,75,90,165,2019-04-10 04:00:00,2019-10-04 00:00:00,LABORABLE
10,4,2019,6,157,192,349,2019-04-10 05:00:00,2019-10-04 00:00:00,LABORABLE
10,4,2019,7,431,417,848,2019-04-10 06:00:00,2019-10-04 00:00:00,LABORABLE
10,4,2019,8,688,674,1362,2019-04-10 07:00:00,2019-10-04 00:00:00,LABORABLE
10,4,2019,9,703,723,1426,2019-04-10 08:00:00,2019-10-04 00:00:00,LABORABLE
10,4,2019,10,654,712,1366,2019-04-10 09:00:00,2019-10-04 00:00:00,LABORABLE
10,4,2019,11,542,679,1221,2019-04-10 10:00:00,2019-10-04 00:00:00,LABORABLE
10,4,2019,12,571,713,1284,2019-04-10 11:00:00,2019-10-04 00:00:00,LABORABLE
10,4,2019,13,615,686,1301,2019-04-10 12:00:00,2019-10-04 00:00:00,LABORABLE
10,4,2019,14,643,742,1385,2019-04-10 13:00:00,2019-10-04 00:00:00,LABORABLE
10,4,2019,15,688,707,1395,2019-04-10 14:00:00,2019-10-04 00:00:00,LABORABLE
10,4,2019,16,662,699,1361,2019-04-10 15:00:00,2019-10-04 00:00:00,LABORABLE
10,4,2019,17,703,753,1456,2019-04-10 16:00:00,2019-10-04 00:00:00,LABORABLE
10,4,2019,18,757,722,1479,2019-04-10 17:00:00,2019-10-04 00:00:00,LABORABLE
10,4,2019,19,644,754,1398,2019-04-10 18:00:00,2019-10-04 00:00:00,LABORABLE
10,4,2019,20,658,784,1442,2019-04-10 19:00:00,2019-10-04 00:00:00,LABORABLE
10,4,2019,21,676,762,1438,2019-04-10 20:00:00,2019-10-04 00:00:00,LABORABLE
10,4,2019,22,477,623,1100,2019-04-10 21:00:00,2019-10-04 00:00:00,LABORABLE
10,4,2019,23,374,514,888,2019-04-10 22:00:00,2019-10-04 00:00:00,LABORABLE
10,4,2019,24,278,397,675,2019-04-10 23:00:00,2019-10-04 00:00:00,LABORABLE
11,4,2019,1,195,287,482,2019-04-11 00:00:00,2019-11-04 00:00:00,LABORABLE
11,4,2019,2,133,204,337,2019-04-11 01:00:00,2019-11-04 00:00:00,LABORABLE
11,4,2019,3,88,150,238,2019-04-11 02:00:00,2019-11-04 00:00:00,LABORABLE
11,4,2019,4,59,107,166,2019-04-11 03:00:00,2019-11-04 00:00:00,LABORABLE
11,4,2019,5,80,117,197,2019-04-11 04:00:00,2019-11-04 00:00:00,LABORABLE
11,4,2019,6,183,181,364,2019-04-11 05:00:00,2019-11-04 00:00:00,LABORABLE
11,4,2019,7,422,410,832,2019-04-11 06:00:00,2019-11-04 00:00:00,LABORABLE
11,4,2019,8,690,629,1319,2019-04-11 07:00:00,2019-11-04 00:00:00,LABORABLE
11,4,2019,9,708,731,1439,2019-04-11 08:00:00,2019-11-04 00:00:00,LABORABLE
11,4,2019,10,634,760,1394,2019-04-11 09:00:00,2019-11-04 00:00:00,LABORABLE
11,4,2019,11,561,698,1259,2019-04-11 10:00:00,2019-11-04 00:00:00,LABORABLE
11,4,2019,12,588,736,1324,2019-04-11 11:00:00,2019-11-04 00:00:00,LABORABLE
11,4,2019,13,639,782,1421,2019-04-11 12:00:00,2019-11-04 00:00:00,LABORABLE
11,4,2019,14,691,749,1440,2019-04-11 13:00:00,2019-11-04 00:00:00,LABORABLE
11,4,2019,15,643,703,1346,2019-04-11 14:00:00,2019-11-04 00:00:00,LABORABLE
11,4,2019,16,644,699,1343,2019-04-11 15:00:00,2019-11-04 00:00:00,LABORABLE
11,4,2019,17,626,727,1353,2019-04-11 16:00:00,2019-11-04 00:00:00,LABORABLE
11,4,2019,18,710,777,1487,2019-04-11 17:00:00,2019-11-04 00:00:00,LABORABLE
11,4,2019,19,685,784,1469,2019-04-11 18:00:00,2019-11-04 00:00:00,LABORABLE
11,4,2019,20,671,746,1417,2019-04-11 19:00:00,2019-11-04 00:00:00,LABORABLE
11,4,2019,21,652,804,1456,2019-04-11 20:00:00,2019-11-04 00:00:00,LABORABLE
11,4,2019,22,615,636,1251,2019-04-11 21:00:00,2019-11-04 00:00:00,LABORABLE
11,4,2019,23,508,542,1050,2019-04-11 22:00:00,2019-11-04 00:00:00,LABORABLE
11,4,2019,24,314,439,753,2019-04-11 23:00:00,2019-11-04 00:00:00,LABORABLE
12,4,2019,1,219,299,518,2019-04-12 00:00:00,2019-12-04 00:00:00,LABORABLE
12,4,2019,2,144,248,392,2019-04-12 01:00:00,2019-12-04 00:00:00,LABORABLE
12,4,2019,3,103,195,298,2019-04-12 02:00:00,2019-12-04 00:00:00,LABORABLE
12,4,2019,4,89,150,239,2019-04-12 03:00:00,2019-12-04 00:00:00,LABORABLE
12,4,2019,5,94,116,210,2019-04-12 04:00:00,2019-12-04 00:00:00,LABORABLE
12,4,2019,6,128,178,306,2019-04-12 05:00:00,2019-12-04 00:00:00,LABORABLE
12,4,2019,7,278,412,690,2019-04-12 06:00:00,2019-12-04 00:00:00,LABORABLE
12,4,2019,8,434,598,1032,2019-04-12 07:00:00,2019-12-04 00:00:00,LABORABLE
12,4,2019,9,579,641,1220,2019-04-12 08:00:00,2019-12-04 00:00:00,LABORABLE
12,4,2019,10,609,659,1268,2019-04-12 09:00:00,2019-12-04 00:00:00,LABORABLE
12,4,2019,11,585,687,1272,2019-04-12 10:00:00,2019-12-04 00:00:00,LABORABLE
12,4,2019,12,589,611,1200,2019-04-12 11:00:00,2019-12-04 00:00:00,LABORABLE
12,4,2019,13,535,655,1190,2019-04-12 12:00:00,2019-12-04 00:00:00,LABORABLE
12,4,2019,14,650,743,1393,2019-04-12 13:00:00,2019-12-04 00:00:00,LABORABLE
12,4,2019,15,696,685,1381,2019-04-12 14:00:00,2019-12-04 00:00:00,LABORABLE
12,4,2019,16,638,713,1351,2019-04-12 15:00:00,2019-12-04 00:00:00,LABORABLE
12,4,2019,17,625,716,1341,2019-04-12 16:00:00,2019-12-04 00:00:00,LABORABLE
12,4,2019,18,671,820,1491,2019-04-12 17:00:00,2019-12-04 00:00:00,LABORABLE
12,4,2019,19,729,851,1580,2019-04-12 18:00:00,2019-12-04 00:00:00,LABORABLE
12,4,2019,20,654,812,1466,2019-04-12 19:00:00,2019-12-04 00:00:00,LABORABLE
12,4,2019,21,671,829,1500,2019-04-12 20:00:00,2019-12-04 00:00:00,LABORABLE
12,4,2019,22,623,760,1383,2019-04-12 21:00:00,2019-12-04 00:00:00,LABORABLE
12,4,2019,23,564,654,1218,2019-04-12 22:00:00,2019-12-04 00:00:00,LABORABLE
12,4,2019,24,428,571,999,2019-04-12 23:00:00,2019-12-04 00:00:00,LABORABLE
13,4,2019,1,568,368,936,2019-04-13 00:00:00,2019-04-13 00:00:00,LABORABLE
13,4,2019,2,358,269,627,2019-04-13 01:00:00,2019-04-13 00:00:00,LABORABLE
13,4,2019,3,272,203,475,2019-04-13 02:00:00,2019-04-13 00:00:00,LABORABLE
13,4,2019,4,195,157,352,2019-04-13 03:00:00,2019-04-13 00:00:00,LABORABLE
13,4,2019,5,169,138,307,2019-04-13 04:00:00,2019-04-13 00:00:00,LABORABLE
13,4,2019,6,216,122,338,2019-04-13 05:00:00,2019-04-13 00:00:00,LABORABLE
13,4,2019,7,314,157,471,2019-04-13 06:00:00,2019-04-13 00:00:00,LABORABLE
13,4,2019,8,413,224,637,2019-04-13 07:00:00,2019-04-13 00:00:00,LABORABLE
13,4,2019,9,409,331,740,2019-04-13 08:00:00,2019-04-13 00:00:00,LABORABLE
13,4,2019,10,538,399,937,2019-04-13 09:00:00,2019-04-13 00:00:00,LABORABLE
13,4,2019,11,774,419,1193,2019-04-13 10:00:00,2019-04-13 00:00:00,LABORABLE
13,4,2019,12,824,545,1369,2019-04-13 11:00:00,2019-04-13 00:00:00,LABORABLE
13,4,2019,13,924,605,1529,2019-04-13 12:00:00,2019-04-13 00:00:00,LABORABLE
13,4,2019,14,824,574,1398,2019-04-13 13:00:00,2019-04-13 00:00:00,LABORABLE
13,4,2019,15,837,541,1378,2019-04-13 14:00:00,2019-04-13 00:00:00,LABORABLE
13,4,2019,16,663,517,1180,2019-04-13 15:00:00,2019-04-13 00:00:00,LABORABLE
13,4,2019,17,639,450,1089,2019-04-13 16:00:00,2019-04-13 00:00:00,LABORABLE
13,4,2019,18,751,482,1233,2019-04-13 17:00:00,2019-04-13 00:00:00,LABORABLE
13,4,2019,19,796,528,1324,2019-04-13 18:00:00,2019-04-13 00:00:00,LABORABLE
13,4,2019,20,891,612,1503,2019-04-13 19:00:00,2019-04-13 00:00:00,LABORABLE
13,4,2019,21,842,556,1398,2019-04-13 20:00:00,2019-04-13 00:00:00,LABORABLE
13,4,2019,22,882,551,1433,2019-04-13 21:00:00,2019-04-13 00:00:00,LABORABLE
13,4,2019,23,819,528,1347,2019-04-13 22:00:00,2019-04-13 00:00:00,LABORABLE
13,4,2019,24,577,400,977,2019-04-13 23:00:00,2019-04-13 00:00:00,LABORABLE
14,4,2019,1,535,350,885,2019-04-14 00:00:00,2019-04-14 00:00:00,LABORABLE
14,4,2019,2,366,265,631,2019-04-14 01:00:00,2019-04-14 00:00:00,LABORABLE
14,4,2019,3,270,218,488,2019-04-14 02:00:00,2019-04-14 00:00:00,LABORABLE
14,4,2019,4,217,152,369,2019-04-14 03:00:00,2019-04-14 00:00:00,LABORABLE
14,4,2019,5,182,129,311,2019-04-14 04:00:00,2019-04-14 00:00:00,LABORABLE
14,4,2019,6,136,92,228,2019-04-14 05:00:00,2019-04-14 00:00:00,LABORABLE
14,4,2019,7,215,170,385,2019-04-14 06:00:00,2019-04-14 00:00:00,LABORABLE
14,4,2019,8,250,152,402,2019-04-14 07:00:00,2019-04-14 00:00:00,LABORABLE
14,4,2019,9,311,213,524,2019-04-14 08:00:00,2019-04-14 00:00:00,LABORABLE
14,4,2019,10,464,312,776,2019-04-14 09:00:00,2019-04-14 00:00:00,LABORABLE
14,4,2019,11,571,380,951,2019-04-14 10:00:00,2019-04-14 00:00:00,LABORABLE
14,4,2019,12,662,428,1090,2019-04-14 11:00:00,2019-04-14 00:00:00,LABORABLE
14,4,2019,13,782,509,1291,2019-04-14 12:00:00,2019-04-14 00:00:00,LABORABLE
14,4,2019,14,809,565,1374,2019-04-14 13:00:00,2019-04-14 00:00:00,LABORABLE
14,4,2019,15,734,437,1171,2019-04-14 14:00:00,2019-04-14 00:00:00,LABORABLE
14,4,2019,16,543,458,1001,2019-04-14 15:00:00,2019-04-14 00:00:00,LABORABLE
14,4,2019,17,653,447,1100,2019-04-14 16:00:00,2019-04-14 00:00:00,LABORABLE
14,4,2019,18,723,470,1193,2019-04-14 17:00:00,2019-04-14 00:00:00,LABORABLE
14,4,2019,19,848,489,1337,2019-04-14 18:00:00,2019-04-14 00:00:00,LABORABLE
14,4,2019,20,691,563,1254,2019-04-14 19:00:00,2019-04-14 00:00:00,LABORABLE
14,4,2019,21,631,483,1114,2019-04-14 20:00:00,2019-04-14 00:00:00,LABORABLE
14,4,2019,22,879,568,1447,2019-04-14 21:00:00,2019-04-14 00:00:00,LABORABLE
14,4,2019,23,817,500,1317,2019-04-14 22:00:00,2019-04-14 00:00:00,LABORABLE
14,4,2019,24,611,407,1018,2019-04-14 23:00:00,2019-04-14 00:00:00,LABORABLE
15,4,2019,1,499,322,821,2019-04-15 00:00:00,2019-04-15 00:00:00,LABORABLE
15,4,2019,2,384,262,646,2019-04-15 01:00:00,2019-04-15 00:00:00,LABORABLE
15,4,2019,3,251,183,434,2019-04-15 02:00:00,2019-04-15 00:00:00,LABORABLE
15,4,2019,4,215,150,365,2019-04-15 03:00:00,2019-04-15 00:00:00,LABORABLE
15,4,2019,5,169,107,276,2019-04-15 04:00:00,2019-04-15 00:00:00,LABORABLE
15,4,2019,6,200,147,347,2019-04-15 05:00:00,2019-04-15 00:00:00,LABORABLE
15,4,2019,7,315,191,506,2019-04-15 06:00:00,2019-04-15 00:00:00,LABORABLE
15,4,2019,8,375,212,587,2019-04-15 07:00:00,2019-04-15 00:00:00,LABORABLE
15,4,2019,9,425,308,733,2019-04-15 08:00:00,2019-04-15 00:00:00,LABORABLE
15,4,2019,10,551,384,935,2019-04-15 09:00:00,2019-04-15 00:00:00,LABORABLE
15,4,2019,11,709,494,1203,2019-04-15 10:00:00,2019-04-15 00:00:00,LABORABLE
15,4,2019,12,931,621,1552,2019-04-15 11:00:00,2019-04-15 00:00:00,LABORABLE
15,4,2019,13,941,622,1563,2019-04-15 12:00:00,2019-04-15 00:00:00,LABORABLE
15,4,2019,14,988,636,1624,2019-04-15 13:00:00,2019-04-15 00:00:00,LABORABLE
15,4,2019,15,981,624,1605,2019-04-15 14:00:00,2019-04-15 00:00:00,LABORABLE
15,4,2019,16,737,553,1290,2019-04-15 15:00:00,2019-04-15 00:00:00,LABORABLE
15,4,2019,17,800,541,1341,2019-04-15 16:00:00,2019-04-15 00:00:00,LABORABLE
15,4,2019,18,827,527,1354,2019-04-15 17:00:00,2019-04-15 00:00:00,LABORABLE
15,4,2019,19,839,595,1434,2019-04-15 18:00:00,2019-04-15 00:00:00,LABORABLE
15,4,2019,20,941,584,1525,2019-04-15 19:00:00,2019-04-15 00:00:00,LABORABLE
15,4,2019,21,1101,638,1739,2019-04-15 20:00:00,2019-04-15 00:00:00,LABORABLE
15,4,2019,22,1157,606,1763,2019-04-15 21:00:00,2019-04-15 00:00:00,LABORABLE
15,4,2019,23,979,559,1538,2019-04-15 22:00:00,2019-04-15 00:00:00,LABORABLE
15,4,2019,24,756,443,1199,2019-04-15 23:00:00,2019-04-15 00:00:00,LABORABLE
16,4,2019,1,691,448,1139,2019-04-16 00:00:00,2019-04-16 00:00:00,LABORABLE
16,4,2019,2,541,229,770,2019-04-16 01:00:00,2019-04-16 00:00:00,LABORABLE
16,4,2019,3,445,299,744,2019-04-16 02:00:00,2019-04-16 00:00:00,LABORABLE
16,4,2019,4,293,258,551,2019-04-16 03:00:00,2019-04-16 00:00:00,LABORABLE
16,4,2019,5,269,199,468,2019-04-16 04:00:00,2019-04-16 00:00:00,LABORABLE
16,4,2019,6,234,191,425,2019-04-16 05:00:00,2019-04-16 00:00:00,LABORABLE
16,4,2019,7,343,267,610,2019-04-16 06:00:00,2019-04-16 00:00:00,LABORABLE
16,4,2019,8,258,199,457,2019-04-16 07:00:00,2019-04-16 00:00:00,LABORABLE
16,4,2019,9,318,239,557,2019-04-16 08:00:00,2019-04-16 00:00:00,LABORABLE
16,4,2019,10,443,319,762,2019-04-16 09:00:00,2019-04-16 00:00:00,LABORABLE
16,4,2019,11,606,362,968,2019-04-16 10:00:00,2019-04-16 00:00:00,LABORABLE
16,4,2019,12,780,476,1256,2019-04-16 11:00:00,2019-04-16 00:00:00,LABORABLE
16,4,2019,13,847,550,1397,2019-04-16 12:00:00,2019-04-16 00:00:00,LABORABLE
16,4,2019,14,959,580,1539,2019-04-16 13:00:00,2019-04-16 00:00:00,LABORABLE
16,4,2019,15,910,576,1486,2019-04-16 14:00:00,2019-04-16 00:00:00,LABORABLE
16,4,2019,16,809,539,1348,2019-04-16 15:00:00,2019-04-16 00:00:00,LABORABLE
16,4,2019,17,817,541,1358,2019-04-16 16:00:00,2019-04-16 00:00:00,LABORABLE
16,4,2019,18,927,604,1531,2019-04-16 17:00:00,2019-04-16 00:00:00,LABORABLE
16,4,2019,19,923,591,1514,2019-04-16 18:00:00,2019-04-16 00:00:00,LABORABLE
16,4,2019,20,976,580,1556,2019-04-16 19:00:00,2019-04-16 00:00:00,LABORABLE
16,4,2019,21,1004,579,1583,2019-04-16 20:00:00,2019-04-16 00:00:00,LABORABLE
16,4,2019,22,1045,608,1653,2019-04-16 21:00:00,2019-04-16 00:00:00,LABORABLE
16,4,2019,23,921,470,1391,2019-04-16 22:00:00,2019-04-16 00:00:00,LABORABLE
16,4,2019,24,643,440,1083,2019-04-16 23:00:00,2019-04-16 00:00:00,LABORABLE
17,4,2019,1,485,327,812,2019-04-17 00:00:00,2019-04-17 00:00:00,LABORABLE
17,4,2019,2,338,259,597,2019-04-17 01:00:00,2019-04-17 00:00:00,LABORABLE
17,4,2019,3,204,213,417,2019-04-17 02:00:00,2019-04-17 00:00:00,LABORABLE
17,4,2019,4,146,111,257,2019-04-17 03:00:00,2019-04-17 00:00:00,LABORABLE
17,4,2019,5,142,110,252,2019-04-17 04:00:00,2019-04-17 00:00:00,LABORABLE
17,4,2019,6,221,153,374,2019-04-17 05:00:00,2019-04-17 00:00:00,LABORABLE
17,4,2019,7,540,385,925,2019-04-17 06:00:00,2019-04-17 00:00:00,LABORABLE
17,4,2019,8,924,573,1497,2019-04-17 07:00:00,2019-04-17 00:00:00,LABORABLE
17,4,2019,9,1176,615,1791,2019-04-17 08:00:00,2019-04-17 00:00:00,LABORABLE
17,4,2019,10,1180,687,1867,2019-04-17 09:00:00,2019-04-17 00:00:00,LABORABLE
17,4,2019,11,1184,685,1869,2019-04-17 10:00:00,2019-04-17 00:00:00,LABORABLE
17,4,2019,12,1295,777,2072,2019-04-17 11:00:00,2019-04-17 00:00:00,LABORABLE
17,4,2019,13,1325,767,2092,2019-04-17 12:00:00,2019-04-17 00:00:00,LABORABLE
17,4,2019,14,1439,823,2262,2019-04-17 13:00:00,2019-04-17 00:00:00,LABORABLE
17,4,2019,15,1256,726,1982,2019-04-17 14:00:00,2019-04-17 00:00:00,LABORABLE
17,4,2019,16,1176,665,1841,2019-04-17 15:00:00,2019-04-17 00:00:00,LABORABLE
17,4,2019,17,1223,696,1919,2019-04-17 16:00:00,2019-04-17 00:00:00,LABORABLE
17,4,2019,18,1400,707,2107,2019-04-17 17:00:00,2019-04-17 00:00:00,LABORABLE
17,4,2019,19,1519,825,2344,2019-04-17 18:00:00,2019-04-17 00:00:00,LABORABLE
17,4,2019,20,1432,818,2250,2019-04-17 19:00:00,2019-04-17 00:00:00,LABORABLE
17,4,2019,21,1213,810,2023,2019-04-17 20:00:00,2019-04-17 00:00:00,LABORABLE
17,4,2019,22,1113,723,1836,2019-04-17 21:00:00,2019-04-17 00:00:00,LABORABLE
17,4,2019,23,878,484,1362,2019-04-17 22:00:00,2019-04-17 00:00:00,LABORABLE
17,4,2019,24,551,365,916,2019-04-17 23:00:00,2019-04-17 00:00:00,LABORABLE
18,4,2019,1,342,247,589,2019-04-18 00:00:00,2019-04-18 00:00:00,FESTIVO
18,4,2019,2,209,150,359,2019-04-18 01:00:00,2019-04-18 00:00:00,FESTIVO
18,4,2019,3,197,129,326,2019-04-18 02:00:00,2019-04-18 00:00:00,FESTIVO
18,4,2019,4,128,96,224,2019-04-18 03:00:00,2019-04-18 00:00:00,FESTIVO
18,4,2019,5,141,70,211,2019-04-18 04:00:00,2019-04-18 00:00:00,FESTIVO
18,4,2019,6,227,164,391,2019-04-18 05:00:00,2019-04-18 00:00:00,FESTIVO
18,4,2019,7,585,417,1002,2019-04-18 06:00:00,2019-04-18 00:00:00,FESTIVO
18,4,2019,8,1019,611,1630,2019-04-18 07:00:00,2019-04-18 00:00:00,FESTIVO
18,4,2019,9,1315,716,2031,2019-04-18 08:00:00,2019-04-18 00:00:00,FESTIVO
18,4,2019,10,1277,780,2057,2019-04-18 09:00:00,2019-04-18 00:00:00,FESTIVO
18,4,2019,11,909,719,1628,2019-04-18 10:00:00,2019-04-18 00:00:00,FESTIVO
18,4,2019,12,875,493,1368,2019-04-18 11:00:00,2019-04-18 00:00:00,FESTIVO
18,4,2019,13,1357,742,2099,2019-04-18 12:00:00,2019-04-18 00:00:00,FESTIVO
18,4,2019,14,1415,839,2254,2019-04-18 13:00:00,2019-04-18 00:00:00,FESTIVO
18,4,2019,15,1289,729,2018,2019-04-18 14:00:00,2019-04-18 00:00:00,FESTIVO
18,4,2019,16,1208,760,1968,2019-04-18 15:00:00,2019-04-18 00:00:00,FESTIVO
18,4,2019,17,1233,742,1975,2019-04-18 16:00:00,2019-04-18 00:00:00,FESTIVO
18,4,2019,18,1330,793,2123,2019-04-18 17:00:00,2019-04-18 00:00:00,FESTIVO
18,4,2019,19,1392,804,2196,2019-04-18 18:00:00,2019-04-18 00:00:00,FESTIVO
18,4,2019,20,1380,805,2185,2019-04-18 19:00:00,2019-04-18 00:00:00,FESTIVO
18,4,2019,21,1333,787,2120,2019-04-18 20:00:00,2019-04-18 00:00:00,FESTIVO
18,4,2019,22,960,546,1506,2019-04-18 21:00:00,2019-04-18 00:00:00,FESTIVO
18,4,2019,23,668,462,1130,2019-04-18 22:00:00,2019-04-18 00:00:00,FESTIVO
18,4,2019,24,577,371,948,2019-04-18 23:00:00,2019-04-18 00:00:00,FESTIVO
19,4,2019,1,351,228,579,2019-04-19 00:00:00,2019-04-19 00:00:00,FESTIVO
19,4,2019,2,256,192,448,2019-04-19 01:00:00,2019-04-19 00:00:00,FESTIVO
19,4,2019,3,180,133,313,2019-04-19 02:00:00,2019-04-19 00:00:00,FESTIVO
19,4,2019,4,130,84,214,2019-04-19 03:00:00,2019-04-19 00:00:00,FESTIVO
19,4,2019,5,116,68,184,2019-04-19 04:00:00,2019-04-19 00:00:00,FESTIVO
19,4,2019,6,193,142,335,2019-04-19 05:00:00,2019-04-19 00:00:00,FESTIVO
19,4,2019,7,616,391,1007,2019-04-19 06:00:00,2019-04-19 00:00:00,FESTIVO
19,4,2019,8,1074,625,1699,2019-04-19 07:00:00,2019-04-19 00:00:00,FESTIVO
19,4,2019,9,1302,712,2014,2019-04-19 08:00:00,2019-04-19 00:00:00,FESTIVO
19,4,2019,10,1341,728,2069,2019-04-19 09:00:00,2019-04-19 00:00:00,FESTIVO
19,4,2019,11,1271,661,1932,2019-04-19 10:00:00,2019-04-19 00:00:00,FESTIVO
19,4,2019,12,1288,772,2060,2019-04-19 11:00:00,2019-04-19 00:00:00,FESTIVO
19,4,2019,13,1303,739,2042,2019-04-19 12:00:00,2019-04-19 00:00:00,FESTIVO
19,4,2019,14,1292,783,2075,2019-04-19 13:00:00,2019-04-19 00:00:00,FESTIVO
19,4,2019,15,1332,689,2021,2019-04-19 14:00:00,2019-04-19 00:00:00,FESTIVO
19,4,2019,16,1274,692,1966,2019-04-19 15:00:00,2019-04-19 00:00:00,FESTIVO
19,4,2019,17,1231,692,1923,2019-04-19 16:00:00,2019-04-19 00:00:00,FESTIVO
19,4,2019,18,1267,713,1980,2019-04-19 17:00:00,2019-04-19 00:00:00,FESTIVO
19,4,2019,19,1413,805,2218,2019-04-19 18:00:00,2019-04-19 00:00:00,FESTIVO
19,4,2019,20,1374,763,2137,2019-04-19 19:00:00,2019-04-19 00:00:00,FESTIVO
19,4,2019,21,1358,828,2186,2019-04-19 20:00:00,2019-04-19 00:00:00,FESTIVO
19,4,2019,22,1097,656,1753,2019-04-19 21:00:00,2019-04-19 00:00:00,FESTIVO
19,4,2019,23,773,480,1253,2019-04-19 22:00:00,2019-04-19 00:00:00,FESTIVO
19,4,2019,24,608,365,973,2019-04-19 23:00:00,2019-04-19 00:00:00,FESTIVO
20,4,2019,1,441,275,716,2019-04-20 00:00:00,2019-04-20 00:00:00,LABORABLE
20,4,2019,2,252,181,433,2019-04-20 01:00:00,2019-04-20 00:00:00,LABORABLE
20,4,2019,3,177,100,277,2019-04-20 02:00:00,2019-04-20 00:00:00,LABORABLE
20,4,2019,4,114,86,200,2019-04-20 03:00:00,2019-04-20 00:00:00,LABORABLE
20,4,2019,5,146,82,228,2019-04-20 04:00:00,2019-04-20 00:00:00,LABORABLE
20,4,2019,6,229,163,392,2019-04-20 05:00:00,2019-04-20 00:00:00,LABORABLE
20,4,2019,7,608,414,1022,2019-04-20 06:00:00,2019-04-20 00:00:00,LABORABLE
20,4,2019,8,975,610,1585,2019-04-20 07:00:00,2019-04-20 00:00:00,LABORABLE
20,4,2019,9,1486,777,2263,2019-04-20 08:00:00,2019-04-20 00:00:00,LABORABLE
20,4,2019,10,1388,711,2099,2019-04-20 09:00:00,2019-04-20 00:00:00,LABORABLE
20,4,2019,11,1392,701,2093,2019-04-20 10:00:00,2019-04-20 00:00:00,LABORABLE
20,4,2019,12,1226,771,1997,2019-04-20 11:00:00,2019-04-20 00:00:00,LABORABLE
20,4,2019,13,1298,741,2039,2019-04-20 12:00:00,2019-04-20 00:00:00,LABORABLE
20,4,2019,14,1588,810,2398,2019-04-20 13:00:00,2019-04-20 00:00:00,LABORABLE
20,4,2019,15,1388,673,2061,2019-04-20 14:00:00,2019-04-20 00:00:00,LABORABLE
20,4,2019,16,1294,682,1976,2019-04-20 15:00:00,2019-04-20 00:00:00,LABORABLE
20,4,2019,17,1314,753,2067,2019-04-20 16:00:00,2019-04-20 00:00:00,LABORABLE
20,4,2019,18,1310,747,2057,2019-04-20 17:00:00,2019-04-20 00:00:00,LABORABLE
20,4,2019,19,1371,759,2130,2019-04-20 18:00:00,2019-04-20 00:00:00,LABORABLE
20,4,2019,20,1473,832,2305,2019-04-20 19:00:00,2019-04-20 00:00:00,LABORABLE
20,4,2019,21,1342,794,2136,2019-04-20 20:00:00,2019-04-20 00:00:00,LABORABLE
20,4,2019,22,1217,702,1919,2019-04-20 21:00:00,2019-04-20 00:00:00,LABORABLE
20,4,2019,23,933,546,1479,2019-04-20 22:00:00,2019-04-20 00:00:00,LABORABLE
20,4,2019,24,661,400,1061,2019-04-20 23:00:00,2019-04-20 00:00:00,LABORABLE
21,4,2019,1,502,299,801,2019-04-21 00:00:00,2019-04-21 00:00:00,LABORABLE
21,4,2019,2,297,219,516,2019-04-21 01:00:00,2019-04-21 00:00:00,LABORABLE
21,4,2019,3,209,157,366,2019-04-21 02:00:00,2019-04-21 00:00:00,LABORABLE
21,4,2019,4,166,102,268,2019-04-21 03:00:00,2019-04-21 00:00:00,LABORABLE
21,4,2019,5,152,95,247,2019-04-21 04:00:00,2019-04-21 00:00:00,LABORABLE
21,4,2019,6,258,147,405,2019-04-21 05:00:00,2019-04-21 00:00:00,LABORABLE
21,4,2019,7,597,409,1006,2019-04-21 06:00:00,2019-04-21 00:00:00,LABORABLE
21,4,2019,8,1098,630,1728,2019-04-21 07:00:00,2019-04-21 00:00:00,LABORABLE
21,4,2019,9,1342,709,2051,2019-04-21 08:00:00,2019-04-21 00:00:00,LABORABLE
21,4,2019,10,1388,731,2119,2019-04-21 09:00:00,2019-04-21 00:00:00,LABORABLE
21,4,2019,11,1244,700,1944,2019-04-21 10:00:00,2019-04-21 00:00:00,LABORABLE
21,4,2019,12,1240,746,1986,2019-04-21 11:00:00,2019-04-21 00:00:00,LABORABLE
21,4,2019,13,1368,695,2063,2019-04-21 12:00:00,2019-04-21 00:00:00,LABORABLE
21,4,2019,14,1305,790,2095,2019-04-21 13:00:00,2019-04-21 00:00:00,LABORABLE
21,4,2019,15,1384,780,2164,2019-04-21 14:00:00,2019-04-21 00:00:00,LABORABLE
21,4,2019,16,1333,687,2020,2019-04-21 15:00:00,2019-04-21 00:00:00,LABORABLE
21,4,2019,17,1391,782,2173,2019-04-21 16:00:00,2019-04-21 00:00:00,LABORABLE
21,4,2019,18,1420,794,2214,2019-04-21 17:00:00,2019-04-21 00:00:00,LABORABLE
21,4,2019,19,1478,769,2247,2019-04-21 18:00:00,2019-04-21 00:00:00,LABORABLE
21,4,2019,20,1479,834,2313,2019-04-21 19:00:00,2019-04-21 00:00:00,LABORABLE
21,4,2019,21,1486,885,2371,2019-04-21 20:00:00,2019-04-21 00:00:00,LABORABLE
21,4,2019,22,1423,779,2202,2019-04-21 21:00:00,2019-04-21 00:00:00,LABORABLE
21,4,2019,23,1102,626,1728,2019-04-21 22:00:00,2019-04-21 00:00:00,LABORABLE
21,4,2019,24,806,502,1308,2019-04-21 23:00:00,2019-04-21 00:00:00,LABORABLE
22,4,2019,1,197,307,504,2019-04-22 00:00:00,2019-04-22 00:00:00,LABORABLE
22,4,2019,2,138,241,379,2019-04-22 01:00:00,2019-04-22 00:00:00,LABORABLE
22,4,2019,3,104,185,289,2019-04-22 02:00:00,2019-04-22 00:00:00,LABORABLE
22,4,2019,4,79,122,201,2019-04-22 03:00:00,2019-04-22 00:00:00,LABORABLE
22,4,2019,5,81,103,184,2019-04-22 04:00:00,2019-04-22 00:00:00,LABORABLE
22,4,2019,6,148,153,301,2019-04-22 05:00:00,2019-04-22 00:00:00,LABORABLE
22,4,2019,7,354,385,739,2019-04-22 06:00:00,2019-04-22 00:00:00,LABORABLE
22,4,2019,8,592,541,1133,2019-04-22 07:00:00,2019-04-22 00:00:00,LABORABLE
22,4,2019,9,554,628,1182,2019-04-22 08:00:00,2019-04-22 00:00:00,LABORABLE
22,4,2019,10,536,627,1163,2019-04-22 09:00:00,2019-04-22 00:00:00,LABORABLE
22,4,2019,11,550,651,1201,2019-04-22 10:00:00,2019-04-22 00:00:00,LABORABLE
22,4,2019,12,578,763,1341,2019-04-22 11:00:00,2019-04-22 00:00:00,LABORABLE
22,4,2019,13,603,758,1361,2019-04-22 12:00:00,2019-04-22 00:00:00,LABORABLE
22,4,2019,14,576,811,1387,2019-04-22 13:00:00,2019-04-22 00:00:00,LABORABLE
22,4,2019,15,632,707,1339,2019-04-22 14:00:00,2019-04-22 00:00:00,LABORABLE
22,4,2019,16,596,700,1296,2019-04-22 15:00:00,2019-04-22 00:00:00,LABORABLE
22,4,2019,17,636,790,1426,2019-04-22 16:00:00,2019-04-22 00:00:00,LABORABLE
22,4,2019,18,720,799,1519,2019-04-22 17:00:00,2019-04-22 00:00:00,LABORABLE
22,4,2019,19,699,794,1493,2019-04-22 18:00:00,2019-04-22 00:00:00,LABORABLE
22,4,2019,20,645,781,1426,2019-04-22 19:00:00,2019-04-22 00:00:00,LABORABLE
22,4,2019,21,624,777,1401,2019-04-22 20:00:00,2019-04-22 00:00:00,LABORABLE
22,4,2019,22,497,650,1147,2019-04-22 21:00:00,2019-04-22 00:00:00,LABORABLE
22,4,2019,23,363,488,851,2019-04-22 22:00:00,2019-04-22 00:00:00,LABORABLE
22,4,2019,24,223,331,554,2019-04-22 23:00:00,2019-04-22 00:00:00,LABORABLE
23,4,2019,1,164,249,413,2019-04-23 00:00:00,2019-04-23 00:00:00,LABORABLE
23,4,2019,2,85,187,272,2019-04-23 01:00:00,2019-04-23 00:00:00,LABORABLE
23,4,2019,3,63,124,187,2019-04-23 02:00:00,2019-04-23 00:00:00,LABORABLE
23,4,2019,4,73,85,158,2019-04-23 03:00:00,2019-04-23 00:00:00,LABORABLE
23,4,2019,5,66,88,154,2019-04-23 04:00:00,2019-04-23 00:00:00,LABORABLE
23,4,2019,6,144,134,278,2019-04-23 05:00:00,2019-04-23 00:00:00,LABORABLE
23,4,2019,7,408,423,831,2019-04-23 06:00:00,2019-04-23 00:00:00,LABORABLE
23,4,2019,8,698,642,1340,2019-04-23 07:00:00,2019-04-23 00:00:00,LABORABLE
23,4,2019,9,668,709,1377,2019-04-23 08:00:00,2019-04-23 00:00:00,LABORABLE
23,4,2019,10,615,703,1318,2019-04-23 09:00:00,2019-04-23 00:00:00,LABORABLE
23,4,2019,11,534,708,1242,2019-04-23 10:00:00,2019-04-23 00:00:00,LABORABLE
23,4,2019,12,619,722,1341,2019-04-23 11:00:00,2019-04-23 00:00:00,LABORABLE
23,4,2019,13,638,734,1372,2019-04-23 12:00:00,2019-04-23 00:00:00,LABORABLE
23,4,2019,14,593,753,1346,2019-04-23 13:00:00,2019-04-23 00:00:00,LABORABLE
23,4,2019,15,626,732,1358,2019-04-23 14:00:00,2019-04-23 00:00:00,LABORABLE
23,4,2019,16,628,672,1300,2019-04-23 15:00:00,2019-04-23 00:00:00,LABORABLE
23,4,2019,17,621,744,1365,2019-04-23 16:00:00,2019-04-23 00:00:00,LABORABLE
23,4,2019,18,699,822,1521,2019-04-23 17:00:00,2019-04-23 00:00:00,LABORABLE
23,4,2019,19,621,753,1374,2019-04-23 18:00:00,2019-04-23 00:00:00,LABORABLE
23,4,2019,20,601,766,1367,2019-04-23 19:00:00,2019-04-23 00:00:00,LABORABLE
23,4,2019,21,621,793,1414,2019-04-23 20:00:00,2019-04-23 00:00:00,LABORABLE
23,4,2019,22,517,634,1151,2019-04-23 21:00:00,2019-04-23 00:00:00,LABORABLE
23,4,2019,23,386,436,822,2019-04-23 22:00:00,2019-04-23 00:00:00,LABORABLE
23,4,2019,24,234,299,533,2019-04-23 23:00:00,2019-04-23 00:00:00,LABORABLE
24,4,2019,1,195,248,443,2019-04-24 00:00:00,2019-04-24 00:00:00,LABORABLE
24,4,2019,2,92,171,263,2019-04-24 01:00:00,2019-04-24 00:00:00,LABORABLE
24,4,2019,3,86,126,212,2019-04-24 02:00:00,2019-04-24 00:00:00,LABORABLE
24,4,2019,4,64,79,143,2019-04-24 03:00:00,2019-04-24 00:00:00,LABORABLE
24,4,2019,5,70,103,173,2019-04-24 04:00:00,2019-04-24 00:00:00,LABORABLE
24,4,2019,6,152,154,306,2019-04-24 05:00:00,2019-04-24 00:00:00,LABORABLE
24,4,2019,7,427,390,817,2019-04-24 06:00:00,2019-04-24 00:00:00,LABORABLE
24,4,2019,8,683,661,1344,2019-04-24 07:00:00,2019-04-24 00:00:00,LABORABLE
24,4,2019,9,699,725,1424,2019-04-24 08:00:00,2019-04-24 00:00:00,LABORABLE
24,4,2019,10,608,711,1319,2019-04-24 09:00:00,2019-04-24 00:00:00,LABORABLE
24,4,2019,11,536,640,1176,2019-04-24 10:00:00,2019-04-24 00:00:00,LABORABLE
24,4,2019,12,542,698,1240,2019-04-24 11:00:00,2019-04-24 00:00:00,LABORABLE
24,4,2019,13,569,749,1318,2019-04-24 12:00:00,2019-04-24 00:00:00,LABORABLE
24,4,2019,14,614,728,1342,2019-04-24 13:00:00,2019-04-24 00:00:00,LABORABLE
24,4,2019,15,619,711,1330,2019-04-24 14:00:00,2019-04-24 00:00:00,LABORABLE
24,4,2019,16,659,658,1317,2019-04-24 15:00:00,2019-04-24 00:00:00,LABORABLE
24,4,2019,17,674,695,1369,2019-04-24 16:00:00,2019-04-24 00:00:00,LABORABLE
24,4,2019,18,699,749,1448,2019-04-24 17:00:00,2019-04-24 00:00:00,LABORABLE
24,4,2019,19,625,705,1330,2019-04-24 18:00:00,2019-04-24 00:00:00,LABORABLE
24,4,2019,20,532,691,1223,2019-04-24 19:00:00,2019-04-24 00:00:00,LABORABLE
24,4,2019,21,596,642,1238,2019-04-24 20:00:00,2019-04-24 00:00:00,LABORABLE
24,4,2019,22,476,613,1089,2019-04-24 21:00:00,2019-04-24 00:00:00,LABORABLE
24,4,2019,23,418,473,891,2019-04-24 22:00:00,2019-04-24 00:00:00,LABORABLE
24,4,2019,24,248,310,558,2019-04-24 23:00:00,2019-04-24 00:00:00,LABORABLE
25,4,2019,1,193,261,454,2019-04-25 00:00:00,2019-04-25 00:00:00,LABORABLE
25,4,2019,2,132,199,331,2019-04-25 01:00:00,2019-04-25 00:00:00,LABORABLE
25,4,2019,3,64,141,205,2019-04-25 02:00:00,2019-04-25 00:00:00,LABORABLE
25,4,2019,4,68,106,174,2019-04-25 03:00:00,2019-04-25 00:00:00,LABORABLE
25,4,2019,5,77,110,187,2019-04-25 04:00:00,2019-04-25 00:00:00,LABORABLE
25,4,2019,6,168,170,338,2019-04-25 05:00:00,2019-04-25 00:00:00,LABORABLE
25,4,2019,7,446,398,844,2019-04-25 06:00:00,2019-04-25 00:00:00,LABORABLE
25,4,2019,8,700,651,1351,2019-04-25 07:00:00,2019-04-25 00:00:00,LABORABLE
25,4,2019,9,710,740,1450,2019-04-25 08:00:00,2019-04-25 00:00:00,LABORABLE
25,4,2019,10,629,659,1288,2019-04-25 09:00:00,2019-04-25 00:00:00,LABORABLE
25,4,2019,11,605,681,1286,2019-04-25 10:00:00,2019-04-25 00:00:00,LABORABLE
25,4,2019,12,561,699,1260,2019-04-25 11:00:00,2019-04-25 00:00:00,LABORABLE
25,4,2019,13,596,680,1276,2019-04-25 12:00:00,2019-04-25 00:00:00,LABORABLE
25,4,2019,14,585,681,1266,2019-04-25 13:00:00,2019-04-25 00:00:00,LABORABLE
25,4,2019,15,675,696,1371,2019-04-25 14:00:00,2019-04-25 00:00:00,LABORABLE
25,4,2019,16,653,700,1353,2019-04-25 15:00:00,2019-04-25 00:00:00,LABORABLE
25,4,2019,17,603,793,1396,2019-04-25 16:00:00,2019-04-25 00:00:00,LABORABLE
25,4,2019,18,703,785,1488,2019-04-25 17:00:00,2019-04-25 00:00:00,LABORABLE
25,4,2019,19,675,786,1461,2019-04-25 18:00:00,2019-04-25 00:00:00,LABORABLE
25,4,2019,20,665,821,1486,2019-04-25 19:00:00,2019-04-25 00:00:00,LABORABLE
25,4,2019,21,675,755,1430,2019-04-25 20:00:00,2019-04-25 00:00:00,LABORABLE
25,4,2019,22,577,652,1229,2019-04-25 21:00:00,2019-04-25 00:00:00,LABORABLE
25,4,2019,23,456,516,972,2019-04-25 22:00:00,2019-04-25 00:00:00,LABORABLE
25,4,2019,24,353,376,729,2019-04-25 23:00:00,2019-04-25 00:00:00,LABORABLE
26,4,2019,1,212,292,504,2019-04-26 00:00:00,2019-04-26 00:00:00,LABORABLE
26,4,2019,2,130,260,390,2019-04-26 01:00:00,2019-04-26 00:00:00,LABORABLE
26,4,2019,3,106,191,297,2019-04-26 02:00:00,2019-04-26 00:00:00,LABORABLE
26,4,2019,4,92,158,250,2019-04-26 03:00:00,2019-04-26 00:00:00,LABORABLE
26,4,2019,5,94,141,235,2019-04-26 04:00:00,2019-04-26 00:00:00,LABORABLE
26,4,2019,6,182,185,367,2019-04-26 05:00:00,2019-04-26 00:00:00,LABORABLE
26,4,2019,7,278,314,592,2019-04-26 06:00:00,2019-04-26 00:00:00,LABORABLE
26,4,2019,8,434,602,1036,2019-04-26 07:00:00,2019-04-26 00:00:00,LABORABLE
26,4,2019,9,681,738,1419,2019-04-26 08:00:00,2019-04-26 00:00:00,LABORABLE
26,4,2019,10,646,745,1391,2019-04-26 09:00:00,2019-04-26 00:00:00,LABORABLE
26,4,2019,11,526,657,1183,2019-04-26 10:00:00,2019-04-26 00:00:00,LABORABLE
26,4,2019,12,573,737,1310,2019-04-26 11:00:00,2019-04-26 00:00:00,LABORABLE
26,4,2019,13,646,675,1321,2019-04-26 12:00:00,2019-04-26 00:00:00,LABORABLE
26,4,2019,14,668,821,1489,2019-04-26 13:00:00,2019-04-26 00:00:00,LABORABLE
26,4,2019,15,597,647,1244,2019-04-26 14:00:00,2019-04-26 00:00:00,LABORABLE
26,4,2019,16,632,675,1307,2019-04-26 15:00:00,2019-04-26 00:00:00,LABORABLE
26,4,2019,17,675,825,1500,2019-04-26 16:00:00,2019-04-26 00:00:00,LABORABLE
26,4,2019,18,727,792,1519,2019-04-26 17:00:00,2019-04-26 00:00:00,LABORABLE
26,4,2019,19,724,757,1481,2019-04-26 18:00:00,2019-04-26 00:00:00,LABORABLE
26,4,2019,20,658,810,1468,2019-04-26 19:00:00,2019-04-26 00:00:00,LABORABLE
26,4,2019,21,748,864,1612,2019-04-26 20:00:00,2019-04-26 00:00:00,LABORABLE
26,4,2019,22,654,812,1466,2019-04-26 21:00:00,2019-04-26 00:00:00,LABORABLE
26,4,2019,23,599,687,1286,2019-04-26 22:00:00,2019-04-26 00:00:00,LABORABLE
26,4,2019,24,436,573,1009,2019-04-26 23:00:00,2019-04-26 00:00:00,LABORABLE
27,4,2019,1,397,265,662,2019-04-27 00:00:00,2019-04-27 00:00:00,LABORABLE
27,4,2019,2,267,180,447,2019-04-27 01:00:00,2019-04-27 00:00:00,LABORABLE
27,4,2019,3,179,155,334,2019-04-27 02:00:00,2019-04-27 00:00:00,LABORABLE
27,4,2019,4,134,104,238,2019-04-27 03:00:00,2019-04-27 00:00:00,LABORABLE
27,4,2019,5,109,91,200,2019-04-27 04:00:00,2019-04-27 00:00:00,LABORABLE
27,4,2019,6,239,152,391,2019-04-27 05:00:00,2019-04-27 00:00:00,LABORABLE
27,4,2019,7,587,371,958,2019-04-27 06:00:00,2019-04-27 00:00:00,LABORABLE
27,4,2019,8,1094,607,1701,2019-04-27 07:00:00,2019-04-27 00:00:00,LABORABLE
27,4,2019,9,1311,740,2051,2019-04-27 08:00:00,2019-04-27 00:00:00,LABORABLE
27,4,2019,10,1390,759,2149,2019-04-27 09:00:00,2019-04-27 00:00:00,LABORABLE
27,4,2019,11,854,751,1605,2019-04-27 10:00:00,2019-04-27 00:00:00,LABORABLE
27,4,2019,12,1278,724,2002,2019-04-27 11:00:00,2019-04-27 00:00:00,LABORABLE
27,4,2019,13,909,502,1411,2019-04-27 12:00:00,2019-04-27 00:00:00,LABORABLE
27,4,2019,14,1354,783,2137,2019-04-27 13:00:00,2019-04-27 00:00:00,LABORABLE
27,4,2019,15,1430,712,2142,2019-04-27 14:00:00,2019-04-27 00:00:00,LABORABLE
27,4,2019,16,1300,706,2006,2019-04-27 15:00:00,2019-04-27 00:00:00,LABORABLE
27,4,2019,17,1363,779,2142,2019-04-27 16:00:00,2019-04-27 00:00:00,LABORABLE
27,4,2019,18,1447,769,2216,2019-04-27 17:00:00,2019-04-27 00:00:00,LABORABLE
27,4,2019,19,1508,812,2320,2019-04-27 18:00:00,2019-04-27 00:00:00,LABORABLE
27,4,2019,20,1519,817,2336,2019-04-27 19:00:00,2019-04-27 00:00:00,LABORABLE
27,4,2019,21,1403,804,2207,2019-04-27 20:00:00,2019-04-27 00:00:00,LABORABLE
27,4,2019,22,1336,733,2069,2019-04-27 21:00:00,2019-04-27 00:00:00,LABORABLE
27,4,2019,23,991,503,1494,2019-04-27 22:00:00,2019-04-27 00:00:00,LABORABLE
27,4,2019,24,748,414,1162,2019-04-27 23:00:00,2019-04-27 00:00:00,LABORABLE
28,4,2019,1,439,308,747,2019-04-28 00:00:00,2019-04-28 00:00:00,LABORABLE
28,4,2019,2,311,200,511,2019-04-28 01:00:00,2019-04-28 00:00:00,LABORABLE
28,4,2019,3,215,158,373,2019-04-28 02:00:00,2019-04-28 00:00:00,LABORABLE
28,4,2019,4,165,90,255,2019-04-28 03:00:00,2019-04-28 00:00:00,LABORABLE
28,4,2019,5,168,99,267,2019-04-28 04:00:00,2019-04-28 00:00:00,LABORABLE
28,4,2019,6,244,151,395,2019-04-28 05:00:00,2019-04-28 00:00:00,LABORABLE
28,4,2019,7,553,398,951,2019-04-28 06:00:00,2019-04-28 00:00:00,LABORABLE
28,4,2019,8,1097,603,1700,2019-04-28 07:00:00,2019-04-28 00:00:00,LABORABLE
28,4,2019,9,1340,784,2124,2019-04-28 08:00:00,2019-04-28 00:00:00,LABORABLE
28,4,2019,10,1269,719,1988,2019-04-28 09:00:00,2019-04-28 00:00:00,LABORABLE
28,4,2019,11,1274,734,2008,2019-04-28 10:00:00,2019-04-28 00:00:00,LABORABLE
28,4,2019,12,675,840,1515,2019-04-28 11:00:00,2019-04-28 00:00:00,LABORABLE
28,4,2019,13,1441,788,2229,2019-04-28 12:00:00,2019-04-28 00:00:00,LABORABLE
28,4,2019,14,1409,844,2253,2019-04-28 13:00:00,2019-04-28 00:00:00,LABORABLE
28,4,2019,15,1408,882,2290,2019-04-28 14:00:00,2019-04-28 00:00:00,LABORABLE
28,4,2019,16,1354,845,2199,2019-04-28 15:00:00,2019-04-28 00:00:00,LABORABLE
28,4,2019,17,1514,769,2283,2019-04-28 16:00:00,2019-04-28 00:00:00,LABORABLE
28,4,2019,18,1424,823,2247,2019-04-28 17:00:00,2019-04-28 00:00:00,LABORABLE
28,4,2019,19,1376,828,2204,2019-04-28 18:00:00,2019-04-28 00:00:00,LABORABLE
28,4,2019,20,1511,851,2362,2019-04-28 19:00:00,2019-04-28 00:00:00,LABORABLE
28,4,2019,21,1410,894,2304,2019-04-28 20:00:00,2019-04-28 00:00:00,LABORABLE
28,4,2019,22,1365,775,2140,2019-04-28 21:00:00,2019-04-28 00:00:00,LABORABLE
28,4,2019,23,1122,618,1740,2019-04-28 22:00:00,2019-04-28 00:00:00,LABORABLE
28,4,2019,24,867,505,1372,2019-04-28 23:00:00,2019-04-28 00:00:00,LABORABLE
29,4,2019,1,236,326,562,2019-04-29 00:00:00,2019-04-29 00:00:00,LABORABLE
29,4,2019,2,151,219,370,2019-04-29 01:00:00,2019-04-29 00:00:00,LABORABLE
29,4,2019,3,109,168,277,2019-04-29 02:00:00,2019-04-29 00:00:00,LABORABLE
29,4,2019,4,97,154,251,2019-04-29 03:00:00,2019-04-29 00:00:00,LABORABLE
29,4,2019,5,81,119,200,2019-04-29 04:00:00,2019-04-29 00:00:00,LABORABLE
29,4,2019,6,162,158,320,2019-04-29 05:00:00,2019-04-29 00:00:00,LABORABLE
29,4,2019,7,444,408,852,2019-04-29 06:00:00,2019-04-29 00:00:00,LABORABLE
29,4,2019,8,670,687,1357,2019-04-29 07:00:00,2019-04-29 00:00:00,LABORABLE
29,4,2019,9,695,690,1385,2019-04-29 08:00:00,2019-04-29 00:00:00,LABORABLE
29,4,2019,10,658,689,1347,2019-04-29 09:00:00,2019-04-29 00:00:00,LABORABLE
29,4,2019,11,614,684,1298,2019-04-29 10:00:00,2019-04-29 00:00:00,LABORABLE
29,4,2019,12,588,702,1290,2019-04-29 11:00:00,2019-04-29 00:00:00,LABORABLE
29,4,2019,13,653,742,1395,2019-04-29 12:00:00,2019-04-29 00:00:00,LABORABLE
29,4,2019,14,593,733,1326,2019-04-29 13:00:00,2019-04-29 00:00:00,LABORABLE
29,4,2019,15,614,760,1374,2019-04-29 14:00:00,2019-04-29 00:00:00,LABORABLE
29,4,2019,16,641,684,1325,2019-04-29 15:00:00,2019-04-29 00:00:00,LABORABLE
29,4,2019,17,675,758,1433,2019-04-29 16:00:00,2019-04-29 00:00:00,LABORABLE
29,4,2019,18,669,781,1450,2019-04-29 17:00:00,2019-04-29 00:00:00,LABORABLE
29,4,2019,19,656,777,1433,2019-04-29 18:00:00,2019-04-29 00:00:00,LABORABLE
29,4,2019,20,660,801,1461,2019-04-29 19:00:00,2019-04-29 00:00:00,LABORABLE
29,4,2019,21,599,704,1303,2019-04-29 20:00:00,2019-04-29 00:00:00,LABORABLE
29,4,2019,22,553,666,1219,2019-04-29 21:00:00,2019-04-29 00:00:00,LABORABLE
29,4,2019,23,420,506,926,2019-04-29 22:00:00,2019-04-29 00:00:00,LABORABLE
29,4,2019,24,274,357,631,2019-04-29 23:00:00,2019-04-29 00:00:00,LABORABLE
30,4,2019,1,141,260,401,2019-04-30 00:00:00,2019-04-30 00:00:00,LABORABLE
30,4,2019,2,101,203,304,2019-04-30 01:00:00,2019-04-30 00:00:00,LABORABLE
30,4,2019,3,85,147,232,2019-04-30 02:00:00,2019-04-30 00:00:00,LABORABLE
30,4,2019,4,80,112,192,2019-04-30 03:00:00,2019-04-30 00:00:00,LABORABLE
30,4,2019,5,77,100,177,2019-04-30 04:00:00,2019-04-30 00:00:00,LABORABLE
30,4,2019,6,169,136,305,2019-04-30 05:00:00,2019-04-30 00:00:00,LABORABLE
30,4,2019,7,419,411,830,2019-04-30 06:00:00,2019-04-30 00:00:00,LABORABLE
30,4,2019,8,672,619,1291,2019-04-30 07:00:00,2019-04-30 00:00:00,LABORABLE
30,4,2019,9,670,697,1367,2019-04-30 08:00:00,2019-04-30 00:00:00,LABORABLE
30,4,2019,10,678,746,1424,2019-04-30 09:00:00,2019-04-30 00:00:00,LABORABLE
30,4,2019,11,607,764,1371,2019-04-30 10:00:00,2019-04-30 00:00:00,LABORABLE
30,4,2019,12,649,750,1399,2019-04-30 11:00:00,2019-04-30 00:00:00,LABORABLE
30,4,2019,13,671,748,1419,2019-04-30 12:00:00,2019-04-30 00:00:00,LABORABLE
30,4,2019,14,672,816,1488,2019-04-30 13:00:00,2019-04-30 00:00:00,LABORABLE
30,4,2019,15,708,729,1437,2019-04-30 14:00:00,2019-04-30 00:00:00,LABORABLE
30,4,2019,16,678,733,1411,2019-04-30 15:00:00,2019-04-30 00:00:00,LABORABLE
30,4,2019,17,510,533,1043,2019-04-30 16:00:00,2019-04-30 00:00:00,LABORABLE
30,4,2019,18,703,814,1517,2019-04-30 17:00:00,2019-04-30 00:00:00,LABORABLE
30,4,2019,19,706,813,1519,2019-04-30 18:00:00,2019-04-30 00:00:00,LABORABLE
30,4,2019,20,699,847,1546,2019-04-30 19:00:00,2019-04-30 00:00:00,LABORABLE
30,4,2019,21,717,849,1566,2019-04-30 20:00:00,2019-04-30 00:00:00,LABORABLE
30,4,2019,22,627,700,1327,2019-04-30 21:00:00,2019-04-30 00:00:00,LABORABLE
30,4,2019,23,459,618,1077,2019-04-30 22:00:00,2019-04-30 00:00:00,LABORABLE
30,4,2019,24,362,453,815,2019-04-30 23:00:00,2019-04-30 00:00:00,LABORABLE
1,5,2019,1,524,401,925,2019-05-01 00:00:00,2019-01-05 00:00:00,FESTIVO
1,5,2019,2,412,308,720,2019-05-01 01:00:00,2019-01-05 00:00:00,FESTIVO
1,5,2019,3,303,241,544,2019-05-01 02:00:00,2019-01-05 00:00:00,FESTIVO
1,5,2019,4,281,182,463,2019-05-01 03:00:00,2019-01-05 00:00:00,FESTIVO
1,5,2019,5,172,129,301,2019-05-01 04:00:00,2019-01-05 00:00:00,FESTIVO
1,5,2019,6,194,137,331,2019-05-01 05:00:00,2019-01-05 00:00:00,FESTIVO
1,5,2019,7,329,193,522,2019-05-01 06:00:00,2019-01-05 00:00:00,FESTIVO
1,5,2019,8,311,175,486,2019-05-01 07:00:00,2019-01-05 00:00:00,FESTIVO
1,5,2019,9,360,290,650,2019-05-01 08:00:00,2019-01-05 00:00:00,FESTIVO
1,5,2019,10,464,343,807,2019-05-01 09:00:00,2019-01-05 00:00:00,FESTIVO
1,5,2019,11,615,421,1036,2019-05-01 10:00:00,2019-01-05 00:00:00,FESTIVO
1,5,2019,12,725,479,1204,2019-05-01 11:00:00,2019-01-05 00:00:00,FESTIVO
1,5,2019,13,850,507,1357,2019-05-01 12:00:00,2019-01-05 00:00:00,FESTIVO
1,5,2019,14,974,655,1629,2019-05-01 13:00:00,2019-01-05 00:00:00,FESTIVO
1,5,2019,15,924,580,1504,2019-05-01 14:00:00,2019-01-05 00:00:00,FESTIVO
1,5,2019,16,695,490,1185,2019-05-01 15:00:00,2019-01-05 00:00:00,FESTIVO
1,5,2019,17,755,561,1316,2019-05-01 16:00:00,2019-01-05 00:00:00,FESTIVO
1,5,2019,18,886,581,1467,2019-05-01 17:00:00,2019-01-05 00:00:00,FESTIVO
1,5,2019,19,919,606,1525,2019-05-01 18:00:00,2019-01-05 00:00:00,FESTIVO
1,5,2019,20,965,658,1623,2019-05-01 19:00:00,2019-01-05 00:00:00,FESTIVO
1,5,2019,21,940,612,1552,2019-05-01 20:00:00,2019-01-05 00:00:00,FESTIVO
1,5,2019,22,1082,613,1695,2019-05-01 21:00:00,2019-01-05 00:00:00,FESTIVO
1,5,2019,23,879,530,1409,2019-05-01 22:00:00,2019-01-05 00:00:00,FESTIVO
1,5,2019,24,678,464,1142,2019-05-01 23:00:00,2019-01-05 00:00:00,FESTIVO
2,5,2019,1,260,399,659,2019-05-02 00:00:00,2019-02-05 00:00:00,FESTIVO
2,5,2019,2,228,307,535,2019-05-02 01:00:00,2019-02-05 00:00:00,FESTIVO
2,5,2019,3,148,249,397,2019-05-02 02:00:00,2019-02-05 00:00:00,FESTIVO
2,5,2019,4,101,196,297,2019-05-02 03:00:00,2019-02-05 00:00:00,FESTIVO
2,5,2019,5,80,152,232,2019-05-02 04:00:00,2019-02-05 00:00:00,FESTIVO
2,5,2019,6,119,174,293,2019-05-02 05:00:00,2019-02-05 00:00:00,FESTIVO
2,5,2019,7,211,251,462,2019-05-02 06:00:00,2019-02-05 00:00:00,FESTIVO
2,5,2019,8,266,276,542,2019-05-02 07:00:00,2019-02-05 00:00:00,FESTIVO
2,5,2019,9,272,305,577,2019-05-02 08:00:00,2019-02-05 00:00:00,FESTIVO
2,5,2019,10,349,406,755,2019-05-02 09:00:00,2019-02-05 00:00:00,FESTIVO
2,5,2019,11,436,488,924,2019-05-02 10:00:00,2019-02-05 00:00:00,FESTIVO
2,5,2019,12,565,536,1101,2019-05-02 11:00:00,2019-02-05 00:00:00,FESTIVO
2,5,2019,13,502,603,1105,2019-05-02 12:00:00,2019-02-05 00:00:00,FESTIVO
2,5,2019,14,494,650,1144,2019-05-02 13:00:00,2019-02-05 00:00:00,FESTIVO
2,5,2019,15,425,600,1025,2019-05-02 14:00:00,2019-02-05 00:00:00,FESTIVO
2,5,2019,16,417,566,983,2019-05-02 15:00:00,2019-02-05 00:00:00,FESTIVO
2,5,2019,17,432,577,1009,2019-05-02 16:00:00,2019-02-05 00:00:00,FESTIVO
2,5,2019,18,465,647,1112,2019-05-02 17:00:00,2019-02-05 00:00:00,FESTIVO
2,5,2019,19,482,637,1119,2019-05-02 18:00:00,2019-02-05 00:00:00,FESTIVO
2,5,2019,20,459,663,1122,2019-05-02 19:00:00,2019-02-05 00:00:00,FESTIVO
2,5,2019,21,469,588,1057,2019-05-02 20:00:00,2019-02-05 00:00:00,FESTIVO
2,5,2019,22,519,643,1162,2019-05-02 21:00:00,2019-02-05 00:00:00,FESTIVO
2,5,2019,23,458,556,1014,2019-05-02 22:00:00,2019-02-05 00:00:00,FESTIVO
2,5,2019,24,343,429,772,2019-05-02 23:00:00,2019-02-05 00:00:00,FESTIVO
3,5,2019,1,228,377,605,2019-05-03 00:00:00,2019-03-05 00:00:00,LABORABLE
3,5,2019,2,141,249,390,2019-05-03 01:00:00,2019-03-05 00:00:00,LABORABLE
3,5,2019,3,110,227,337,2019-05-03 02:00:00,2019-03-05 00:00:00,LABORABLE
3,5,2019,4,93,170,263,2019-05-03 03:00:00,2019-03-05 00:00:00,LABORABLE
3,5,2019,5,90,114,204,2019-05-03 04:00:00,2019-03-05 00:00:00,LABORABLE
3,5,2019,6,159,192,351,2019-05-03 05:00:00,2019-03-05 00:00:00,LABORABLE
3,5,2019,7,321,318,639,2019-05-03 06:00:00,2019-03-05 00:00:00,LABORABLE
3,5,2019,8,476,483,959,2019-05-03 07:00:00,2019-03-05 00:00:00,LABORABLE
3,5,2019,9,480,489,969,2019-05-03 08:00:00,2019-03-05 00:00:00,LABORABLE
3,5,2019,10,547,633,1180,2019-05-03 09:00:00,2019-03-05 00:00:00,LABORABLE
3,5,2019,11,516,685,1201,2019-05-03 10:00:00,2019-03-05 00:00:00,LABORABLE
3,5,2019,12,573,734,1307,2019-05-03 11:00:00,2019-03-05 00:00:00,LABORABLE
3,5,2019,13,615,786,1401,2019-05-03 12:00:00,2019-03-05 00:00:00,LABORABLE
3,5,2019,14,622,781,1403,2019-05-03 13:00:00,2019-03-05 00:00:00,LABORABLE
3,5,2019,15,604,756,1360,2019-05-03 14:00:00,2019-03-05 00:00:00,LABORABLE
3,5,2019,16,554,688,1242,2019-05-03 15:00:00,2019-03-05 00:00:00,LABORABLE
3,5,2019,17,576,692,1268,2019-05-03 16:00:00,2019-03-05 00:00:00,LABORABLE
3,5,2019,18,616,778,1394,2019-05-03 17:00:00,2019-03-05 00:00:00,LABORABLE
3,5,2019,19,596,734,1330,2019-05-03 18:00:00,2019-03-05 00:00:00,LABORABLE
3,5,2019,20,563,791,1354,2019-05-03 19:00:00,2019-03-05 00:00:00,LABORABLE
3,5,2019,21,583,789,1372,2019-05-03 20:00:00,2019-03-05 00:00:00,LABORABLE
3,5,2019,22,581,753,1334,2019-05-03 21:00:00,2019-03-05 00:00:00,LABORABLE
3,5,2019,23,476,612,1088,2019-05-03 22:00:00,2019-03-05 00:00:00,LABORABLE
3,5,2019,24,388,543,931,2019-05-03 23:00:00,2019-03-05 00:00:00,LABORABLE
4,5,2019,1,267,436,703,2019-05-04 00:00:00,2019-04-05 00:00:00,LABORABLE
4,5,2019,2,250,368,618,2019-05-04 01:00:00,2019-04-05 00:00:00,LABORABLE
4,5,2019,3,168,269,437,2019-05-04 02:00:00,2019-04-05 00:00:00,LABORABLE
4,5,2019,4,147,222,369,2019-05-04 03:00:00,2019-04-05 00:00:00,LABORABLE
4,5,2019,5,112,202,314,2019-05-04 04:00:00,2019-04-05 00:00:00,LABORABLE
4,5,2019,6,141,248,389,2019-05-04 05:00:00,2019-04-05 00:00:00,LABORABLE
4,5,2019,7,200,264,464,2019-05-04 06:00:00,2019-04-05 00:00:00,LABORABLE
4,5,2019,8,257,260,517,2019-05-04 07:00:00,2019-04-05 00:00:00,LABORABLE
4,5,2019,9,291,387,678,2019-05-04 08:00:00,2019-04-05 00:00:00,LABORABLE
4,5,2019,10,412,477,889,2019-05-04 09:00:00,2019-04-05 00:00:00,LABORABLE
4,5,2019,11,519,617,1136,2019-05-04 10:00:00,2019-04-05 00:00:00,LABORABLE
4,5,2019,12,557,681,1238,2019-05-04 11:00:00,2019-04-05 00:00:00,LABORABLE
4,5,2019,13,603,672,1275,2019-05-04 12:00:00,2019-04-05 00:00:00,LABORABLE
4,5,2019,14,618,782,1400,2019-05-04 13:00:00,2019-04-05 00:00:00,LABORABLE
4,5,2019,15,570,765,1335,2019-05-04 14:00:00,2019-04-05 00:00:00,LABORABLE
4,5,2019,16,486,616,1102,2019-05-04 15:00:00,2019-04-05 00:00:00,LABORABLE
4,5,2019,17,451,644,1095,2019-05-04 16:00:00,2019-04-05 00:00:00,LABORABLE
4,5,2019,18,497,688,1185,2019-05-04 17:00:00,2019-04-05 00:00:00,LABORABLE
4,5,2019,19,577,730,1307,2019-05-04 18:00:00,2019-04-05 00:00:00,LABORABLE
4,5,2019,20,548,742,1290,2019-05-04 19:00:00,2019-04-05 00:00:00,LABORABLE
4,5,2019,21,495,734,1229,2019-05-04 20:00:00,2019-04-05 00:00:00,LABORABLE
4,5,2019,22,548,719,1267,2019-05-04 21:00:00,2019-04-05 00:00:00,LABORABLE
4,5,2019,23,539,754,1293,2019-05-04 22:00:00,2019-04-05 00:00:00,LABORABLE
4,5,2019,24,434,590,1024,2019-05-04 23:00:00,2019-04-05 00:00:00,LABORABLE
5,5,2019,1,396,475,871,2019-05-05 00:00:00,2019-05-05 00:00:00,LABORABLE
5,5,2019,2,278,457,735,2019-05-05 01:00:00,2019-05-05 00:00:00,LABORABLE
5,5,2019,3,243,339,582,2019-05-05 02:00:00,2019-05-05 00:00:00,LABORABLE
5,5,2019,4,170,321,491,2019-05-05 03:00:00,2019-05-05 00:00:00,LABORABLE
5,5,2019,5,158,266,424,2019-05-05 04:00:00,2019-05-05 00:00:00,LABORABLE
5,5,2019,6,126,230,356,2019-05-05 05:00:00,2019-05-05 00:00:00,LABORABLE
5,5,2019,7,194,302,496,2019-05-05 06:00:00,2019-05-05 00:00:00,LABORABLE
5,5,2019,8,153,250,403,2019-05-05 07:00:00,2019-05-05 00:00:00,LABORABLE
5,5,2019,9,232,292,524,2019-05-05 08:00:00,2019-05-05 00:00:00,LABORABLE
5,5,2019,10,313,389,702,2019-05-05 09:00:00,2019-05-05 00:00:00,LABORABLE
5,5,2019,11,397,491,888,2019-05-05 10:00:00,2019-05-05 00:00:00,LABORABLE
5,5,2019,12,489,575,1064,2019-05-05 11:00:00,2019-05-05 00:00:00,LABORABLE
5,5,2019,13,576,671,1247,2019-05-05 12:00:00,2019-05-05 00:00:00,LABORABLE
5,5,2019,14,655,744,1399,2019-05-05 13:00:00,2019-05-05 00:00:00,LABORABLE
5,5,2019,15,616,796,1412,2019-05-05 14:00:00,2019-05-05 00:00:00,LABORABLE
5,5,2019,16,490,677,1167,2019-05-05 15:00:00,2019-05-05 00:00:00,LABORABLE
5,5,2019,17,516,672,1188,2019-05-05 16:00:00,2019-05-05 00:00:00,LABORABLE
5,5,2019,18,587,741,1328,2019-05-05 17:00:00,2019-05-05 00:00:00,LABORABLE
5,5,2019,19,645,764,1409,2019-05-05 18:00:00,2019-05-05 00:00:00,LABORABLE
5,5,2019,20,610,762,1372,2019-05-05 19:00:00,2019-05-05 00:00:00,LABORABLE
5,5,2019,21,586,766,1352,2019-05-05 20:00:00,2019-05-05 00:00:00,LABORABLE
5,5,2019,22,584,643,1227,2019-05-05 21:00:00,2019-05-05 00:00:00,LABORABLE
5,5,2019,23,527,577,1104,2019-05-05 22:00:00,2019-05-05 00:00:00,LABORABLE
5,5,2019,24,337,418,755,2019-05-05 23:00:00,2019-05-05 00:00:00,LABORABLE
6,5,2019,1,259,351,610,2019-05-06 00:00:00,2019-06-05 00:00:00,LABORABLE
6,5,2019,2,162,251,413,2019-05-06 01:00:00,2019-06-05 00:00:00,LABORABLE
6,5,2019,3,100,220,320,2019-05-06 02:00:00,2019-06-05 00:00:00,LABORABLE
6,5,2019,4,84,151,235,2019-05-06 03:00:00,2019-06-05 00:00:00,LABORABLE
6,5,2019,5,68,129,197,2019-05-06 04:00:00,2019-06-05 00:00:00,LABORABLE
6,5,2019,6,160,164,324,2019-05-06 05:00:00,2019-06-05 00:00:00,LABORABLE
6,5,2019,7,287,421,708,2019-05-06 06:00:00,2019-06-05 00:00:00,LABORABLE
6,5,2019,8,664,656,1320,2019-05-06 07:00:00,2019-06-05 00:00:00,LABORABLE
6,5,2019,9,691,668,1359,2019-05-06 08:00:00,2019-06-05 00:00:00,LABORABLE
6,5,2019,10,656,742,1398,2019-05-06 09:00:00,2019-06-05 00:00:00,LABORABLE
6,5,2019,11,587,694,1281,2019-05-06 10:00:00,2019-06-05 00:00:00,LABORABLE
6,5,2019,12,613,711,1324,2019-05-06 11:00:00,2019-06-05 00:00:00,LABORABLE
6,5,2019,13,644,765,1409,2019-05-06 12:00:00,2019-06-05 00:00:00,LABORABLE
6,5,2019,14,625,768,1393,2019-05-06 13:00:00,2019-06-05 00:00:00,LABORABLE
6,5,2019,15,635,751,1386,2019-05-06 14:00:00,2019-06-05 00:00:00,LABORABLE
6,5,2019,16,635,710,1345,2019-05-06 15:00:00,2019-06-05 00:00:00,LABORABLE
6,5,2019,17,648,750,1398,2019-05-06 16:00:00,2019-06-05 00:00:00,LABORABLE
6,5,2019,18,671,760,1431,2019-05-06 17:00:00,2019-06-05 00:00:00,LABORABLE
6,5,2019,19,681,806,1487,2019-05-06 18:00:00,2019-06-05 00:00:00,LABORABLE
6,5,2019,20,640,795,1435,2019-05-06 19:00:00,2019-06-05 00:00:00,LABORABLE
6,5,2019,21,633,750,1383,2019-05-06 20:00:00,2019-06-05 00:00:00,LABORABLE
6,5,2019,22,524,634,1158,2019-05-06 21:00:00,2019-06-05 00:00:00,LABORABLE
6,5,2019,23,402,515,917,2019-05-06 22:00:00,2019-06-05 00:00:00,LABORABLE
6,5,2019,24,265,388,653,2019-05-06 23:00:00,2019-06-05 00:00:00,LABORABLE
7,5,2019,1,167,254,421,2019-05-07 00:00:00,2019-07-05 00:00:00,LABORABLE
7,5,2019,2,109,216,325,2019-05-07 01:00:00,2019-07-05 00:00:00,LABORABLE
7,5,2019,3,88,156,244,2019-05-07 02:00:00,2019-07-05 00:00:00,LABORABLE
7,5,2019,4,71,107,178,2019-05-07 03:00:00,2019-07-05 00:00:00,LABORABLE
7,5,2019,5,80,90,170,2019-05-07 04:00:00,2019-07-05 00:00:00,LABORABLE
7,5,2019,6,150,174,324,2019-05-07 05:00:00,2019-07-05 00:00:00,LABORABLE
7,5,2019,7,418,430,848,2019-05-07 06:00:00,2019-07-05 00:00:00,LABORABLE
7,5,2019,8,718,686,1404,2019-05-07 07:00:00,2019-07-05 00:00:00,LABORABLE
7,5,2019,9,719,765,1484,2019-05-07 08:00:00,2019-07-05 00:00:00,LABORABLE
7,5,2019,10,629,793,1422,2019-05-07 09:00:00,2019-07-05 00:00:00,LABORABLE
7,5,2019,11,606,676,1282,2019-05-07 10:00:00,2019-07-05 00:00:00,LABORABLE
7,5,2019,12,623,695,1318,2019-05-07 11:00:00,2019-07-05 00:00:00,LABORABLE
7,5,2019,13,650,783,1433,2019-05-07 12:00:00,2019-07-05 00:00:00,LABORABLE
7,5,2019,14,589,782,1371,2019-05-07 13:00:00,2019-07-05 00:00:00,LABORABLE
7,5,2019,15,604,727,1331,2019-05-07 14:00:00,2019-07-05 00:00:00,LABORABLE
7,5,2019,16,659,762,1421,2019-05-07 15:00:00,2019-07-05 00:00:00,LABORABLE
7,5,2019,17,661,752,1413,2019-05-07 16:00:00,2019-07-05 00:00:00,LABORABLE
7,5,2019,18,680,767,1447,2019-05-07 17:00:00,2019-07-05 00:00:00,LABORABLE
7,5,2019,19,676,868,1544,2019-05-07 18:00:00,2019-07-05 00:00:00,LABORABLE
7,5,2019,20,646,817,1463,2019-05-07 19:00:00,2019-07-05 00:00:00,LABORABLE
7,5,2019,21,621,739,1360,2019-05-07 20:00:00,2019-07-05 00:00:00,LABORABLE
7,5,2019,22,481,691,1172,2019-05-07 21:00:00,2019-07-05 00:00:00,LABORABLE
7,5,2019,23,386,433,819,2019-05-07 22:00:00,2019-07-05 00:00:00,LABORABLE
7,5,2019,24,290,391,681,2019-05-07 23:00:00,2019-07-05 00:00:00,LABORABLE
8,5,2019,1,201,299,500,2019-05-08 00:00:00,2019-08-05 00:00:00,LABORABLE
8,5,2019,2,104,208,312,2019-05-08 01:00:00,2019-08-05 00:00:00,LABORABLE
8,5,2019,3,81,152,233,2019-05-08 02:00:00,2019-08-05 00:00:00,LABORABLE
8,5,2019,4,87,105,192,2019-05-08 03:00:00,2019-08-05 00:00:00,LABORABLE
8,5,2019,5,82,118,200,2019-05-08 04:00:00,2019-08-05 00:00:00,LABORABLE
8,5,2019,6,153,181,334,2019-05-08 05:00:00,2019-08-05 00:00:00,LABORABLE
8,5,2019,7,459,418,877,2019-05-08 06:00:00,2019-08-05 00:00:00,LABORABLE
8,5,2019,8,694,663,1357,2019-05-08 07:00:00,2019-08-05 00:00:00,LABORABLE
8,5,2019,9,757,756,1513,2019-05-08 08:00:00,2019-08-05 00:00:00,LABORABLE
8,5,2019,10,664,724,1388,2019-05-08 09:00:00,2019-08-05 00:00:00,LABORABLE
8,5,2019,11,461,613,1074,2019-05-08 10:00:00,2019-08-05 00:00:00,LABORABLE
8,5,2019,12,611,758,1369,2019-05-08 11:00:00,2019-08-05 00:00:00,LABORABLE
8,5,2019,13,598,781,1379,2019-05-08 12:00:00,2019-08-05 00:00:00,LABORABLE
8,5,2019,14,694,768,1462,2019-05-08 13:00:00,2019-08-05 00:00:00,LABORABLE
8,5,2019,15,622,752,1374,2019-05-08 14:00:00,2019-08-05 00:00:00,LABORABLE
8,5,2019,16,651,693,1344,2019-05-08 15:00:00,2019-08-05 00:00:00,LABORABLE
8,5,2019,17,646,712,1358,2019-05-08 16:00:00,2019-08-05 00:00:00,LABORABLE
8,5,2019,18,683,782,1465,2019-05-08 17:00:00,2019-08-05 00:00:00,LABORABLE
8,5,2019,19,668,775,1443,2019-05-08 18:00:00,2019-08-05 00:00:00,LABORABLE
8,5,2019,20,620,813,1433,2019-05-08 19:00:00,2019-08-05 00:00:00,LABORABLE
8,5,2019,21,613,715,1328,2019-05-08 20:00:00,2019-08-05 00:00:00,LABORABLE
8,5,2019,22,517,619,1136,2019-05-08 21:00:00,2019-08-05 00:00:00,LABORABLE
8,5,2019,23,386,512,898,2019-05-08 22:00:00,2019-08-05 00:00:00,LABORABLE
8,5,2019,24,319,386,705,2019-05-08 23:00:00,2019-08-05 00:00:00,LABORABLE
9,5,2019,1,232,300,532,2019-05-09 00:00:00,2019-09-05 00:00:00,LABORABLE
9,5,2019,2,145,226,371,2019-05-09 01:00:00,2019-09-05 00:00:00,LABORABLE
9,5,2019,3,88,159,247,2019-05-09 02:00:00,2019-09-05 00:00:00,LABORABLE
9,5,2019,4,73,110,183,2019-05-09 03:00:00,2019-09-05 00:00:00,LABORABLE
9,5,2019,5,76,92,168,2019-05-09 04:00:00,2019-09-05 00:00:00,LABORABLE
9,5,2019,6,169,164,333,2019-05-09 05:00:00,2019-09-05 00:00:00,LABORABLE
9,5,2019,7,450,408,858,2019-05-09 06:00:00,2019-09-05 00:00:00,LABORABLE
9,5,2019,8,670,671,1341,2019-05-09 07:00:00,2019-09-05 00:00:00,LABORABLE
9,5,2019,9,731,726,1457,2019-05-09 08:00:00,2019-09-05 00:00:00,LABORABLE
9,5,2019,10,664,710,1374,2019-05-09 09:00:00,2019-09-05 00:00:00,LABORABLE
9,5,2019,11,595,682,1277,2019-05-09 10:00:00,2019-09-05 00:00:00,LABORABLE
9,5,2019,12,612,742,1354,2019-05-09 11:00:00,2019-09-05 00:00:00,LABORABLE
9,5,2019,13,634,703,1337,2019-05-09 12:00:00,2019-09-05 00:00:00,LABORABLE
9,5,2019,14,668,776,1444,2019-05-09 13:00:00,2019-09-05 00:00:00,LABORABLE
9,5,2019,15,655,695,1350,2019-05-09 14:00:00,2019-09-05 00:00:00,LABORABLE
9,5,2019,16,687,733,1420,2019-05-09 15:00:00,2019-09-05 00:00:00,LABORABLE
9,5,2019,17,627,700,1327,2019-05-09 16:00:00,2019-09-05 00:00:00,LABORABLE
9,5,2019,18,701,770,1471,2019-05-09 17:00:00,2019-09-05 00:00:00,LABORABLE
9,5,2019,19,695,755,1450,2019-05-09 18:00:00,2019-09-05 00:00:00,LABORABLE
9,5,2019,20,702,759,1461,2019-05-09 19:00:00,2019-09-05 00:00:00,LABORABLE
9,5,2019,21,701,804,1505,2019-05-09 20:00:00,2019-09-05 00:00:00,LABORABLE
9,5,2019,22,584,696,1280,2019-05-09 21:00:00,2019-09-05 00:00:00,LABORABLE
9,5,2019,23,472,543,1015,2019-05-09 22:00:00,2019-09-05 00:00:00,LABORABLE
9,5,2019,24,349,393,742,2019-05-09 23:00:00,2019-09-05 00:00:00,LABORABLE
10,5,2019,1,224,374,598,2019-05-10 00:00:00,2019-10-05 00:00:00,LABORABLE
10,5,2019,2,159,241,400,2019-05-10 01:00:00,2019-10-05 00:00:00,LABORABLE
10,5,2019,3,88,187,275,2019-05-10 02:00:00,2019-10-05 00:00:00,LABORABLE
10,5,2019,4,83,149,232,2019-05-10 03:00:00,2019-10-05 00:00:00,LABORABLE
10,5,2019,5,93,97,190,2019-05-10 04:00:00,2019-10-05 00:00:00,LABORABLE
10,5,2019,6,178,178,356,2019-05-10 05:00:00,2019-10-05 00:00:00,LABORABLE
10,5,2019,7,260,297,557,2019-05-10 06:00:00,2019-10-05 00:00:00,LABORABLE
10,5,2019,8,402,695,1097,2019-05-10 07:00:00,2019-10-05 00:00:00,LABORABLE
10,5,2019,9,722,708,1430,2019-05-10 08:00:00,2019-10-05 00:00:00,LABORABLE
10,5,2019,10,697,751,1448,2019-05-10 09:00:00,2019-10-05 00:00:00,LABORABLE
10,5,2019,11,600,683,1283,2019-05-10 10:00:00,2019-10-05 00:00:00,LABORABLE
10,5,2019,12,609,719,1328,2019-05-10 11:00:00,2019-10-05 00:00:00,LABORABLE
10,5,2019,13,695,723,1418,2019-05-10 12:00:00,2019-10-05 00:00:00,LABORABLE
10,5,2019,14,502,630,1132,2019-05-10 13:00:00,2019-10-05 00:00:00,LABORABLE
10,5,2019,15,573,705,1278,2019-05-10 14:00:00,2019-10-05 00:00:00,LABORABLE
10,5,2019,16,713,691,1404,2019-05-10 15:00:00,2019-10-05 00:00:00,LABORABLE
10,5,2019,17,657,797,1454,2019-05-10 16:00:00,2019-10-05 00:00:00,LABORABLE
10,5,2019,18,744,744,1488,2019-05-10 17:00:00,2019-10-05 00:00:00,LABORABLE
10,5,2019,19,749,840,1589,2019-05-10 18:00:00,2019-10-05 00:00:00,LABORABLE
10,5,2019,20,696,851,1547,2019-05-10 19:00:00,2019-10-05 00:00:00,LABORABLE
10,5,2019,21,722,818,1540,2019-05-10 20:00:00,2019-10-05 00:00:00,LABORABLE
10,5,2019,22,618,785,1403,2019-05-10 21:00:00,2019-10-05 00:00:00,LABORABLE
10,5,2019,23,613,672,1285,2019-05-10 22:00:00,2019-10-05 00:00:00,LABORABLE
10,5,2019,24,445,540,985,2019-05-10 23:00:00,2019-10-05 00:00:00,LABORABLE
11,5,2019,1,388,489,877,2019-05-11 00:00:00,2019-11-05 00:00:00,LABORABLE
11,5,2019,2,276,380,656,2019-05-11 01:00:00,2019-11-05 00:00:00,LABORABLE
11,5,2019,3,225,355,580,2019-05-11 02:00:00,2019-11-05 00:00:00,LABORABLE
11,5,2019,4,184,275,459,2019-05-11 03:00:00,2019-11-05 00:00:00,LABORABLE
11,5,2019,5,123,221,344,2019-05-11 04:00:00,2019-11-05 00:00:00,LABORABLE
11,5,2019,6,152,211,363,2019-05-11 05:00:00,2019-11-05 00:00:00,LABORABLE
11,5,2019,7,221,266,487,2019-05-11 06:00:00,2019-11-05 00:00:00,LABORABLE
11,5,2019,8,298,327,625,2019-05-11 07:00:00,2019-11-05 00:00:00,LABORABLE
11,5,2019,9,394,422,816,2019-05-11 08:00:00,2019-11-05 00:00:00,LABORABLE
11,5,2019,10,483,491,974,2019-05-11 09:00:00,2019-11-05 00:00:00,LABORABLE
11,5,2019,11,607,661,1268,2019-05-11 10:00:00,2019-11-05 00:00:00,LABORABLE
11,5,2019,12,671,706,1377,2019-05-11 11:00:00,2019-11-05 00:00:00,LABORABLE
11,5,2019,13,657,689,1346,2019-05-11 12:00:00,2019-11-05 00:00:00,LABORABLE
11,5,2019,14,667,812,1479,2019-05-11 13:00:00,2019-11-05 00:00:00,LABORABLE
11,5,2019,15,682,819,1501,2019-05-11 14:00:00,2019-11-05 00:00:00,LABORABLE
11,5,2019,16,512,677,1189,2019-05-11 15:00:00,2019-11-05 00:00:00,LABORABLE
11,5,2019,17,514,705,1219,2019-05-11 16:00:00,2019-11-05 00:00:00,LABORABLE
11,5,2019,18,582,730,1312,2019-05-11 17:00:00,2019-11-05 00:00:00,LABORABLE
11,5,2019,19,620,762,1382,2019-05-11 18:00:00,2019-11-05 00:00:00,LABORABLE
11,5,2019,20,676,798,1474,2019-05-11 19:00:00,2019-11-05 00:00:00,LABORABLE
11,5,2019,21,664,743,1407,2019-05-11 20:00:00,2019-11-05 00:00:00,LABORABLE
11,5,2019,22,682,715,1397,2019-05-11 21:00:00,2019-11-05 00:00:00,LABORABLE
11,5,2019,23,653,680,1333,2019-05-11 22:00:00,2019-11-05 00:00:00,LABORABLE
11,5,2019,24,550,580,1130,2019-05-11 23:00:00,2019-11-05 00:00:00,LABORABLE
12,5,2019,1,488,530,1018,2019-05-12 00:00:00,2019-12-05 00:00:00,LABORABLE
12,5,2019,2,362,488,850,2019-05-12 01:00:00,2019-12-05 00:00:00,LABORABLE
12,5,2019,3,311,419,730,2019-05-12 02:00:00,2019-12-05 00:00:00,LABORABLE
12,5,2019,4,242,328,570,2019-05-12 03:00:00,2019-12-05 00:00:00,LABORABLE
12,5,2019,5,161,267,428,2019-05-12 04:00:00,2019-12-05 00:00:00,LABORABLE
12,5,2019,6,164,207,371,2019-05-12 05:00:00,2019-12-05 00:00:00,LABORABLE
12,5,2019,7,212,313,525,2019-05-12 06:00:00,2019-12-05 00:00:00,LABORABLE
12,5,2019,8,203,251,454,2019-05-12 07:00:00,2019-12-05 00:00:00,LABORABLE
12,5,2019,9,293,302,595,2019-05-12 08:00:00,2019-12-05 00:00:00,LABORABLE
12,5,2019,10,331,425,756,2019-05-12 09:00:00,2019-12-05 00:00:00,LABORABLE
12,5,2019,11,469,507,976,2019-05-12 10:00:00,2019-12-05 00:00:00,LABORABLE
12,5,2019,12,515,579,1094,2019-05-12 11:00:00,2019-12-05 00:00:00,LABORABLE
12,5,2019,13,594,603,1197,2019-05-12 12:00:00,2019-12-05 00:00:00,LABORABLE
12,5,2019,14,640,707,1347,2019-05-12 13:00:00,2019-12-05 00:00:00,LABORABLE
12,5,2019,15,602,744,1346,2019-05-12 14:00:00,2019-12-05 00:00:00,LABORABLE
12,5,2019,16,503,670,1173,2019-05-12 15:00:00,2019-12-05 00:00:00,LABORABLE
12,5,2019,17,487,713,1200,2019-05-12 16:00:00,2019-12-05 00:00:00,LABORABLE
12,5,2019,18,582,749,1331,2019-05-12 17:00:00,2019-12-05 00:00:00,LABORABLE
12,5,2019,19,553,680,1233,2019-05-12 18:00:00,2019-12-05 00:00:00,LABORABLE
12,5,2019,20,519,711,1230,2019-05-12 19:00:00,2019-12-05 00:00:00,LABORABLE
12,5,2019,21,540,676,1216,2019-05-12 20:00:00,2019-12-05 00:00:00,LABORABLE
12,5,2019,22,582,663,1245,2019-05-12 21:00:00,2019-12-05 00:00:00,LABORABLE
12,5,2019,23,595,609,1204,2019-05-12 22:00:00,2019-12-05 00:00:00,LABORABLE
12,5,2019,24,399,481,880,2019-05-12 23:00:00,2019-12-05 00:00:00,LABORABLE
13,5,2019,1,277,366,643,2019-05-13 00:00:00,2019-05-13 00:00:00,LABORABLE
13,5,2019,2,156,298,454,2019-05-13 01:00:00,2019-05-13 00:00:00,LABORABLE
13,5,2019,3,122,223,345,2019-05-13 02:00:00,2019-05-13 00:00:00,LABORABLE
13,5,2019,4,67,114,181,2019-05-13 03:00:00,2019-05-13 00:00:00,LABORABLE
13,5,2019,5,73,108,181,2019-05-13 04:00:00,2019-05-13 00:00:00,LABORABLE
13,5,2019,6,153,183,336,2019-05-13 05:00:00,2019-05-13 00:00:00,LABORABLE
13,5,2019,7,287,404,691,2019-05-13 06:00:00,2019-05-13 00:00:00,LABORABLE
13,5,2019,8,710,680,1390,2019-05-13 07:00:00,2019-05-13 00:00:00,LABORABLE
13,5,2019,9,676,746,1422,2019-05-13 08:00:00,2019-05-13 00:00:00,LABORABLE
13,5,2019,10,648,675,1323,2019-05-13 09:00:00,2019-05-13 00:00:00,LABORABLE
13,5,2019,11,588,694,1282,2019-05-13 10:00:00,2019-05-13 00:00:00,LABORABLE
13,5,2019,12,441,791,1232,2019-05-13 11:00:00,2019-05-13 00:00:00,LABORABLE
13,5,2019,13,607,710,1317,2019-05-13 12:00:00,2019-05-13 00:00:00,LABORABLE
13,5,2019,14,656,731,1387,2019-05-13 13:00:00,2019-05-13 00:00:00,LABORABLE
13,5,2019,15,711,769,1480,2019-05-13 14:00:00,2019-05-13 00:00:00,LABORABLE
13,5,2019,16,682,671,1353,2019-05-13 15:00:00,2019-05-13 00:00:00,LABORABLE
13,5,2019,17,682,703,1385,2019-05-13 16:00:00,2019-05-13 00:00:00,LABORABLE
13,5,2019,18,697,795,1492,2019-05-13 17:00:00,2019-05-13 00:00:00,LABORABLE
13,5,2019,19,646,775,1421,2019-05-13 18:00:00,2019-05-13 00:00:00,LABORABLE
13,5,2019,20,644,768,1412,2019-05-13 19:00:00,2019-05-13 00:00:00,LABORABLE
13,5,2019,21,590,713,1303,2019-05-13 20:00:00,2019-05-13 00:00:00,LABORABLE
13,5,2019,22,514,670,1184,2019-05-13 21:00:00,2019-05-13 00:00:00,LABORABLE
13,5,2019,23,443,466,909,2019-05-13 22:00:00,2019-05-13 00:00:00,LABORABLE
13,5,2019,24,260,357,617,2019-05-13 23:00:00,2019-05-13 00:00:00,LABORABLE
14,5,2019,1,174,249,423,2019-05-14 00:00:00,2019-05-14 00:00:00,LABORABLE
14,5,2019,2,120,193,313,2019-05-14 01:00:00,2019-05-14 00:00:00,LABORABLE
14,5,2019,3,77,137,214,2019-05-14 02:00:00,2019-05-14 00:00:00,LABORABLE
14,5,2019,4,75,94,169,2019-05-14 03:00:00,2019-05-14 00:00:00,LABORABLE
14,5,2019,5,80,78,158,2019-05-14 04:00:00,2019-05-14 00:00:00,LABORABLE
14,5,2019,6,153,183,336,2019-05-14 05:00:00,2019-05-14 00:00:00,LABORABLE
14,5,2019,7,429,392,821,2019-05-14 06:00:00,2019-05-14 00:00:00,LABORABLE
14,5,2019,8,649,666,1315,2019-05-14 07:00:00,2019-05-14 00:00:00,LABORABLE
14,5,2019,9,752,683,1435,2019-05-14 08:00:00,2019-05-14 00:00:00,LABORABLE
14,5,2019,10,671,756,1427,2019-05-14 09:00:00,2019-05-14 00:00:00,LABORABLE
14,5,2019,11,543,680,1223,2019-05-14 10:00:00,2019-05-14 00:00:00,LABORABLE
14,5,2019,12,511,556,1067,2019-05-14 11:00:00,2019-05-14 00:00:00,LABORABLE
14,5,2019,13,651,789,1440,2019-05-14 12:00:00,2019-05-14 00:00:00,LABORABLE
14,5,2019,14,644,746,1390,2019-05-14 13:00:00,2019-05-14 00:00:00,LABORABLE
14,5,2019,15,670,745,1415,2019-05-14 14:00:00,2019-05-14 00:00:00,LABORABLE
14,5,2019,16,648,720,1368,2019-05-14 15:00:00,2019-05-14 00:00:00,LABORABLE
14,5,2019,17,655,798,1453,2019-05-14 16:00:00,2019-05-14 00:00:00,LABORABLE
14,5,2019,18,721,794,1515,2019-05-14 17:00:00,2019-05-14 00:00:00,LABORABLE
14,5,2019,19,715,760,1475,2019-05-14 18:00:00,2019-05-14 00:00:00,LABORABLE
14,5,2019,20,697,759,1456,2019-05-14 19:00:00,2019-05-14 00:00:00,LABORABLE
14,5,2019,21,662,811,1473,2019-05-14 20:00:00,2019-05-14 00:00:00,LABORABLE
14,5,2019,22,664,720,1384,2019-05-14 21:00:00,2019-05-14 00:00:00,LABORABLE
14,5,2019,23,552,585,1137,2019-05-14 22:00:00,2019-05-14 00:00:00,LABORABLE
14,5,2019,24,435,429,864,2019-05-14 23:00:00,2019-05-14 00:00:00,LABORABLE
15,5,2019,1,345,413,758,2019-05-15 00:00:00,2019-05-15 00:00:00,FESTIVO
15,5,2019,2,278,349,627,2019-05-15 01:00:00,2019-05-15 00:00:00,FESTIVO
15,5,2019,3,197,223,420,2019-05-15 02:00:00,2019-05-15 00:00:00,FESTIVO
15,5,2019,4,139,190,329,2019-05-15 03:00:00,2019-05-15 00:00:00,FESTIVO
15,5,2019,5,125,162,287,2019-05-15 04:00:00,2019-05-15 00:00:00,FESTIVO
15,5,2019,6,126,150,276,2019-05-15 05:00:00,2019-05-15 00:00:00,FESTIVO
15,5,2019,7,245,248,493,2019-05-15 06:00:00,2019-05-15 00:00:00,FESTIVO
15,5,2019,8,384,345,729,2019-05-15 07:00:00,2019-05-15 00:00:00,FESTIVO
15,5,2019,9,380,369,749,2019-05-15 08:00:00,2019-05-15 00:00:00,FESTIVO
15,5,2019,10,406,421,827,2019-05-15 09:00:00,2019-05-15 00:00:00,FESTIVO
15,5,2019,11,453,521,974,2019-05-15 10:00:00,2019-05-15 00:00:00,FESTIVO
15,5,2019,12,575,615,1190,2019-05-15 11:00:00,2019-05-15 00:00:00,FESTIVO
15,5,2019,13,584,621,1205,2019-05-15 12:00:00,2019-05-15 00:00:00,FESTIVO
15,5,2019,14,579,611,1190,2019-05-15 13:00:00,2019-05-15 00:00:00,FESTIVO
15,5,2019,15,574,578,1152,2019-05-15 14:00:00,2019-05-15 00:00:00,FESTIVO
15,5,2019,16,463,525,988,2019-05-15 15:00:00,2019-05-15 00:00:00,FESTIVO
15,5,2019,17,479,610,1089,2019-05-15 16:00:00,2019-05-15 00:00:00,FESTIVO
15,5,2019,18,577,632,1209,2019-05-15 17:00:00,2019-05-15 00:00:00,FESTIVO
15,5,2019,19,662,634,1296,2019-05-15 18:00:00,2019-05-15 00:00:00,FESTIVO
15,5,2019,20,694,644,1338,2019-05-15 19:00:00,2019-05-15 00:00:00,FESTIVO
15,5,2019,21,759,680,1439,2019-05-15 20:00:00,2019-05-15 00:00:00,FESTIVO
15,5,2019,22,673,636,1309,2019-05-15 21:00:00,2019-05-15 00:00:00,FESTIVO
15,5,2019,23,613,600,1213,2019-05-15 22:00:00,2019-05-15 00:00:00,FESTIVO
15,5,2019,24,450,475,925,2019-05-15 23:00:00,2019-05-15 00:00:00,FESTIVO
16,5,2019,1,220,367,587,2019-05-16 00:00:00,2019-05-16 00:00:00,LABORABLE
16,5,2019,2,139,280,419,2019-05-16 01:00:00,2019-05-16 00:00:00,LABORABLE
16,5,2019,3,85,155,240,2019-05-16 02:00:00,2019-05-16 00:00:00,LABORABLE
16,5,2019,4,71,118,189,2019-05-16 03:00:00,2019-05-16 00:00:00,LABORABLE
16,5,2019,5,101,106,207,2019-05-16 04:00:00,2019-05-16 00:00:00,LABORABLE
16,5,2019,6,156,188,344,2019-05-16 05:00:00,2019-05-16 00:00:00,LABORABLE
16,5,2019,7,475,406,881,2019-05-16 06:00:00,2019-05-16 00:00:00,LABORABLE
16,5,2019,8,720,658,1378,2019-05-16 07:00:00,2019-05-16 00:00:00,LABORABLE
16,5,2019,9,695,720,1415,2019-05-16 08:00:00,2019-05-16 00:00:00,LABORABLE
16,5,2019,10,646,752,1398,2019-05-16 09:00:00,2019-05-16 00:00:00,LABORABLE
16,5,2019,11,613,738,1351,2019-05-16 10:00:00,2019-05-16 00:00:00,LABORABLE
16,5,2019,12,491,607,1098,2019-05-16 11:00:00,2019-05-16 00:00:00,LABORABLE
16,5,2019,13,641,749,1390,2019-05-16 12:00:00,2019-05-16 00:00:00,LABORABLE
16,5,2019,14,506,687,1193,2019-05-16 13:00:00,2019-05-16 00:00:00,LABORABLE
16,5,2019,15,644,730,1374,2019-05-16 14:00:00,2019-05-16 00:00:00,LABORABLE
16,5,2019,16,627,695,1322,2019-05-16 15:00:00,2019-05-16 00:00:00,LABORABLE
16,5,2019,17,671,787,1458,2019-05-16 16:00:00,2019-05-16 00:00:00,LABORABLE
16,5,2019,18,708,757,1465,2019-05-16 17:00:00,2019-05-16 00:00:00,LABORABLE
16,5,2019,19,669,823,1492,2019-05-16 18:00:00,2019-05-16 00:00:00,LABORABLE
16,5,2019,20,674,823,1497,2019-05-16 19:00:00,2019-05-16 00:00:00,LABORABLE
16,5,2019,21,656,697,1353,2019-05-16 20:00:00,2019-05-16 00:00:00,LABORABLE
16,5,2019,22,625,642,1267,2019-05-16 21:00:00,2019-05-16 00:00:00,LABORABLE
16,5,2019,23,504,540,1044,2019-05-16 22:00:00,2019-05-16 00:00:00,LABORABLE
16,5,2019,24,314,403,717,2019-05-16 23:00:00,2019-05-16 00:00:00,LABORABLE
17,5,2019,1,203,366,569,2019-05-17 00:00:00,2019-05-17 00:00:00,LABORABLE
17,5,2019,2,138,241,379,2019-05-17 01:00:00,2019-05-17 00:00:00,LABORABLE
17,5,2019,3,90,203,293,2019-05-17 02:00:00,2019-05-17 00:00:00,LABORABLE
17,5,2019,4,85,154,239,2019-05-17 03:00:00,2019-05-17 00:00:00,LABORABLE
17,5,2019,5,74,108,182,2019-05-17 04:00:00,2019-05-17 00:00:00,LABORABLE
17,5,2019,6,164,177,341,2019-05-17 05:00:00,2019-05-17 00:00:00,LABORABLE
17,5,2019,7,260,310,570,2019-05-17 06:00:00,2019-05-17 00:00:00,LABORABLE
17,5,2019,8,402,646,1048,2019-05-17 07:00:00,2019-05-17 00:00:00,LABORABLE
17,5,2019,9,704,732,1436,2019-05-17 08:00:00,2019-05-17 00:00:00,LABORABLE
17,5,2019,10,642,700,1342,2019-05-17 09:00:00,2019-05-17 00:00:00,LABORABLE
17,5,2019,11,585,708,1293,2019-05-17 10:00:00,2019-05-17 00:00:00,LABORABLE
17,5,2019,12,613,723,1336,2019-05-17 11:00:00,2019-05-17 00:00:00,LABORABLE
17,5,2019,13,631,687,1318,2019-05-17 12:00:00,2019-05-17 00:00:00,LABORABLE
17,5,2019,14,654,736,1390,2019-05-17 13:00:00,2019-05-17 00:00:00,LABORABLE
17,5,2019,15,672,756,1428,2019-05-17 14:00:00,2019-05-17 00:00:00,LABORABLE
17,5,2019,16,658,705,1363,2019-05-17 15:00:00,2019-05-17 00:00:00,LABORABLE
17,5,2019,17,672,795,1467,2019-05-17 16:00:00,2019-05-17 00:00:00,LABORABLE
17,5,2019,18,675,870,1545,2019-05-17 17:00:00,2019-05-17 00:00:00,LABORABLE
17,5,2019,19,737,837,1574,2019-05-17 18:00:00,2019-05-17 00:00:00,LABORABLE
17,5,2019,20,668,810,1478,2019-05-17 19:00:00,2019-05-17 00:00:00,LABORABLE
17,5,2019,21,667,843,1510,2019-05-17 20:00:00,2019-05-17 00:00:00,LABORABLE
17,5,2019,22,635,738,1373,2019-05-17 21:00:00,2019-05-17 00:00:00,LABORABLE
17,5,2019,23,512,652,1164,2019-05-17 22:00:00,2019-05-17 00:00:00,LABORABLE
17,5,2019,24,420,504,924,2019-05-17 23:00:00,2019-05-17 00:00:00,LABORABLE
18,5,2019,1,298,488,786,2019-05-18 00:00:00,2019-05-18 00:00:00,LABORABLE
18,5,2019,2,277,379,656,2019-05-18 01:00:00,2019-05-18 00:00:00,LABORABLE
18,5,2019,3,185,315,500,2019-05-18 02:00:00,2019-05-18 00:00:00,LABORABLE
18,5,2019,4,141,218,359,2019-05-18 03:00:00,2019-05-18 00:00:00,LABORABLE
18,5,2019,5,122,201,323,2019-05-18 04:00:00,2019-05-18 00:00:00,LABORABLE
18,5,2019,6,148,191,339,2019-05-18 05:00:00,2019-05-18 00:00:00,LABORABLE
18,5,2019,7,199,284,483,2019-05-18 06:00:00,2019-05-18 00:00:00,LABORABLE
18,5,2019,8,288,322,610,2019-05-18 07:00:00,2019-05-18 00:00:00,LABORABLE
18,5,2019,9,410,446,856,2019-05-18 08:00:00,2019-05-18 00:00:00,LABORABLE
18,5,2019,10,497,538,1035,2019-05-18 09:00:00,2019-05-18 00:00:00,LABORABLE
18,5,2019,11,622,674,1296,2019-05-18 10:00:00,2019-05-18 00:00:00,LABORABLE
18,5,2019,12,712,670,1382,2019-05-18 11:00:00,2019-05-18 00:00:00,LABORABLE
18,5,2019,13,674,726,1400,2019-05-18 12:00:00,2019-05-18 00:00:00,LABORABLE
18,5,2019,14,710,767,1477,2019-05-18 13:00:00,2019-05-18 00:00:00,LABORABLE
18,5,2019,15,744,830,1574,2019-05-18 14:00:00,2019-05-18 00:00:00,LABORABLE
18,5,2019,16,469,631,1100,2019-05-18 15:00:00,2019-05-18 00:00:00,LABORABLE
18,5,2019,17,513,711,1224,2019-05-18 16:00:00,2019-05-18 00:00:00,LABORABLE
18,5,2019,18,534,733,1267,2019-05-18 17:00:00,2019-05-18 00:00:00,LABORABLE
18,5,2019,19,643,733,1376,2019-05-18 18:00:00,2019-05-18 00:00:00,LABORABLE
18,5,2019,20,625,740,1365,2019-05-18 19:00:00,2019-05-18 00:00:00,LABORABLE
18,5,2019,21,600,749,1349,2019-05-18 20:00:00,2019-05-18 00:00:00,LABORABLE
18,5,2019,22,707,680,1387,2019-05-18 21:00:00,2019-05-18 00:00:00,LABORABLE
18,5,2019,23,580,629,1209,2019-05-18 22:00:00,2019-05-18 00:00:00,LABORABLE
18,5,2019,24,426,558,984,2019-05-18 23:00:00,2019-05-18 00:00:00,LABORABLE
19,5,2019,1,402,448,850,2019-05-19 00:00:00,2019-05-19 00:00:00,LABORABLE
19,5,2019,2,347,470,817,2019-05-19 01:00:00,2019-05-19 00:00:00,LABORABLE
19,5,2019,3,255,401,656,2019-05-19 02:00:00,2019-05-19 00:00:00,LABORABLE
19,5,2019,4,207,303,510,2019-05-19 03:00:00,2019-05-19 00:00:00,LABORABLE
19,5,2019,5,157,241,398,2019-05-19 04:00:00,2019-05-19 00:00:00,LABORABLE
19,5,2019,6,136,271,407,2019-05-19 05:00:00,2019-05-19 00:00:00,LABORABLE
19,5,2019,7,197,275,472,2019-05-19 06:00:00,2019-05-19 00:00:00,LABORABLE
19,5,2019,8,187,278,465,2019-05-19 07:00:00,2019-05-19 00:00:00,LABORABLE
19,5,2019,9,256,292,548,2019-05-19 08:00:00,2019-05-19 00:00:00,LABORABLE
19,5,2019,10,311,355,666,2019-05-19 09:00:00,2019-05-19 00:00:00,LABORABLE
19,5,2019,11,484,503,987,2019-05-19 10:00:00,2019-05-19 00:00:00,LABORABLE
19,5,2019,12,576,597,1173,2019-05-19 11:00:00,2019-05-19 00:00:00,LABORABLE
19,5,2019,13,528,605,1133,2019-05-19 12:00:00,2019-05-19 00:00:00,LABORABLE
19,5,2019,14,572,625,1197,2019-05-19 13:00:00,2019-05-19 00:00:00,LABORABLE
19,5,2019,15,655,677,1332,2019-05-19 14:00:00,2019-05-19 00:00:00,LABORABLE
19,5,2019,16,447,593,1040,2019-05-19 15:00:00,2019-05-19 00:00:00,LABORABLE
19,5,2019,17,449,612,1061,2019-05-19 16:00:00,2019-05-19 00:00:00,LABORABLE
19,5,2019,18,498,725,1223,2019-05-19 17:00:00,2019-05-19 00:00:00,LABORABLE
19,5,2019,19,530,650,1180,2019-05-19 18:00:00,2019-05-19 00:00:00,LABORABLE
19,5,2019,20,559,611,1170,2019-05-19 19:00:00,2019-05-19 00:00:00,LABORABLE
19,5,2019,21,446,617,1063,2019-05-19 20:00:00,2019-05-19 00:00:00,LABORABLE
19,5,2019,22,537,622,1159,2019-05-19 21:00:00,2019-05-19 00:00:00,LABORABLE
19,5,2019,23,442,548,990,2019-05-19 22:00:00,2019-05-19 00:00:00,LABORABLE
19,5,2019,24,352,395,747,2019-05-19 23:00:00,2019-05-19 00:00:00,LABORABLE
20,5,2019,1,218,332,550,2019-05-20 00:00:00,2019-05-20 00:00:00,LABORABLE
20,5,2019,2,121,223,344,2019-05-20 01:00:00,2019-05-20 00:00:00,LABORABLE
20,5,2019,3,107,170,277,2019-05-20 02:00:00,2019-05-20 00:00:00,LABORABLE
20,5,2019,4,103,115,218,2019-05-20 03:00:00,2019-05-20 00:00:00,LABORABLE
20,5,2019,5,74,119,193,2019-05-20 04:00:00,2019-05-20 00:00:00,LABORABLE
20,5,2019,6,171,197,368,2019-05-20 05:00:00,2019-05-20 00:00:00,LABORABLE
20,5,2019,7,287,424,711,2019-05-20 06:00:00,2019-05-20 00:00:00,LABORABLE
20,5,2019,8,680,657,1337,2019-05-20 07:00:00,2019-05-20 00:00:00,LABORABLE
20,5,2019,9,708,724,1432,2019-05-20 08:00:00,2019-05-20 00:00:00,LABORABLE
20,5,2019,10,584,702,1286,2019-05-20 09:00:00,2019-05-20 00:00:00,LABORABLE
20,5,2019,11,540,687,1227,2019-05-20 10:00:00,2019-05-20 00:00:00,LABORABLE
20,5,2019,12,633,718,1351,2019-05-20 11:00:00,2019-05-20 00:00:00,LABORABLE
20,5,2019,13,654,702,1356,2019-05-20 12:00:00,2019-05-20 00:00:00,LABORABLE
20,5,2019,14,624,720,1344,2019-05-20 13:00:00,2019-05-20 00:00:00,LABORABLE
20,5,2019,15,622,740,1362,2019-05-20 14:00:00,2019-05-20 00:00:00,LABORABLE
20,5,2019,16,632,672,1304,2019-05-20 15:00:00,2019-05-20 00:00:00,LABORABLE
20,5,2019,17,658,760,1418,2019-05-20 16:00:00,2019-05-20 00:00:00,LABORABLE
20,5,2019,18,666,752,1418,2019-05-20 17:00:00,2019-05-20 00:00:00,LABORABLE
20,5,2019,19,684,809,1493,2019-05-20 18:00:00,2019-05-20 00:00:00,LABORABLE
20,5,2019,20,642,820,1462,2019-05-20 19:00:00,2019-05-20 00:00:00,LABORABLE
20,5,2019,21,606,762,1368,2019-05-20 20:00:00,2019-05-20 00:00:00,LABORABLE
20,5,2019,22,482,592,1074,2019-05-20 21:00:00,2019-05-20 00:00:00,LABORABLE
20,5,2019,23,388,494,882,2019-05-20 22:00:00,2019-05-20 00:00:00,LABORABLE
20,5,2019,24,260,370,630,2019-05-20 23:00:00,2019-05-20 00:00:00,LABORABLE
21,5,2019,1,168,289,457,2019-05-21 00:00:00,2019-05-21 00:00:00,LABORABLE
21,5,2019,2,119,184,303,2019-05-21 01:00:00,2019-05-21 00:00:00,LABORABLE
21,5,2019,3,70,118,188,2019-05-21 02:00:00,2019-05-21 00:00:00,LABORABLE
21,5,2019,4,62,86,148,2019-05-21 03:00:00,2019-05-21 00:00:00,LABORABLE
21,5,2019,5,80,82,162,2019-05-21 04:00:00,2019-05-21 00:00:00,LABORABLE
21,5,2019,6,155,184,339,2019-05-21 05:00:00,2019-05-21 00:00:00,LABORABLE
21,5,2019,7,417,408,825,2019-05-21 06:00:00,2019-05-21 00:00:00,LABORABLE
21,5,2019,8,685,655,1340,2019-05-21 07:00:00,2019-05-21 00:00:00,LABORABLE
21,5,2019,9,703,740,1443,2019-05-21 08:00:00,2019-05-21 00:00:00,LABORABLE
21,5,2019,10,586,719,1305,2019-05-21 09:00:00,2019-05-21 00:00:00,LABORABLE
21,5,2019,11,583,707,1290,2019-05-21 10:00:00,2019-05-21 00:00:00,LABORABLE
21,5,2019,12,482,599,1081,2019-05-21 11:00:00,2019-05-21 00:00:00,LABORABLE
21,5,2019,13,576,676,1252,2019-05-21 12:00:00,2019-05-21 00:00:00,LABORABLE
21,5,2019,14,634,745,1379,2019-05-21 13:00:00,2019-05-21 00:00:00,LABORABLE
21,5,2019,15,622,691,1313,2019-05-21 14:00:00,2019-05-21 00:00:00,LABORABLE
21,5,2019,16,677,705,1382,2019-05-21 15:00:00,2019-05-21 00:00:00,LABORABLE
21,5,2019,17,655,739,1394,2019-05-21 16:00:00,2019-05-21 00:00:00,LABORABLE
21,5,2019,18,682,728,1410,2019-05-21 17:00:00,2019-05-21 00:00:00,LABORABLE
21,5,2019,19,673,775,1448,2019-05-21 18:00:00,2019-05-21 00:00:00,LABORABLE
21,5,2019,20,688,765,1453,2019-05-21 19:00:00,2019-05-21 00:00:00,LABORABLE
21,5,2019,21,604,727,1331,2019-05-21 20:00:00,2019-05-21 00:00:00,LABORABLE
21,5,2019,22,519,625,1144,2019-05-21 21:00:00,2019-05-21 00:00:00,LABORABLE
21,5,2019,23,476,480,956,2019-05-21 22:00:00,2019-05-21 00:00:00,LABORABLE
21,5,2019,24,277,440,717,2019-05-21 23:00:00,2019-05-21 00:00:00,LABORABLE
22,5,2019,1,191,304,495,2019-05-22 00:00:00,2019-05-22 00:00:00,LABORABLE
22,5,2019,2,119,226,345,2019-05-22 01:00:00,2019-05-22 00:00:00,LABORABLE
22,5,2019,3,90,163,253,2019-05-22 02:00:00,2019-05-22 00:00:00,LABORABLE
22,5,2019,4,66,112,178,2019-05-22 03:00:00,2019-05-22 00:00:00,LABORABLE
22,5,2019,5,75,102,177,2019-05-22 04:00:00,2019-05-22 00:00:00,LABORABLE
22,5,2019,6,167,174,341,2019-05-22 05:00:00,2019-05-22 00:00:00,LABORABLE
22,5,2019,7,445,443,888,2019-05-22 06:00:00,2019-05-22 00:00:00,LABORABLE
22,5,2019,8,668,653,1321,2019-05-22 07:00:00,2019-05-22 00:00:00,LABORABLE
22,5,2019,9,618,765,1383,2019-05-22 08:00:00,2019-05-22 00:00:00,LABORABLE
22,5,2019,10,723,712,1435,2019-05-22 09:00:00,2019-05-22 00:00:00,LABORABLE
22,5,2019,11,584,662,1246,2019-05-22 10:00:00,2019-05-22 00:00:00,LABORABLE
22,5,2019,12,590,723,1313,2019-05-22 11:00:00,2019-05-22 00:00:00,LABORABLE
22,5,2019,13,583,767,1350,2019-05-22 12:00:00,2019-05-22 00:00:00,LABORABLE
22,5,2019,14,656,799,1455,2019-05-22 13:00:00,2019-05-22 00:00:00,LABORABLE
22,5,2019,15,664,721,1385,2019-05-22 14:00:00,2019-05-22 00:00:00,LABORABLE
22,5,2019,16,681,712,1393,2019-05-22 15:00:00,2019-05-22 00:00:00,LABORABLE
22,5,2019,17,668,718,1386,2019-05-22 16:00:00,2019-05-22 00:00:00,LABORABLE
22,5,2019,18,684,758,1442,2019-05-22 17:00:00,2019-05-22 00:00:00,LABORABLE
22,5,2019,19,742,810,1552,2019-05-22 18:00:00,2019-05-22 00:00:00,LABORABLE
22,5,2019,20,656,816,1472,2019-05-22 19:00:00,2019-05-22 00:00:00,LABORABLE
22,5,2019,21,604,702,1306,2019-05-22 20:00:00,2019-05-22 00:00:00,LABORABLE
22,5,2019,22,525,604,1129,2019-05-22 21:00:00,2019-05-22 00:00:00,LABORABLE
22,5,2019,23,448,553,1001,2019-05-22 22:00:00,2019-05-22 00:00:00,LABORABLE
22,5,2019,24,277,357,634,2019-05-22 23:00:00,2019-05-22 00:00:00,LABORABLE
23,5,2019,1,252,302,554,2019-05-23 00:00:00,2019-05-23 00:00:00,LABORABLE
23,5,2019,2,139,238,377,2019-05-23 01:00:00,2019-05-23 00:00:00,LABORABLE
23,5,2019,3,96,169,265,2019-05-23 02:00:00,2019-05-23 00:00:00,LABORABLE
23,5,2019,4,90,117,207,2019-05-23 03:00:00,2019-05-23 00:00:00,LABORABLE
23,5,2019,5,84,108,192,2019-05-23 04:00:00,2019-05-23 00:00:00,LABORABLE
23,5,2019,6,170,176,346,2019-05-23 05:00:00,2019-05-23 00:00:00,LABORABLE
23,5,2019,7,448,396,844,2019-05-23 06:00:00,2019-05-23 00:00:00,LABORABLE
23,5,2019,8,691,635,1326,2019-05-23 07:00:00,2019-05-23 00:00:00,LABORABLE
23,5,2019,9,759,734,1493,2019-05-23 08:00:00,2019-05-23 00:00:00,LABORABLE
23,5,2019,10,710,698,1408,2019-05-23 09:00:00,2019-05-23 00:00:00,LABORABLE
23,5,2019,11,640,665,1305,2019-05-23 10:00:00,2019-05-23 00:00:00,LABORABLE
23,5,2019,12,618,768,1386,2019-05-23 11:00:00,2019-05-23 00:00:00,LABORABLE
23,5,2019,13,671,731,1402,2019-05-23 12:00:00,2019-05-23 00:00:00,LABORABLE
23,5,2019,14,653,720,1373,2019-05-23 13:00:00,2019-05-23 00:00:00,LABORABLE
23,5,2019,15,506,563,1069,2019-05-23 14:00:00,2019-05-23 00:00:00,LABORABLE
23,5,2019,16,691,669,1360,2019-05-23 15:00:00,2019-05-23 00:00:00,LABORABLE
23,5,2019,17,680,700,1380,2019-05-23 16:00:00,2019-05-23 00:00:00,LABORABLE
23,5,2019,18,716,781,1497,2019-05-23 17:00:00,2019-05-23 00:00:00,LABORABLE
23,5,2019,19,744,842,1586,2019-05-23 18:00:00,2019-05-23 00:00:00,LABORABLE
23,5,2019,20,623,779,1402,2019-05-23 19:00:00,2019-05-23 00:00:00,LABORABLE
23,5,2019,21,688,805,1493,2019-05-23 20:00:00,2019-05-23 00:00:00,LABORABLE
23,5,2019,22,604,651,1255,2019-05-23 21:00:00,2019-05-23 00:00:00,LABORABLE
23,5,2019,23,484,509,993,2019-05-23 22:00:00,2019-05-23 00:00:00,LABORABLE
23,5,2019,24,350,421,771,2019-05-23 23:00:00,2019-05-23 00:00:00,LABORABLE
24,5,2019,1,273,350,623,2019-05-24 00:00:00,2019-05-24 00:00:00,LABORABLE
24,5,2019,2,178,231,409,2019-05-24 01:00:00,2019-05-24 00:00:00,LABORABLE
24,5,2019,3,120,205,325,2019-05-24 02:00:00,2019-05-24 00:00:00,LABORABLE
24,5,2019,4,99,156,255,2019-05-24 03:00:00,2019-05-24 00:00:00,LABORABLE
24,5,2019,5,93,115,208,2019-05-24 04:00:00,2019-05-24 00:00:00,LABORABLE
24,5,2019,6,163,182,345,2019-05-24 05:00:00,2019-05-24 00:00:00,LABORABLE
24,5,2019,7,260,293,553,2019-05-24 06:00:00,2019-05-24 00:00:00,LABORABLE
24,5,2019,8,402,668,1070,2019-05-24 07:00:00,2019-05-24 00:00:00,LABORABLE
24,5,2019,9,722,747,1469,2019-05-24 08:00:00,2019-05-24 00:00:00,LABORABLE
24,5,2019,10,659,734,1393,2019-05-24 09:00:00,2019-05-24 00:00:00,LABORABLE
24,5,2019,11,605,728,1333,2019-05-24 10:00:00,2019-05-24 00:00:00,LABORABLE
24,5,2019,12,580,756,1336,2019-05-24 11:00:00,2019-05-24 00:00:00,LABORABLE
24,5,2019,13,661,780,1441,2019-05-24 12:00:00,2019-05-24 00:00:00,LABORABLE
24,5,2019,14,641,675,1316,2019-05-24 13:00:00,2019-05-24 00:00:00,LABORABLE
24,5,2019,15,687,718,1405,2019-05-24 14:00:00,2019-05-24 00:00:00,LABORABLE
24,5,2019,16,693,737,1430,2019-05-24 15:00:00,2019-05-24 00:00:00,LABORABLE
24,5,2019,17,690,792,1482,2019-05-24 16:00:00,2019-05-24 00:00:00,LABORABLE
24,5,2019,18,744,691,1435,2019-05-24 17:00:00,2019-05-24 00:00:00,LABORABLE
24,5,2019,19,684,863,1547,2019-05-24 18:00:00,2019-05-24 00:00:00,LABORABLE
24,5,2019,20,669,785,1454,2019-05-24 19:00:00,2019-05-24 00:00:00,LABORABLE
24,5,2019,21,699,859,1558,2019-05-24 20:00:00,2019-05-24 00:00:00,LABORABLE
24,5,2019,22,669,727,1396,2019-05-24 21:00:00,2019-05-24 00:00:00,LABORABLE
24,5,2019,23,617,635,1252,2019-05-24 22:00:00,2019-05-24 00:00:00,LABORABLE
24,5,2019,24,445,576,1021,2019-05-24 23:00:00,2019-05-24 00:00:00,LABORABLE
25,5,2019,1,361,494,855,2019-05-25 00:00:00,2019-05-25 00:00:00,LABORABLE
25,5,2019,2,271,372,643,2019-05-25 01:00:00,2019-05-25 00:00:00,LABORABLE
25,5,2019,3,209,319,528,2019-05-25 02:00:00,2019-05-25 00:00:00,LABORABLE
25,5,2019,4,160,241,401,2019-05-25 03:00:00,2019-05-25 00:00:00,LABORABLE
25,5,2019,5,141,234,375,2019-05-25 04:00:00,2019-05-25 00:00:00,LABORABLE
25,5,2019,6,159,244,403,2019-05-25 05:00:00,2019-05-25 00:00:00,LABORABLE
25,5,2019,7,221,306,527,2019-05-25 06:00:00,2019-05-25 00:00:00,LABORABLE
25,5,2019,8,313,331,644,2019-05-25 07:00:00,2019-05-25 00:00:00,LABORABLE
25,5,2019,9,387,402,789,2019-05-25 08:00:00,2019-05-25 00:00:00,LABORABLE
25,5,2019,10,476,491,967,2019-05-25 09:00:00,2019-05-25 00:00:00,LABORABLE
25,5,2019,11,583,622,1205,2019-05-25 10:00:00,2019-05-25 00:00:00,LABORABLE
25,5,2019,12,649,746,1395,2019-05-25 11:00:00,2019-05-25 00:00:00,LABORABLE
25,5,2019,13,675,749,1424,2019-05-25 12:00:00,2019-05-25 00:00:00,LABORABLE
25,5,2019,14,630,801,1431,2019-05-25 13:00:00,2019-05-25 00:00:00,LABORABLE
25,5,2019,15,619,834,1453,2019-05-25 14:00:00,2019-05-25 00:00:00,LABORABLE
25,5,2019,16,490,696,1186,2019-05-25 15:00:00,2019-05-25 00:00:00,LABORABLE
25,5,2019,17,496,680,1176,2019-05-25 16:00:00,2019-05-25 00:00:00,LABORABLE
25,5,2019,18,555,769,1324,2019-05-25 17:00:00,2019-05-25 00:00:00,LABORABLE
25,5,2019,19,654,728,1382,2019-05-25 18:00:00,2019-05-25 00:00:00,LABORABLE
25,5,2019,20,574,794,1368,2019-05-25 19:00:00,2019-05-25 00:00:00,LABORABLE
25,5,2019,21,602,702,1304,2019-05-25 20:00:00,2019-05-25 00:00:00,LABORABLE
25,5,2019,22,594,708,1302,2019-05-25 21:00:00,2019-05-25 00:00:00,LABORABLE
25,5,2019,23,567,655,1222,2019-05-25 22:00:00,2019-05-25 00:00:00,LABORABLE
25,5,2019,24,531,615,1146,2019-05-25 23:00:00,2019-05-25 00:00:00,LABORABLE
26,5,2019,1,443,511,954,2019-05-26 00:00:00,2019-05-26 00:00:00,LABORABLE
26,5,2019,2,356,457,813,2019-05-26 01:00:00,2019-05-26 00:00:00,LABORABLE
26,5,2019,3,251,370,621,2019-05-26 02:00:00,2019-05-26 00:00:00,LABORABLE
26,5,2019,4,218,305,523,2019-05-26 03:00:00,2019-05-26 00:00:00,LABORABLE
26,5,2019,5,141,328,469,2019-05-26 04:00:00,2019-05-26 00:00:00,LABORABLE
26,5,2019,6,155,258,413,2019-05-26 05:00:00,2019-05-26 00:00:00,LABORABLE
26,5,2019,7,196,301,497,2019-05-26 06:00:00,2019-05-26 00:00:00,LABORABLE
26,5,2019,8,219,275,494,2019-05-26 07:00:00,2019-05-26 00:00:00,LABORABLE
26,5,2019,9,247,279,526,2019-05-26 08:00:00,2019-05-26 00:00:00,LABORABLE
26,5,2019,10,362,436,798,2019-05-26 09:00:00,2019-05-26 00:00:00,LABORABLE
26,5,2019,11,444,523,967,2019-05-26 10:00:00,2019-05-26 00:00:00,LABORABLE
26,5,2019,12,551,616,1167,2019-05-26 11:00:00,2019-05-26 00:00:00,LABORABLE
26,5,2019,13,655,685,1340,2019-05-26 12:00:00,2019-05-26 00:00:00,LABORABLE
26,5,2019,14,639,732,1371,2019-05-26 13:00:00,2019-05-26 00:00:00,LABORABLE
26,5,2019,15,621,742,1363,2019-05-26 14:00:00,2019-05-26 00:00:00,LABORABLE
26,5,2019,16,470,637,1107,2019-05-26 15:00:00,2019-05-26 00:00:00,LABORABLE
26,5,2019,17,483,725,1208,2019-05-26 16:00:00,2019-05-26 00:00:00,LABORABLE
26,5,2019,18,539,740,1279,2019-05-26 17:00:00,2019-05-26 00:00:00,LABORABLE
26,5,2019,19,587,750,1337,2019-05-26 18:00:00,2019-05-26 00:00:00,LABORABLE
26,5,2019,20,539,741,1280,2019-05-26 19:00:00,2019-05-26 00:00:00,LABORABLE
26,5,2019,21,550,640,1190,2019-05-26 20:00:00,2019-05-26 00:00:00,LABORABLE
26,5,2019,22,547,647,1194,2019-05-26 21:00:00,2019-05-26 00:00:00,LABORABLE
26,5,2019,23,500,561,1061,2019-05-26 22:00:00,2019-05-26 00:00:00,LABORABLE
26,5,2019,24,320,482,802,2019-05-26 23:00:00,2019-05-26 00:00:00,LABORABLE
27,5,2019,1,262,362,624,2019-05-27 00:00:00,2019-05-27 00:00:00,LABORABLE
27,5,2019,2,163,261,424,2019-05-27 01:00:00,2019-05-27 00:00:00,LABORABLE
27,5,2019,3,124,200,324,2019-05-27 02:00:00,2019-05-27 00:00:00,LABORABLE
27,5,2019,4,98,153,251,2019-05-27 03:00:00,2019-05-27 00:00:00,LABORABLE
27,5,2019,5,76,124,200,2019-05-27 04:00:00,2019-05-27 00:00:00,LABORABLE
27,5,2019,6,172,171,343,2019-05-27 05:00:00,2019-05-27 00:00:00,LABORABLE
27,5,2019,7,287,410,697,2019-05-27 06:00:00,2019-05-27 00:00:00,LABORABLE
27,5,2019,8,715,727,1442,2019-05-27 07:00:00,2019-05-27 00:00:00,LABORABLE
27,5,2019,9,699,762,1461,2019-05-27 08:00:00,2019-05-27 00:00:00,LABORABLE
27,5,2019,10,653,695,1348,2019-05-27 09:00:00,2019-05-27 00:00:00,LABORABLE
27,5,2019,11,561,675,1236,2019-05-27 10:00:00,2019-05-27 00:00:00,LABORABLE
27,5,2019,12,561,756,1317,2019-05-27 11:00:00,2019-05-27 00:00:00,LABORABLE
27,5,2019,13,580,733,1313,2019-05-27 12:00:00,2019-05-27 00:00:00,LABORABLE
27,5,2019,14,620,758,1378,2019-05-27 13:00:00,2019-05-27 00:00:00,LABORABLE
27,5,2019,15,663,733,1396,2019-05-27 14:00:00,2019-05-27 00:00:00,LABORABLE
27,5,2019,16,655,718,1373,2019-05-27 15:00:00,2019-05-27 00:00:00,LABORABLE
27,5,2019,17,629,731,1360,2019-05-27 16:00:00,2019-05-27 00:00:00,LABORABLE
27,5,2019,18,647,768,1415,2019-05-27 17:00:00,2019-05-27 00:00:00,LABORABLE
27,5,2019,19,683,729,1412,2019-05-27 18:00:00,2019-05-27 00:00:00,LABORABLE
27,5,2019,20,621,759,1380,2019-05-27 19:00:00,2019-05-27 00:00:00,LABORABLE
27,5,2019,21,595,758,1353,2019-05-27 20:00:00,2019-05-27 00:00:00,LABORABLE
27,5,2019,22,522,668,1190,2019-05-27 21:00:00,2019-05-27 00:00:00,LABORABLE
27,5,2019,23,443,520,963,2019-05-27 22:00:00,2019-05-27 00:00:00,LABORABLE
27,5,2019,24,270,383,653,2019-05-27 23:00:00,2019-05-27 00:00:00,LABORABLE
28,5,2019,1,199,344,543,2019-05-28 00:00:00,2019-05-28 00:00:00,LABORABLE
28,5,2019,2,109,207,316,2019-05-28 01:00:00,2019-05-28 00:00:00,LABORABLE
28,5,2019,3,82,161,243,2019-05-28 02:00:00,2019-05-28 00:00:00,LABORABLE
28,5,2019,4,74,98,172,2019-05-28 03:00:00,2019-05-28 00:00:00,LABORABLE
28,5,2019,5,69,82,151,2019-05-28 04:00:00,2019-05-28 00:00:00,LABORABLE
28,5,2019,6,151,175,326,2019-05-28 05:00:00,2019-05-28 00:00:00,LABORABLE
28,5,2019,7,448,451,899,2019-05-28 06:00:00,2019-05-28 00:00:00,LABORABLE
28,5,2019,8,756,683,1439,2019-05-28 07:00:00,2019-05-28 00:00:00,LABORABLE
28,5,2019,9,660,760,1420,2019-05-28 08:00:00,2019-05-28 00:00:00,LABORABLE
28,5,2019,10,648,707,1355,2019-05-28 09:00:00,2019-05-28 00:00:00,LABORABLE
28,5,2019,11,554,685,1239,2019-05-28 10:00:00,2019-05-28 00:00:00,LABORABLE
28,5,2019,12,602,698,1300,2019-05-28 11:00:00,2019-05-28 00:00:00,LABORABLE
28,5,2019,13,626,766,1392,2019-05-28 12:00:00,2019-05-28 00:00:00,LABORABLE
28,5,2019,14,636,748,1384,2019-05-28 13:00:00,2019-05-28 00:00:00,LABORABLE
28,5,2019,15,674,734,1408,2019-05-28 14:00:00,2019-05-28 00:00:00,LABORABLE
28,5,2019,16,630,674,1304,2019-05-28 15:00:00,2019-05-28 00:00:00,LABORABLE
28,5,2019,17,651,763,1414,2019-05-28 16:00:00,2019-05-28 00:00:00,LABORABLE
28,5,2019,18,661,759,1420,2019-05-28 17:00:00,2019-05-28 00:00:00,LABORABLE
28,5,2019,19,643,814,1457,2019-05-28 18:00:00,2019-05-28 00:00:00,LABORABLE
28,5,2019,20,638,720,1358,2019-05-28 19:00:00,2019-05-28 00:00:00,LABORABLE
28,5,2019,21,640,762,1402,2019-05-28 20:00:00,2019-05-28 00:00:00,LABORABLE
28,5,2019,22,550,690,1240,2019-05-28 21:00:00,2019-05-28 00:00:00,LABORABLE
28,5,2019,23,463,524,987,2019-05-28 22:00:00,2019-05-28 00:00:00,LABORABLE
28,5,2019,24,275,366,641,2019-05-28 23:00:00,2019-05-28 00:00:00,LABORABLE
29,5,2019,1,188,342,530,2019-05-29 00:00:00,2019-05-29 00:00:00,LABORABLE
29,5,2019,2,130,200,330,2019-05-29 01:00:00,2019-05-29 00:00:00,LABORABLE
29,5,2019,3,88,157,245,2019-05-29 02:00:00,2019-05-29 00:00:00,LABORABLE
29,5,2019,4,65,125,190,2019-05-29 03:00:00,2019-05-29 00:00:00,LABORABLE
29,5,2019,5,88,108,196,2019-05-29 04:00:00,2019-05-29 00:00:00,LABORABLE
29,5,2019,6,175,197,372,2019-05-29 05:00:00,2019-05-29 00:00:00,LABORABLE
29,5,2019,7,435,417,852,2019-05-29 06:00:00,2019-05-29 00:00:00,LABORABLE
29,5,2019,8,684,681,1365,2019-05-29 07:00:00,2019-05-29 00:00:00,LABORABLE
29,5,2019,9,735,662,1397,2019-05-29 08:00:00,2019-05-29 00:00:00,LABORABLE
29,5,2019,10,674,727,1401,2019-05-29 09:00:00,2019-05-29 00:00:00,LABORABLE
29,5,2019,11,571,652,1223,2019-05-29 10:00:00,2019-05-29 00:00:00,LABORABLE
29,5,2019,12,588,685,1273,2019-05-29 11:00:00,2019-05-29 00:00:00,LABORABLE
29,5,2019,13,605,729,1334,2019-05-29 12:00:00,2019-05-29 00:00:00,LABORABLE
29,5,2019,14,437,687,1124,2019-05-29 13:00:00,2019-05-29 00:00:00,LABORABLE
29,5,2019,15,653,785,1438,2019-05-29 14:00:00,2019-05-29 00:00:00,LABORABLE
29,5,2019,16,678,711,1389,2019-05-29 15:00:00,2019-05-29 00:00:00,LABORABLE
29,5,2019,17,578,666,1244,2019-05-29 16:00:00,2019-05-29 00:00:00,LABORABLE
29,5,2019,18,703,721,1424,2019-05-29 17:00:00,2019-05-29 00:00:00,LABORABLE
29,5,2019,19,702,731,1433,2019-05-29 18:00:00,2019-05-29 00:00:00,LABORABLE
29,5,2019,20,603,725,1328,2019-05-29 19:00:00,2019-05-29 00:00:00,LABORABLE
29,5,2019,21,631,743,1374,2019-05-29 20:00:00,2019-05-29 00:00:00,LABORABLE
29,5,2019,22,554,620,1174,2019-05-29 21:00:00,2019-05-29 00:00:00,LABORABLE
29,5,2019,23,415,493,908,2019-05-29 22:00:00,2019-05-29 00:00:00,LABORABLE
29,5,2019,24,287,405,692,2019-05-29 23:00:00,2019-05-29 00:00:00,LABORABLE
30,5,2019,1,251,286,537,2019-05-30 00:00:00,2019-05-30 00:00:00,LABORABLE
30,5,2019,2,144,239,383,2019-05-30 01:00:00,2019-05-30 00:00:00,LABORABLE
30,5,2019,3,103,150,253,2019-05-30 02:00:00,2019-05-30 00:00:00,LABORABLE
30,5,2019,4,89,108,197,2019-05-30 03:00:00,2019-05-30 00:00:00,LABORABLE
30,5,2019,5,89,105,194,2019-05-30 04:00:00,2019-05-30 00:00:00,LABORABLE
30,5,2019,6,187,194,381,2019-05-30 05:00:00,2019-05-30 00:00:00,LABORABLE
30,5,2019,7,456,433,889,2019-05-30 06:00:00,2019-05-30 00:00:00,LABORABLE
30,5,2019,8,686,657,1343,2019-05-30 07:00:00,2019-05-30 00:00:00,LABORABLE
30,5,2019,9,721,694,1415,2019-05-30 08:00:00,2019-05-30 00:00:00,LABORABLE
30,5,2019,10,705,668,1373,2019-05-30 09:00:00,2019-05-30 00:00:00,LABORABLE
30,5,2019,11,495,645,1140,2019-05-30 10:00:00,2019-05-30 00:00:00,LABORABLE
30,5,2019,12,570,708,1278,2019-05-30 11:00:00,2019-05-30 00:00:00,LABORABLE
30,5,2019,13,640,681,1321,2019-05-30 12:00:00,2019-05-30 00:00:00,LABORABLE
30,5,2019,14,652,754,1406,2019-05-30 13:00:00,2019-05-30 00:00:00,LABORABLE
30,5,2019,15,684,695,1379,2019-05-30 14:00:00,2019-05-30 00:00:00,LABORABLE
30,5,2019,16,651,682,1333,2019-05-30 15:00:00,2019-05-30 00:00:00,LABORABLE
30,5,2019,17,650,770,1420,2019-05-30 16:00:00,2019-05-30 00:00:00,LABORABLE
30,5,2019,18,692,771,1463,2019-05-30 17:00:00,2019-05-30 00:00:00,LABORABLE
30,5,2019,19,715,814,1529,2019-05-30 18:00:00,2019-05-30 00:00:00,LABORABLE
30,5,2019,20,669,794,1463,2019-05-30 19:00:00,2019-05-30 00:00:00,LABORABLE
30,5,2019,21,649,741,1390,2019-05-30 20:00:00,2019-05-30 00:00:00,LABORABLE
30,5,2019,22,564,684,1248,2019-05-30 21:00:00,2019-05-30 00:00:00,LABORABLE
30,5,2019,23,525,546,1071,2019-05-30 22:00:00,2019-05-30 00:00:00,LABORABLE
30,5,2019,24,329,487,816,2019-05-30 23:00:00,2019-05-30 00:00:00,LABORABLE
31,5,2019,1,241,360,601,2019-05-31 00:00:00,2019-05-31 00:00:00,LABORABLE
31,5,2019,2,185,249,434,2019-05-31 01:00:00,2019-05-31 00:00:00,LABORABLE
31,5,2019,3,112,210,322,2019-05-31 02:00:00,2019-05-31 00:00:00,LABORABLE
31,5,2019,4,103,168,271,2019-05-31 03:00:00,2019-05-31 00:00:00,LABORABLE
31,5,2019,5,104,131,235,2019-05-31 04:00:00,2019-05-31 00:00:00,LABORABLE
31,5,2019,6,176,207,383,2019-05-31 05:00:00,2019-05-31 00:00:00,LABORABLE
31,5,2019,7,260,287,547,2019-05-31 06:00:00,2019-05-31 00:00:00,LABORABLE
31,5,2019,8,402,674,1076,2019-05-31 07:00:00,2019-05-31 00:00:00,LABORABLE
31,5,2019,9,680,703,1383,2019-05-31 08:00:00,2019-05-31 00:00:00,LABORABLE
31,5,2019,10,662,700,1362,2019-05-31 09:00:00,2019-05-31 00:00:00,LABORABLE
31,5,2019,11,604,635,1239,2019-05-31 10:00:00,2019-05-31 00:00:00,LABORABLE
31,5,2019,12,596,777,1373,2019-05-31 11:00:00,2019-05-31 00:00:00,LABORABLE
31,5,2019,13,650,714,1364,2019-05-31 12:00:00,2019-05-31 00:00:00,LABORABLE
31,5,2019,14,626,795,1421,2019-05-31 13:00:00,2019-05-31 00:00:00,LABORABLE
31,5,2019,15,690,712,1402,2019-05-31 14:00:00,2019-05-31 00:00:00,LABORABLE
31,5,2019,16,645,737,1382,2019-05-31 15:00:00,2019-05-31 00:00:00,LABORABLE
31,5,2019,17,636,834,1470,2019-05-31 16:00:00,2019-05-31 00:00:00,LABORABLE
31,5,2019,18,694,745,1439,2019-05-31 17:00:00,2019-05-31 00:00:00,LABORABLE
31,5,2019,19,730,765,1495,2019-05-31 18:00:00,2019-05-31 00:00:00,LABORABLE
31,5,2019,20,644,807,1451,2019-05-31 19:00:00,2019-05-31 00:00:00,LABORABLE
31,5,2019,21,708,850,1558,2019-05-31 20:00:00,2019-05-31 00:00:00,LABORABLE
31,5,2019,22,675,703,1378,2019-05-31 21:00:00,2019-05-31 00:00:00,LABORABLE
31,5,2019,23,593,659,1252,2019-05-31 22:00:00,2019-05-31 00:00:00,LABORABLE
31,5,2019,24,421,510,931,2019-05-31 23:00:00,2019-05-31 00:00:00,LABORABLE
1,6,2019,1,336,431,767,2019-06-01 00:00:00,2019-01-06 00:00:00,LABORABLE
1,6,2019,2,280,407,687,2019-06-01 01:00:00,2019-01-06 00:00:00,LABORABLE
1,6,2019,3,183,330,513,2019-06-01 02:00:00,2019-01-06 00:00:00,LABORABLE
1,6,2019,4,186,283,469,2019-06-01 03:00:00,2019-01-06 00:00:00,LABORABLE
1,6,2019,5,151,218,369,2019-06-01 04:00:00,2019-01-06 00:00:00,LABORABLE
1,6,2019,6,149,227,376,2019-06-01 05:00:00,2019-01-06 00:00:00,LABORABLE
1,6,2019,7,223,301,524,2019-06-01 06:00:00,2019-01-06 00:00:00,LABORABLE
1,6,2019,8,331,346,677,2019-06-01 07:00:00,2019-01-06 00:00:00,LABORABLE
1,6,2019,9,375,386,761,2019-06-01 08:00:00,2019-01-06 00:00:00,LABORABLE
1,6,2019,10,470,576,1046,2019-06-01 09:00:00,2019-01-06 00:00:00,LABORABLE
1,6,2019,11,571,666,1237,2019-06-01 10:00:00,2019-01-06 00:00:00,LABORABLE
1,6,2019,12,654,688,1342,2019-06-01 11:00:00,2019-01-06 00:00:00,LABORABLE
1,6,2019,13,635,719,1354,2019-06-01 12:00:00,2019-01-06 00:00:00,LABORABLE
1,6,2019,14,612,813,1425,2019-06-01 13:00:00,2019-01-06 00:00:00,LABORABLE
1,6,2019,15,656,886,1542,2019-06-01 14:00:00,2019-01-06 00:00:00,LABORABLE
1,6,2019,16,525,655,1180,2019-06-01 15:00:00,2019-01-06 00:00:00,LABORABLE
1,6,2019,17,495,679,1174,2019-06-01 16:00:00,2019-01-06 00:00:00,LABORABLE
1,6,2019,18,530,755,1285,2019-06-01 17:00:00,2019-01-06 00:00:00,LABORABLE
1,6,2019,19,596,729,1325,2019-06-01 18:00:00,2019-01-06 00:00:00,LABORABLE
1,6,2019,20,604,718,1322,2019-06-01 19:00:00,2019-01-06 00:00:00,LABORABLE
1,6,2019,21,577,771,1348,2019-06-01 20:00:00,2019-01-06 00:00:00,LABORABLE
1,6,2019,22,535,636,1171,2019-06-01 21:00:00,2019-01-06 00:00:00,LABORABLE
1,6,2019,23,533,608,1141,2019-06-01 22:00:00,2019-01-06 00:00:00,LABORABLE
1,6,2019,24,452,573,1025,2019-06-01 23:00:00,2019-01-06 00:00:00,LABORABLE
2,6,2019,1,461,617,1078,2019-06-02 00:00:00,2019-02-06 00:00:00,LABORABLE
2,6,2019,2,382,460,842,2019-06-02 01:00:00,2019-02-06 00:00:00,LABORABLE
2,6,2019,3,267,405,672,2019-06-02 02:00:00,2019-02-06 00:00:00,LABORABLE
2,6,2019,4,205,369,574,2019-06-02 03:00:00,2019-02-06 00:00:00,LABORABLE
2,6,2019,5,153,283,436,2019-06-02 04:00:00,2019-02-06 00:00:00,LABORABLE
2,6,2019,6,157,260,417,2019-06-02 05:00:00,2019-02-06 00:00:00,LABORABLE
2,6,2019,7,187,298,485,2019-06-02 06:00:00,2019-02-06 00:00:00,LABORABLE
2,6,2019,8,228,266,494,2019-06-02 07:00:00,2019-02-06 00:00:00,LABORABLE
2,6,2019,9,229,300,529,2019-06-02 08:00:00,2019-02-06 00:00:00,LABORABLE
2,6,2019,10,372,375,747,2019-06-02 09:00:00,2019-02-06 00:00:00,LABORABLE
2,6,2019,11,451,506,957,2019-06-02 10:00:00,2019-02-06 00:00:00,LABORABLE
2,6,2019,12,532,601,1133,2019-06-02 11:00:00,2019-02-06 00:00:00,LABORABLE
2,6,2019,13,473,604,1077,2019-06-02 12:00:00,2019-02-06 00:00:00,LABORABLE
2,6,2019,14,570,756,1326,2019-06-02 13:00:00,2019-02-06 00:00:00,LABORABLE
2,6,2019,15,495,684,1179,2019-06-02 14:00:00,2019-02-06 00:00:00,LABORABLE
2,6,2019,16,449,619,1068,2019-06-02 15:00:00,2019-02-06 00:00:00,LABORABLE
2,6,2019,17,452,655,1107,2019-06-02 16:00:00,2019-02-06 00:00:00,LABORABLE
2,6,2019,18,510,681,1191,2019-06-02 17:00:00,2019-02-06 00:00:00,LABORABLE
2,6,2019,19,565,685,1250,2019-06-02 18:00:00,2019-02-06 00:00:00,LABORABLE
2,6,2019,20,501,718,1219,2019-06-02 19:00:00,2019-02-06 00:00:00,LABORABLE
2,6,2019,21,543,740,1283,2019-06-02 20:00:00,2019-02-06 00:00:00,LABORABLE
2,6,2019,22,584,654,1238,2019-06-02 21:00:00,2019-02-06 00:00:00,LABORABLE
2,6,2019,23,514,523,1037,2019-06-02 22:00:00,2019-02-06 00:00:00,LABORABLE
2,6,2019,24,337,419,756,2019-06-02 23:00:00,2019-02-06 00:00:00,LABORABLE
3,6,2019,1,214,348,562,2019-06-03 00:00:00,2019-03-06 00:00:00,LABORABLE
3,6,2019,2,149,229,378,2019-06-03 01:00:00,2019-03-06 00:00:00,LABORABLE
3,6,2019,3,116,172,288,2019-06-03 02:00:00,2019-03-06 00:00:00,LABORABLE
3,6,2019,4,91,142,233,2019-06-03 03:00:00,2019-03-06 00:00:00,LABORABLE
3,6,2019,5,89,113,202,2019-06-03 04:00:00,2019-03-06 00:00:00,LABORABLE
3,6,2019,6,172,175,347,2019-06-03 05:00:00,2019-03-06 00:00:00,LABORABLE
3,6,2019,7,301,451,752,2019-06-03 06:00:00,2019-03-06 00:00:00,LABORABLE
3,6,2019,8,728,624,1352,2019-06-03 07:00:00,2019-03-06 00:00:00,LABORABLE
3,6,2019,9,676,694,1370,2019-06-03 08:00:00,2019-03-06 00:00:00,LABORABLE
3,6,2019,10,650,717,1367,2019-06-03 09:00:00,2019-03-06 00:00:00,LABORABLE
3,6,2019,11,518,674,1192,2019-06-03 10:00:00,2019-03-06 00:00:00,LABORABLE
3,6,2019,12,572,692,1264,2019-06-03 11:00:00,2019-03-06 00:00:00,LABORABLE
3,6,2019,13,618,717,1335,2019-06-03 12:00:00,2019-03-06 00:00:00,LABORABLE
3,6,2019,14,614,756,1370,2019-06-03 13:00:00,2019-03-06 00:00:00,LABORABLE
3,6,2019,15,658,686,1344,2019-06-03 14:00:00,2019-03-06 00:00:00,LABORABLE
3,6,2019,16,682,713,1395,2019-06-03 15:00:00,2019-03-06 00:00:00,LABORABLE
3,6,2019,17,609,679,1288,2019-06-03 16:00:00,2019-03-06 00:00:00,LABORABLE
3,6,2019,18,645,768,1413,2019-06-03 17:00:00,2019-03-06 00:00:00,LABORABLE
3,6,2019,19,650,789,1439,2019-06-03 18:00:00,2019-03-06 00:00:00,LABORABLE
3,6,2019,20,625,790,1415,2019-06-03 19:00:00,2019-03-06 00:00:00,LABORABLE
3,6,2019,21,592,734,1326,2019-06-03 20:00:00,2019-03-06 00:00:00,LABORABLE
3,6,2019,22,556,597,1153,2019-06-03 21:00:00,2019-03-06 00:00:00,LABORABLE
3,6,2019,23,445,514,959,2019-06-03 22:00:00,2019-03-06 00:00:00,LABORABLE
3,6,2019,24,283,353,636,2019-06-03 23:00:00,2019-03-06 00:00:00,LABORABLE
4,6,2019,1,191,303,494,2019-06-04 00:00:00,2019-04-06 00:00:00,LABORABLE
4,6,2019,2,123,210,333,2019-06-04 01:00:00,2019-04-06 00:00:00,LABORABLE
4,6,2019,3,79,158,237,2019-06-04 02:00:00,2019-04-06 00:00:00,LABORABLE
4,6,2019,4,75,106,181,2019-06-04 03:00:00,2019-04-06 00:00:00,LABORABLE
4,6,2019,5,78,111,189,2019-06-04 04:00:00,2019-04-06 00:00:00,LABORABLE
4,6,2019,6,155,148,303,2019-06-04 05:00:00,2019-04-06 00:00:00,LABORABLE
4,6,2019,7,426,434,860,2019-06-04 06:00:00,2019-04-06 00:00:00,LABORABLE
4,6,2019,8,706,706,1412,2019-06-04 07:00:00,2019-04-06 00:00:00,LABORABLE
4,6,2019,9,700,671,1371,2019-06-04 08:00:00,2019-04-06 00:00:00,LABORABLE
4,6,2019,10,598,731,1329,2019-06-04 09:00:00,2019-04-06 00:00:00,LABORABLE
4,6,2019,11,430,685,1115,2019-06-04 10:00:00,2019-04-06 00:00:00,LABORABLE
4,6,2019,12,552,732,1284,2019-06-04 11:00:00,2019-04-06 00:00:00,LABORABLE
4,6,2019,13,609,782,1391,2019-06-04 12:00:00,2019-04-06 00:00:00,LABORABLE
4,6,2019,14,465,804,1269,2019-06-04 13:00:00,2019-04-06 00:00:00,LABORABLE
4,6,2019,15,668,721,1389,2019-06-04 14:00:00,2019-04-06 00:00:00,LABORABLE
4,6,2019,16,645,685,1330,2019-06-04 15:00:00,2019-04-06 00:00:00,LABORABLE
4,6,2019,17,562,733,1295,2019-06-04 16:00:00,2019-04-06 00:00:00,LABORABLE
4,6,2019,18,655,743,1398,2019-06-04 17:00:00,2019-04-06 00:00:00,LABORABLE
4,6,2019,19,658,736,1394,2019-06-04 18:00:00,2019-04-06 00:00:00,LABORABLE
4,6,2019,20,614,770,1384,2019-06-04 19:00:00,2019-04-06 00:00:00,LABORABLE
4,6,2019,21,660,774,1434,2019-06-04 20:00:00,2019-04-06 00:00:00,LABORABLE
4,6,2019,22,549,666,1215,2019-06-04 21:00:00,2019-04-06 00:00:00,LABORABLE
4,6,2019,23,439,563,1002,2019-06-04 22:00:00,2019-04-06 00:00:00,LABORABLE
4,6,2019,24,253,336,589,2019-06-04 23:00:00,2019-04-06 00:00:00,LABORABLE
5,6,2019,1,197,301,498,2019-06-05 00:00:00,2019-05-06 00:00:00,LABORABLE
5,6,2019,2,143,204,347,2019-06-05 01:00:00,2019-05-06 00:00:00,LABORABLE
5,6,2019,3,92,164,256,2019-06-05 02:00:00,2019-05-06 00:00:00,LABORABLE
5,6,2019,4,73,126,199,2019-06-05 03:00:00,2019-05-06 00:00:00,LABORABLE
5,6,2019,5,81,103,184,2019-06-05 04:00:00,2019-05-06 00:00:00,LABORABLE
5,6,2019,6,163,172,335,2019-06-05 05:00:00,2019-05-06 00:00:00,LABORABLE
5,6,2019,7,426,453,879,2019-06-05 06:00:00,2019-05-06 00:00:00,LABORABLE
5,6,2019,8,734,684,1418,2019-06-05 07:00:00,2019-05-06 00:00:00,LABORABLE
5,6,2019,9,661,686,1347,2019-06-05 08:00:00,2019-05-06 00:00:00,LABORABLE
5,6,2019,10,613,698,1311,2019-06-05 09:00:00,2019-05-06 00:00:00,LABORABLE
5,6,2019,11,473,582,1055,2019-06-05 10:00:00,2019-05-06 00:00:00,LABORABLE
5,6,2019,12,558,740,1298,2019-06-05 11:00:00,2019-05-06 00:00:00,LABORABLE
5,6,2019,13,602,773,1375,2019-06-05 12:00:00,2019-05-06 00:00:00,LABORABLE
5,6,2019,14,514,659,1173,2019-06-05 13:00:00,2019-05-06 00:00:00,LABORABLE
5,6,2019,15,687,715,1402,2019-06-05 14:00:00,2019-05-06 00:00:00,LABORABLE
5,6,2019,16,593,696,1289,2019-06-05 15:00:00,2019-05-06 00:00:00,LABORABLE
5,6,2019,17,618,662,1280,2019-06-05 16:00:00,2019-05-06 00:00:00,LABORABLE
5,6,2019,18,667,755,1422,2019-06-05 17:00:00,2019-05-06 00:00:00,LABORABLE
5,6,2019,19,625,724,1349,2019-06-05 18:00:00,2019-05-06 00:00:00,LABORABLE
5,6,2019,20,648,824,1472,2019-06-05 19:00:00,2019-05-06 00:00:00,LABORABLE
5,6,2019,21,644,781,1425,2019-06-05 20:00:00,2019-05-06 00:00:00,LABORABLE
5,6,2019,22,544,630,1174,2019-06-05 21:00:00,2019-05-06 00:00:00,LABORABLE
5,6,2019,23,443,568,1011,2019-06-05 22:00:00,2019-05-06 00:00:00,LABORABLE
5,6,2019,24,283,406,689,2019-06-05 23:00:00,2019-05-06 00:00:00,LABORABLE
6,6,2019,1,212,337,549,2019-06-06 00:00:00,2019-06-06 00:00:00,LABORABLE
6,6,2019,2,135,231,366,2019-06-06 01:00:00,2019-06-06 00:00:00,LABORABLE
6,6,2019,3,120,169,289,2019-06-06 02:00:00,2019-06-06 00:00:00,LABORABLE
6,6,2019,4,76,134,210,2019-06-06 03:00:00,2019-06-06 00:00:00,LABORABLE
6,6,2019,5,103,105,208,2019-06-06 04:00:00,2019-06-06 00:00:00,LABORABLE
6,6,2019,6,170,171,341,2019-06-06 05:00:00,2019-06-06 00:00:00,LABORABLE
6,6,2019,7,426,461,887,2019-06-06 06:00:00,2019-06-06 00:00:00,LABORABLE
6,6,2019,8,691,650,1341,2019-06-06 07:00:00,2019-06-06 00:00:00,LABORABLE
6,6,2019,9,686,702,1388,2019-06-06 08:00:00,2019-06-06 00:00:00,LABORABLE
6,6,2019,10,644,734,1378,2019-06-06 09:00:00,2019-06-06 00:00:00,LABORABLE
6,6,2019,11,569,668,1237,2019-06-06 10:00:00,2019-06-06 00:00:00,LABORABLE
6,6,2019,12,610,789,1399,2019-06-06 11:00:00,2019-06-06 00:00:00,LABORABLE
6,6,2019,13,523,565,1088,2019-06-06 12:00:00,2019-06-06 00:00:00,LABORABLE
6,6,2019,14,672,768,1440,2019-06-06 13:00:00,2019-06-06 00:00:00,LABORABLE
6,6,2019,15,556,627,1183,2019-06-06 14:00:00,2019-06-06 00:00:00,LABORABLE
6,6,2019,16,594,703,1297,2019-06-06 15:00:00,2019-06-06 00:00:00,LABORABLE
6,6,2019,17,604,712,1316,2019-06-06 16:00:00,2019-06-06 00:00:00,LABORABLE
6,6,2019,18,641,767,1408,2019-06-06 17:00:00,2019-06-06 00:00:00,LABORABLE
6,6,2019,19,673,790,1463,2019-06-06 18:00:00,2019-06-06 00:00:00,LABORABLE
6,6,2019,20,683,769,1452,2019-06-06 19:00:00,2019-06-06 00:00:00,LABORABLE
6,6,2019,21,677,793,1470,2019-06-06 20:00:00,2019-06-06 00:00:00,LABORABLE
6,6,2019,22,598,716,1314,2019-06-06 21:00:00,2019-06-06 00:00:00,LABORABLE
6,6,2019,23,492,568,1060,2019-06-06 22:00:00,2019-06-06 00:00:00,LABORABLE
6,6,2019,24,338,430,768,2019-06-06 23:00:00,2019-06-06 00:00:00,LABORABLE
7,6,2019,1,247,366,613,2019-06-07 00:00:00,2019-07-06 00:00:00,LABORABLE
7,6,2019,2,136,280,416,2019-06-07 01:00:00,2019-07-06 00:00:00,LABORABLE
7,6,2019,3,125,195,320,2019-06-07 02:00:00,2019-07-06 00:00:00,LABORABLE
7,6,2019,4,79,137,216,2019-06-07 03:00:00,2019-07-06 00:00:00,LABORABLE
7,6,2019,5,102,139,241,2019-06-07 04:00:00,2019-07-06 00:00:00,LABORABLE
7,6,2019,6,162,207,369,2019-06-07 05:00:00,2019-07-06 00:00:00,LABORABLE
7,6,2019,7,244,439,683,2019-06-07 06:00:00,2019-07-06 00:00:00,LABORABLE
7,6,2019,8,366,651,1017,2019-06-07 07:00:00,2019-07-06 00:00:00,LABORABLE
7,6,2019,9,669,657,1326,2019-06-07 08:00:00,2019-07-06 00:00:00,LABORABLE
7,6,2019,10,622,694,1316,2019-06-07 09:00:00,2019-07-06 00:00:00,LABORABLE
7,6,2019,11,569,692,1261,2019-06-07 10:00:00,2019-07-06 00:00:00,LABORABLE
7,6,2019,12,618,778,1396,2019-06-07 11:00:00,2019-07-06 00:00:00,LABORABLE
7,6,2019,13,625,766,1391,2019-06-07 12:00:00,2019-07-06 00:00:00,LABORABLE
7,6,2019,14,684,762,1446,2019-06-07 13:00:00,2019-07-06 00:00:00,LABORABLE
7,6,2019,15,701,746,1447,2019-06-07 14:00:00,2019-07-06 00:00:00,LABORABLE
7,6,2019,16,624,739,1363,2019-06-07 15:00:00,2019-07-06 00:00:00,LABORABLE
7,6,2019,17,621,745,1366,2019-06-07 16:00:00,2019-07-06 00:00:00,LABORABLE
7,6,2019,18,694,784,1478,2019-06-07 17:00:00,2019-07-06 00:00:00,LABORABLE
7,6,2019,19,720,806,1526,2019-06-07 18:00:00,2019-07-06 00:00:00,LABORABLE
7,6,2019,20,700,864,1564,2019-06-07 19:00:00,2019-07-06 00:00:00,LABORABLE
7,6,2019,21,713,833,1546,2019-06-07 20:00:00,2019-07-06 00:00:00,LABORABLE
7,6,2019,22,622,750,1372,2019-06-07 21:00:00,2019-07-06 00:00:00,LABORABLE
7,6,2019,23,578,691,1269,2019-06-07 22:00:00,2019-07-06 00:00:00,LABORABLE
7,6,2019,24,446,625,1071,2019-06-07 23:00:00,2019-07-06 00:00:00,LABORABLE
8,6,2019,1,348,469,817,2019-06-08 00:00:00,2019-08-06 00:00:00,LABORABLE
8,6,2019,2,266,374,640,2019-06-08 01:00:00,2019-08-06 00:00:00,LABORABLE
8,6,2019,3,184,356,540,2019-06-08 02:00:00,2019-08-06 00:00:00,LABORABLE
8,6,2019,4,183,295,478,2019-06-08 03:00:00,2019-08-06 00:00:00,LABORABLE
8,6,2019,5,149,234,383,2019-06-08 04:00:00,2019-08-06 00:00:00,LABORABLE
8,6,2019,6,152,213,365,2019-06-08 05:00:00,2019-08-06 00:00:00,LABORABLE
8,6,2019,7,243,279,522,2019-06-08 06:00:00,2019-08-06 00:00:00,LABORABLE
8,6,2019,8,304,318,622,2019-06-08 07:00:00,2019-08-06 00:00:00,LABORABLE
8,6,2019,9,414,405,819,2019-06-08 08:00:00,2019-08-06 00:00:00,LABORABLE
8,6,2019,10,464,534,998,2019-06-08 09:00:00,2019-08-06 00:00:00,LABORABLE
8,6,2019,11,544,659,1203,2019-06-08 10:00:00,2019-08-06 00:00:00,LABORABLE
8,6,2019,12,585,726,1311,2019-06-08 11:00:00,2019-08-06 00:00:00,LABORABLE
8,6,2019,13,580,713,1293,2019-06-08 12:00:00,2019-08-06 00:00:00,LABORABLE
8,6,2019,14,579,778,1357,2019-06-08 13:00:00,2019-08-06 00:00:00,LABORABLE
8,6,2019,15,613,752,1365,2019-06-08 14:00:00,2019-08-06 00:00:00,LABORABLE
8,6,2019,16,484,689,1173,2019-06-08 15:00:00,2019-08-06 00:00:00,LABORABLE
8,6,2019,17,458,689,1147,2019-06-08 16:00:00,2019-08-06 00:00:00,LABORABLE
8,6,2019,18,562,753,1315,2019-06-08 17:00:00,2019-08-06 00:00:00,LABORABLE
8,6,2019,19,613,736,1349,2019-06-08 18:00:00,2019-08-06 00:00:00,LABORABLE
8,6,2019,20,574,756,1330,2019-06-08 19:00:00,2019-08-06 00:00:00,LABORABLE
8,6,2019,21,567,721,1288,2019-06-08 20:00:00,2019-08-06 00:00:00,LABORABLE
8,6,2019,22,608,689,1297,2019-06-08 21:00:00,2019-08-06 00:00:00,LABORABLE
8,6,2019,23,564,640,1204,2019-06-08 22:00:00,2019-08-06 00:00:00,LABORABLE
8,6,2019,24,472,586,1058,2019-06-08 23:00:00,2019-08-06 00:00:00,LABORABLE
9,6,2019,1,385,540,925,2019-06-09 00:00:00,2019-09-06 00:00:00,LABORABLE
9,6,2019,2,339,431,770,2019-06-09 01:00:00,2019-09-06 00:00:00,LABORABLE
9,6,2019,3,258,367,625,2019-06-09 02:00:00,2019-09-06 00:00:00,LABORABLE
9,6,2019,4,200,314,514,2019-06-09 03:00:00,2019-09-06 00:00:00,LABORABLE
9,6,2019,5,165,264,429,2019-06-09 04:00:00,2019-09-06 00:00:00,LABORABLE
9,6,2019,6,172,273,445,2019-06-09 05:00:00,2019-09-06 00:00:00,LABORABLE
9,6,2019,7,195,278,473,2019-06-09 06:00:00,2019-09-06 00:00:00,LABORABLE
9,6,2019,8,205,265,470,2019-06-09 07:00:00,2019-09-06 00:00:00,LABORABLE
9,6,2019,9,235,268,503,2019-06-09 08:00:00,2019-09-06 00:00:00,LABORABLE
9,6,2019,10,341,389,730,2019-06-09 09:00:00,2019-09-06 00:00:00,LABORABLE
9,6,2019,11,427,479,906,2019-06-09 10:00:00,2019-09-06 00:00:00,LABORABLE
9,6,2019,12,458,584,1042,2019-06-09 11:00:00,2019-09-06 00:00:00,LABORABLE
9,6,2019,13,561,572,1133,2019-06-09 12:00:00,2019-09-06 00:00:00,LABORABLE
9,6,2019,14,601,658,1259,2019-06-09 13:00:00,2019-09-06 00:00:00,LABORABLE
9,6,2019,15,560,670,1230,2019-06-09 14:00:00,2019-09-06 00:00:00,LABORABLE
9,6,2019,16,440,605,1045,2019-06-09 15:00:00,2019-09-06 00:00:00,LABORABLE
9,6,2019,17,473,630,1103,2019-06-09 16:00:00,2019-09-06 00:00:00,LABORABLE
9,6,2019,18,497,657,1154,2019-06-09 17:00:00,2019-09-06 00:00:00,LABORABLE
9,6,2019,19,510,656,1166,2019-06-09 18:00:00,2019-09-06 00:00:00,LABORABLE
9,6,2019,20,574,666,1240,2019-06-09 19:00:00,2019-09-06 00:00:00,LABORABLE
9,6,2019,21,535,666,1201,2019-06-09 20:00:00,2019-09-06 00:00:00,LABORABLE
9,6,2019,22,549,651,1200,2019-06-09 21:00:00,2019-09-06 00:00:00,LABORABLE
9,6,2019,23,495,561,1056,2019-06-09 22:00:00,2019-09-06 00:00:00,LABORABLE
9,6,2019,24,310,462,772,2019-06-09 23:00:00,2019-09-06 00:00:00,LABORABLE
10,6,2019,1,248,323,571,2019-06-10 00:00:00,2019-10-06 00:00:00,LABORABLE
10,6,2019,2,148,224,372,2019-06-10 01:00:00,2019-10-06 00:00:00,LABORABLE
10,6,2019,3,111,150,261,2019-06-10 02:00:00,2019-10-06 00:00:00,LABORABLE
10,6,2019,4,90,127,217,2019-06-10 03:00:00,2019-10-06 00:00:00,LABORABLE
10,6,2019,5,93,118,211,2019-06-10 04:00:00,2019-10-06 00:00:00,LABORABLE
10,6,2019,6,115,168,283,2019-06-10 05:00:00,2019-10-06 00:00:00,LABORABLE
10,6,2019,7,301,456,757,2019-06-10 06:00:00,2019-10-06 00:00:00,LABORABLE
10,6,2019,8,683,638,1321,2019-06-10 07:00:00,2019-10-06 00:00:00,LABORABLE
10,6,2019,9,714,670,1384,2019-06-10 08:00:00,2019-10-06 00:00:00,LABORABLE
10,6,2019,10,601,736,1337,2019-06-10 09:00:00,2019-10-06 00:00:00,LABORABLE
10,6,2019,11,531,685,1216,2019-06-10 10:00:00,2019-10-06 00:00:00,LABORABLE
10,6,2019,12,608,726,1334,2019-06-10 11:00:00,2019-10-06 00:00:00,LABORABLE
10,6,2019,13,584,740,1324,2019-06-10 12:00:00,2019-10-06 00:00:00,LABORABLE
10,6,2019,14,536,618,1154,2019-06-10 13:00:00,2019-10-06 00:00:00,LABORABLE
10,6,2019,15,684,716,1400,2019-06-10 14:00:00,2019-10-06 00:00:00,LABORABLE
10,6,2019,16,601,646,1247,2019-06-10 15:00:00,2019-10-06 00:00:00,LABORABLE
10,6,2019,17,612,715,1327,2019-06-10 16:00:00,2019-10-06 00:00:00,LABORABLE
10,6,2019,18,644,732,1376,2019-06-10 17:00:00,2019-10-06 00:00:00,LABORABLE
10,6,2019,19,651,755,1406,2019-06-10 18:00:00,2019-10-06 00:00:00,LABORABLE
10,6,2019,20,647,736,1383,2019-06-10 19:00:00,2019-10-06 00:00:00,LABORABLE
10,6,2019,21,608,718,1326,2019-06-10 20:00:00,2019-10-06 00:00:00,LABORABLE
10,6,2019,22,508,647,1155,2019-06-10 21:00:00,2019-10-06 00:00:00,LABORABLE
10,6,2019,23,427,520,947,2019-06-10 22:00:00,2019-10-06 00:00:00,LABORABLE
10,6,2019,24,312,342,654,2019-06-10 23:00:00,2019-10-06 00:00:00,LABORABLE
11,6,2019,1,171,259,430,2019-06-11 00:00:00,2019-11-06 00:00:00,LABORABLE
11,6,2019,2,146,192,338,2019-06-11 01:00:00,2019-11-06 00:00:00,LABORABLE
11,6,2019,3,84,125,209,2019-06-11 02:00:00,2019-11-06 00:00:00,LABORABLE
11,6,2019,4,79,108,187,2019-06-11 03:00:00,2019-11-06 00:00:00,LABORABLE
11,6,2019,5,79,102,181,2019-06-11 04:00:00,2019-11-06 00:00:00,LABORABLE
11,6,2019,6,159,164,323,2019-06-11 05:00:00,2019-11-06 00:00:00,LABORABLE
11,6,2019,7,436,426,862,2019-06-11 06:00:00,2019-11-06 00:00:00,LABORABLE
11,6,2019,8,671,631,1302,2019-06-11 07:00:00,2019-11-06 00:00:00,LABORABLE
11,6,2019,9,680,702,1382,2019-06-11 08:00:00,2019-11-06 00:00:00,LABORABLE
11,6,2019,10,642,731,1373,2019-06-11 09:00:00,2019-11-06 00:00:00,LABORABLE
11,6,2019,11,520,703,1223,2019-06-11 10:00:00,2019-11-06 00:00:00,LABORABLE
11,6,2019,12,557,675,1232,2019-06-11 11:00:00,2019-11-06 00:00:00,LABORABLE
11,6,2019,13,677,748,1425,2019-06-11 12:00:00,2019-11-06 00:00:00,LABORABLE
11,6,2019,14,647,770,1417,2019-06-11 13:00:00,2019-11-06 00:00:00,LABORABLE
11,6,2019,15,673,736,1409,2019-06-11 14:00:00,2019-11-06 00:00:00,LABORABLE
11,6,2019,16,611,634,1245,2019-06-11 15:00:00,2019-11-06 00:00:00,LABORABLE
11,6,2019,17,582,707,1289,2019-06-11 16:00:00,2019-11-06 00:00:00,LABORABLE
11,6,2019,18,631,786,1417,2019-06-11 17:00:00,2019-11-06 00:00:00,LABORABLE
11,6,2019,19,609,745,1354,2019-06-11 18:00:00,2019-11-06 00:00:00,LABORABLE
11,6,2019,20,611,811,1422,2019-06-11 19:00:00,2019-11-06 00:00:00,LABORABLE
11,6,2019,21,647,782,1429,2019-06-11 20:00:00,2019-11-06 00:00:00,LABORABLE
11,6,2019,22,564,679,1243,2019-06-11 21:00:00,2019-11-06 00:00:00,LABORABLE
11,6,2019,23,442,525,967,2019-06-11 22:00:00,2019-11-06 00:00:00,LABORABLE
11,6,2019,24,284,395,679,2019-06-11 23:00:00,2019-11-06 00:00:00,LABORABLE
12,6,2019,1,191,286,477,2019-06-12 00:00:00,2019-12-06 00:00:00,LABORABLE
12,6,2019,2,125,208,333,2019-06-12 01:00:00,2019-12-06 00:00:00,LABORABLE
12,6,2019,3,79,153,232,2019-06-12 02:00:00,2019-12-06 00:00:00,LABORABLE
12,6,2019,4,76,98,174,2019-06-12 03:00:00,2019-12-06 00:00:00,LABORABLE
12,6,2019,5,71,99,170,2019-06-12 04:00:00,2019-12-06 00:00:00,LABORABLE
12,6,2019,6,172,145,317,2019-06-12 05:00:00,2019-12-06 00:00:00,LABORABLE
12,6,2019,7,436,415,851,2019-06-12 06:00:00,2019-12-06 00:00:00,LABORABLE
12,6,2019,8,702,633,1335,2019-06-12 07:00:00,2019-12-06 00:00:00,LABORABLE
12,6,2019,9,675,688,1363,2019-06-12 08:00:00,2019-12-06 00:00:00,LABORABLE
12,6,2019,10,624,710,1334,2019-06-12 09:00:00,2019-12-06 00:00:00,LABORABLE
12,6,2019,11,550,685,1235,2019-06-12 10:00:00,2019-12-06 00:00:00,LABORABLE
12,6,2019,12,575,677,1252,2019-06-12 11:00:00,2019-12-06 00:00:00,LABORABLE
12,6,2019,13,605,718,1323,2019-06-12 12:00:00,2019-12-06 00:00:00,LABORABLE
12,6,2019,14,664,755,1419,2019-06-12 13:00:00,2019-12-06 00:00:00,LABORABLE
12,6,2019,15,641,740,1381,2019-06-12 14:00:00,2019-12-06 00:00:00,LABORABLE
12,6,2019,16,596,691,1287,2019-06-12 15:00:00,2019-12-06 00:00:00,LABORABLE
12,6,2019,17,611,745,1356,2019-06-12 16:00:00,2019-12-06 00:00:00,LABORABLE
12,6,2019,18,667,692,1359,2019-06-12 17:00:00,2019-12-06 00:00:00,LABORABLE
12,6,2019,19,655,757,1412,2019-06-12 18:00:00,2019-12-06 00:00:00,LABORABLE
12,6,2019,20,589,735,1324,2019-06-12 19:00:00,2019-12-06 00:00:00,LABORABLE
12,6,2019,21,656,773,1429,2019-06-12 20:00:00,2019-12-06 00:00:00,LABORABLE
12,6,2019,22,565,616,1181,2019-06-12 21:00:00,2019-12-06 00:00:00,LABORABLE
12,6,2019,23,473,484,957,2019-06-12 22:00:00,2019-12-06 00:00:00,LABORABLE
12,6,2019,24,313,440,753,2019-06-12 23:00:00,2019-12-06 00:00:00,LABORABLE
13,6,2019,1,239,327,566,2019-06-13 00:00:00,2019-06-13 00:00:00,LABORABLE
13,6,2019,2,141,236,377,2019-06-13 01:00:00,2019-06-13 00:00:00,LABORABLE
13,6,2019,3,89,166,255,2019-06-13 02:00:00,2019-06-13 00:00:00,LABORABLE
13,6,2019,4,90,140,230,2019-06-13 03:00:00,2019-06-13 00:00:00,LABORABLE
13,6,2019,5,105,107,212,2019-06-13 04:00:00,2019-06-13 00:00:00,LABORABLE
13,6,2019,6,161,185,346,2019-06-13 05:00:00,2019-06-13 00:00:00,LABORABLE
13,6,2019,7,442,448,890,2019-06-13 06:00:00,2019-06-13 00:00:00,LABORABLE
13,6,2019,8,664,619,1283,2019-06-13 07:00:00,2019-06-13 00:00:00,LABORABLE
13,6,2019,9,709,758,1467,2019-06-13 08:00:00,2019-06-13 00:00:00,LABORABLE
13,6,2019,10,672,695,1367,2019-06-13 09:00:00,2019-06-13 00:00:00,LABORABLE
13,6,2019,11,547,645,1192,2019-06-13 10:00:00,2019-06-13 00:00:00,LABORABLE
13,6,2019,12,578,685,1263,2019-06-13 11:00:00,2019-06-13 00:00:00,LABORABLE
13,6,2019,13,668,736,1404,2019-06-13 12:00:00,2019-06-13 00:00:00,LABORABLE
13,6,2019,14,648,791,1439,2019-06-13 13:00:00,2019-06-13 00:00:00,LABORABLE
13,6,2019,15,637,771,1408,2019-06-13 14:00:00,2019-06-13 00:00:00,LABORABLE
13,6,2019,16,624,674,1298,2019-06-13 15:00:00,2019-06-13 00:00:00,LABORABLE
13,6,2019,17,586,689,1275,2019-06-13 16:00:00,2019-06-13 00:00:00,LABORABLE
13,6,2019,18,722,759,1481,2019-06-13 17:00:00,2019-06-13 00:00:00,LABORABLE
13,6,2019,19,688,788,1476,2019-06-13 18:00:00,2019-06-13 00:00:00,LABORABLE
13,6,2019,20,661,782,1443,2019-06-13 19:00:00,2019-06-13 00:00:00,LABORABLE
13,6,2019,21,690,795,1485,2019-06-13 20:00:00,2019-06-13 00:00:00,LABORABLE
13,6,2019,22,599,692,1291,2019-06-13 21:00:00,2019-06-13 00:00:00,LABORABLE
13,6,2019,23,502,558,1060,2019-06-13 22:00:00,2019-06-13 00:00:00,LABORABLE
13,6,2019,24,330,387,717,2019-06-13 23:00:00,2019-06-13 00:00:00,LABORABLE
14,6,2019,1,240,389,629,2019-06-14 00:00:00,2019-06-14 00:00:00,LABORABLE
14,6,2019,2,152,303,455,2019-06-14 01:00:00,2019-06-14 00:00:00,LABORABLE
14,6,2019,3,117,185,302,2019-06-14 02:00:00,2019-06-14 00:00:00,LABORABLE
14,6,2019,4,94,141,235,2019-06-14 03:00:00,2019-06-14 00:00:00,LABORABLE
14,6,2019,5,96,115,211,2019-06-14 04:00:00,2019-06-14 00:00:00,LABORABLE
14,6,2019,6,179,184,363,2019-06-14 05:00:00,2019-06-14 00:00:00,LABORABLE
14,6,2019,7,244,326,570,2019-06-14 06:00:00,2019-06-14 00:00:00,LABORABLE
14,6,2019,8,366,587,953,2019-06-14 07:00:00,2019-06-14 00:00:00,LABORABLE
14,6,2019,9,654,698,1352,2019-06-14 08:00:00,2019-06-14 00:00:00,LABORABLE
14,6,2019,10,628,727,1355,2019-06-14 09:00:00,2019-06-14 00:00:00,LABORABLE
14,6,2019,11,576,626,1202,2019-06-14 10:00:00,2019-06-14 00:00:00,LABORABLE
14,6,2019,12,611,723,1334,2019-06-14 11:00:00,2019-06-14 00:00:00,LABORABLE
14,6,2019,13,659,774,1433,2019-06-14 12:00:00,2019-06-14 00:00:00,LABORABLE
14,6,2019,14,649,766,1415,2019-06-14 13:00:00,2019-06-14 00:00:00,LABORABLE
14,6,2019,15,700,728,1428,2019-06-14 14:00:00,2019-06-14 00:00:00,LABORABLE
14,6,2019,16,654,726,1380,2019-06-14 15:00:00,2019-06-14 00:00:00,LABORABLE
14,6,2019,17,478,714,1192,2019-06-14 16:00:00,2019-06-14 00:00:00,LABORABLE
14,6,2019,18,654,723,1377,2019-06-14 17:00:00,2019-06-14 00:00:00,LABORABLE
14,6,2019,19,731,799,1530,2019-06-14 18:00:00,2019-06-14 00:00:00,LABORABLE
14,6,2019,20,600,773,1373,2019-06-14 19:00:00,2019-06-14 00:00:00,LABORABLE
14,6,2019,21,671,822,1493,2019-06-14 20:00:00,2019-06-14 00:00:00,LABORABLE
14,6,2019,22,644,748,1392,2019-06-14 21:00:00,2019-06-14 00:00:00,LABORABLE
14,6,2019,23,596,673,1269,2019-06-14 22:00:00,2019-06-14 00:00:00,LABORABLE
14,6,2019,24,414,575,989,2019-06-14 23:00:00,2019-06-14 00:00:00,LABORABLE
15,6,2019,1,302,483,785,2019-06-15 00:00:00,2019-06-15 00:00:00,LABORABLE
15,6,2019,2,268,351,619,2019-06-15 01:00:00,2019-06-15 00:00:00,LABORABLE
15,6,2019,3,177,344,521,2019-06-15 02:00:00,2019-06-15 00:00:00,LABORABLE
15,6,2019,4,160,221,381,2019-06-15 03:00:00,2019-06-15 00:00:00,LABORABLE
15,6,2019,5,123,218,341,2019-06-15 04:00:00,2019-06-15 00:00:00,LABORABLE
15,6,2019,6,141,192,333,2019-06-15 05:00:00,2019-06-15 00:00:00,LABORABLE
15,6,2019,7,215,268,483,2019-06-15 06:00:00,2019-06-15 00:00:00,LABORABLE
15,6,2019,8,289,333,622,2019-06-15 07:00:00,2019-06-15 00:00:00,LABORABLE
15,6,2019,9,367,372,739,2019-06-15 08:00:00,2019-06-15 00:00:00,LABORABLE
15,6,2019,10,467,536,1003,2019-06-15 09:00:00,2019-06-15 00:00:00,LABORABLE
15,6,2019,11,545,593,1138,2019-06-15 10:00:00,2019-06-15 00:00:00,LABORABLE
15,6,2019,12,629,728,1357,2019-06-15 11:00:00,2019-06-15 00:00:00,LABORABLE
15,6,2019,13,635,722,1357,2019-06-15 12:00:00,2019-06-15 00:00:00,LABORABLE
15,6,2019,14,623,823,1446,2019-06-15 13:00:00,2019-06-15 00:00:00,LABORABLE
15,6,2019,15,625,797,1422,2019-06-15 14:00:00,2019-06-15 00:00:00,LABORABLE
15,6,2019,16,515,698,1213,2019-06-15 15:00:00,2019-06-15 00:00:00,LABORABLE
15,6,2019,17,479,750,1229,2019-06-15 16:00:00,2019-06-15 00:00:00,LABORABLE
15,6,2019,18,569,682,1251,2019-06-15 17:00:00,2019-06-15 00:00:00,LABORABLE
15,6,2019,19,549,700,1249,2019-06-15 18:00:00,2019-06-15 00:00:00,LABORABLE
15,6,2019,20,618,664,1282,2019-06-15 19:00:00,2019-06-15 00:00:00,LABORABLE
15,6,2019,21,521,697,1218,2019-06-15 20:00:00,2019-06-15 00:00:00,LABORABLE
15,6,2019,22,533,707,1240,2019-06-15 21:00:00,2019-06-15 00:00:00,LABORABLE
15,6,2019,23,552,659,1211,2019-06-15 22:00:00,2019-06-15 00:00:00,LABORABLE
15,6,2019,24,457,645,1102,2019-06-15 23:00:00,2019-06-15 00:00:00,LABORABLE
16,6,2019,1,398,553,951,2019-06-16 00:00:00,2019-06-16 00:00:00,LABORABLE
16,6,2019,2,320,465,785,2019-06-16 01:00:00,2019-06-16 00:00:00,LABORABLE
16,6,2019,3,274,398,672,2019-06-16 02:00:00,2019-06-16 00:00:00,LABORABLE
16,6,2019,4,209,366,575,2019-06-16 03:00:00,2019-06-16 00:00:00,LABORABLE
16,6,2019,5,170,261,431,2019-06-16 04:00:00,2019-06-16 00:00:00,LABORABLE
16,6,2019,6,172,264,436,2019-06-16 05:00:00,2019-06-16 00:00:00,LABORABLE
16,6,2019,7,211,295,506,2019-06-16 06:00:00,2019-06-16 00:00:00,LABORABLE
16,6,2019,8,215,252,467,2019-06-16 07:00:00,2019-06-16 00:00:00,LABORABLE
16,6,2019,9,242,317,559,2019-06-16 08:00:00,2019-06-16 00:00:00,LABORABLE
16,6,2019,10,333,404,737,2019-06-16 09:00:00,2019-06-16 00:00:00,LABORABLE
16,6,2019,11,421,491,912,2019-06-16 10:00:00,2019-06-16 00:00:00,LABORABLE
16,6,2019,12,516,579,1095,2019-06-16 11:00:00,2019-06-16 00:00:00,LABORABLE
16,6,2019,13,505,620,1125,2019-06-16 12:00:00,2019-06-16 00:00:00,LABORABLE
16,6,2019,14,560,671,1231,2019-06-16 13:00:00,2019-06-16 00:00:00,LABORABLE
16,6,2019,15,523,716,1239,2019-06-16 14:00:00,2019-06-16 00:00:00,LABORABLE
16,6,2019,16,473,623,1096,2019-06-16 15:00:00,2019-06-16 00:00:00,LABORABLE
16,6,2019,17,413,647,1060,2019-06-16 16:00:00,2019-06-16 00:00:00,LABORABLE
16,6,2019,18,497,645,1142,2019-06-16 17:00:00,2019-06-16 00:00:00,LABORABLE
16,6,2019,19,500,636,1136,2019-06-16 18:00:00,2019-06-16 00:00:00,LABORABLE
16,6,2019,20,509,650,1159,2019-06-16 19:00:00,2019-06-16 00:00:00,LABORABLE
16,6,2019,21,572,733,1305,2019-06-16 20:00:00,2019-06-16 00:00:00,LABORABLE
16,6,2019,22,554,687,1241,2019-06-16 21:00:00,2019-06-16 00:00:00,LABORABLE
16,6,2019,23,510,573,1083,2019-06-16 22:00:00,2019-06-16 00:00:00,LABORABLE
16,6,2019,24,350,396,746,2019-06-16 23:00:00,2019-06-16 00:00:00,LABORABLE
17,6,2019,1,239,323,562,2019-06-17 00:00:00,2019-06-17 00:00:00,LABORABLE
17,6,2019,2,120,249,369,2019-06-17 01:00:00,2019-06-17 00:00:00,LABORABLE
17,6,2019,3,101,207,308,2019-06-17 02:00:00,2019-06-17 00:00:00,LABORABLE
17,6,2019,4,87,136,223,2019-06-17 03:00:00,2019-06-17 00:00:00,LABORABLE
17,6,2019,5,79,125,204,2019-06-17 04:00:00,2019-06-17 00:00:00,LABORABLE
17,6,2019,6,115,179,294,2019-06-17 05:00:00,2019-06-17 00:00:00,LABORABLE
17,6,2019,7,301,432,733,2019-06-17 06:00:00,2019-06-17 00:00:00,LABORABLE
17,6,2019,8,678,648,1326,2019-06-17 07:00:00,2019-06-17 00:00:00,LABORABLE
17,6,2019,9,654,667,1321,2019-06-17 08:00:00,2019-06-17 00:00:00,LABORABLE
17,6,2019,10,609,740,1349,2019-06-17 09:00:00,2019-06-17 00:00:00,LABORABLE
17,6,2019,11,467,515,982,2019-06-17 10:00:00,2019-06-17 00:00:00,LABORABLE
17,6,2019,12,592,710,1302,2019-06-17 11:00:00,2019-06-17 00:00:00,LABORABLE
17,6,2019,13,624,733,1357,2019-06-17 12:00:00,2019-06-17 00:00:00,LABORABLE
17,6,2019,14,627,797,1424,2019-06-17 13:00:00,2019-06-17 00:00:00,LABORABLE
17,6,2019,15,677,707,1384,2019-06-17 14:00:00,2019-06-17 00:00:00,LABORABLE
17,6,2019,16,642,612,1254,2019-06-17 15:00:00,2019-06-17 00:00:00,LABORABLE
17,6,2019,17,545,687,1232,2019-06-17 16:00:00,2019-06-17 00:00:00,LABORABLE
17,6,2019,18,648,742,1390,2019-06-17 17:00:00,2019-06-17 00:00:00,LABORABLE
17,6,2019,19,631,776,1407,2019-06-17 18:00:00,2019-06-17 00:00:00,LABORABLE
17,6,2019,20,639,741,1380,2019-06-17 19:00:00,2019-06-17 00:00:00,LABORABLE
17,6,2019,21,605,787,1392,2019-06-17 20:00:00,2019-06-17 00:00:00,LABORABLE
17,6,2019,22,546,584,1130,2019-06-17 21:00:00,2019-06-17 00:00:00,LABORABLE
17,6,2019,23,397,497,894,2019-06-17 22:00:00,2019-06-17 00:00:00,LABORABLE
17,6,2019,24,283,356,639,2019-06-17 23:00:00,2019-06-17 00:00:00,LABORABLE
18,6,2019,1,170,257,427,2019-06-18 00:00:00,2019-06-18 00:00:00,LABORABLE
18,6,2019,2,104,179,283,2019-06-18 01:00:00,2019-06-18 00:00:00,LABORABLE
18,6,2019,3,89,105,194,2019-06-18 02:00:00,2019-06-18 00:00:00,LABORABLE
18,6,2019,4,76,91,167,2019-06-18 03:00:00,2019-06-18 00:00:00,LABORABLE
18,6,2019,5,88,97,185,2019-06-18 04:00:00,2019-06-18 00:00:00,LABORABLE
18,6,2019,6,152,170,322,2019-06-18 05:00:00,2019-06-18 00:00:00,LABORABLE
18,6,2019,7,435,392,827,2019-06-18 06:00:00,2019-06-18 00:00:00,LABORABLE
18,6,2019,8,655,583,1238,2019-06-18 07:00:00,2019-06-18 00:00:00,LABORABLE
18,6,2019,9,666,679,1345,2019-06-18 08:00:00,2019-06-18 00:00:00,LABORABLE
18,6,2019,10,627,730,1357,2019-06-18 09:00:00,2019-06-18 00:00:00,LABORABLE
18,6,2019,11,531,698,1229,2019-06-18 10:00:00,2019-06-18 00:00:00,LABORABLE
18,6,2019,12,535,707,1242,2019-06-18 11:00:00,2019-06-18 00:00:00,LABORABLE
18,6,2019,13,613,880,1493,2019-06-18 12:00:00,2019-06-18 00:00:00,LABORABLE
18,6,2019,14,643,818,1461,2019-06-18 13:00:00,2019-06-18 00:00:00,LABORABLE
18,6,2019,15,655,728,1383,2019-06-18 14:00:00,2019-06-18 00:00:00,LABORABLE
18,6,2019,16,610,666,1276,2019-06-18 15:00:00,2019-06-18 00:00:00,LABORABLE
18,6,2019,17,575,689,1264,2019-06-18 16:00:00,2019-06-18 00:00:00,LABORABLE
18,6,2019,18,630,744,1374,2019-06-18 17:00:00,2019-06-18 00:00:00,LABORABLE
18,6,2019,19,609,790,1399,2019-06-18 18:00:00,2019-06-18 00:00:00,LABORABLE
18,6,2019,20,594,804,1398,2019-06-18 19:00:00,2019-06-18 00:00:00,LABORABLE
18,6,2019,21,606,741,1347,2019-06-18 20:00:00,2019-06-18 00:00:00,LABORABLE
18,6,2019,22,527,642,1169,2019-06-18 21:00:00,2019-06-18 00:00:00,LABORABLE
18,6,2019,23,422,528,950,2019-06-18 22:00:00,2019-06-18 00:00:00,LABORABLE
18,6,2019,24,346,380,726,2019-06-18 23:00:00,2019-06-18 00:00:00,LABORABLE
19,6,2019,1,217,305,522,2019-06-19 00:00:00,2019-06-19 00:00:00,LABORABLE
19,6,2019,2,127,202,329,2019-06-19 01:00:00,2019-06-19 00:00:00,LABORABLE
19,6,2019,3,83,153,236,2019-06-19 02:00:00,2019-06-19 00:00:00,LABORABLE
19,6,2019,4,89,118,207,2019-06-19 03:00:00,2019-06-19 00:00:00,LABORABLE
19,6,2019,5,85,106,191,2019-06-19 04:00:00,2019-06-19 00:00:00,LABORABLE
19,6,2019,6,147,179,326,2019-06-19 05:00:00,2019-06-19 00:00:00,LABORABLE
19,6,2019,7,442,451,893,2019-06-19 06:00:00,2019-06-19 00:00:00,LABORABLE
19,6,2019,8,681,658,1339,2019-06-19 07:00:00,2019-06-19 00:00:00,LABORABLE
19,6,2019,9,705,725,1430,2019-06-19 08:00:00,2019-06-19 00:00:00,LABORABLE
19,6,2019,10,603,645,1248,2019-06-19 09:00:00,2019-06-19 00:00:00,LABORABLE
19,6,2019,11,495,534,1029,2019-06-19 10:00:00,2019-06-19 00:00:00,LABORABLE
19,6,2019,12,551,726,1277,2019-06-19 11:00:00,2019-06-19 00:00:00,LABORABLE
19,6,2019,13,587,771,1358,2019-06-19 12:00:00,2019-06-19 00:00:00,LABORABLE
19,6,2019,14,609,741,1350,2019-06-19 13:00:00,2019-06-19 00:00:00,LABORABLE
19,6,2019,15,647,738,1385,2019-06-19 14:00:00,2019-06-19 00:00:00,LABORABLE
19,6,2019,16,622,671,1293,2019-06-19 15:00:00,2019-06-19 00:00:00,LABORABLE
19,6,2019,17,599,703,1302,2019-06-19 16:00:00,2019-06-19 00:00:00,LABORABLE
19,6,2019,18,605,714,1319,2019-06-19 17:00:00,2019-06-19 00:00:00,LABORABLE
19,6,2019,19,671,758,1429,2019-06-19 18:00:00,2019-06-19 00:00:00,LABORABLE
19,6,2019,20,666,779,1445,2019-06-19 19:00:00,2019-06-19 00:00:00,LABORABLE
19,6,2019,21,605,706,1311,2019-06-19 20:00:00,2019-06-19 00:00:00,LABORABLE
19,6,2019,22,553,644,1197,2019-06-19 21:00:00,2019-06-19 00:00:00,LABORABLE
19,6,2019,23,431,479,910,2019-06-19 22:00:00,2019-06-19 00:00:00,LABORABLE
19,6,2019,24,324,434,758,2019-06-19 23:00:00,2019-06-19 00:00:00,LABORABLE
20,6,2019,1,215,333,548,2019-06-20 00:00:00,2019-06-20 00:00:00,LABORABLE
20,6,2019,2,175,209,384,2019-06-20 01:00:00,2019-06-20 00:00:00,LABORABLE
20,6,2019,3,106,187,293,2019-06-20 02:00:00,2019-06-20 00:00:00,LABORABLE
20,6,2019,4,93,142,235,2019-06-20 03:00:00,2019-06-20 00:00:00,LABORABLE
20,6,2019,5,80,118,198,2019-06-20 04:00:00,2019-06-20 00:00:00,LABORABLE
20,6,2019,6,174,164,338,2019-06-20 05:00:00,2019-06-20 00:00:00,LABORABLE
20,6,2019,7,434,447,881,2019-06-20 06:00:00,2019-06-20 00:00:00,LABORABLE
20,6,2019,8,643,647,1290,2019-06-20 07:00:00,2019-06-20 00:00:00,LABORABLE
20,6,2019,9,647,669,1316,2019-06-20 08:00:00,2019-06-20 00:00:00,LABORABLE
20,6,2019,10,632,750,1382,2019-06-20 09:00:00,2019-06-20 00:00:00,LABORABLE
20,6,2019,11,599,689,1288,2019-06-20 10:00:00,2019-06-20 00:00:00,LABORABLE
20,6,2019,12,570,705,1275,2019-06-20 11:00:00,2019-06-20 00:00:00,LABORABLE
20,6,2019,13,604,735,1339,2019-06-20 12:00:00,2019-06-20 00:00:00,LABORABLE
20,6,2019,14,597,740,1337,2019-06-20 13:00:00,2019-06-20 00:00:00,LABORABLE
20,6,2019,15,541,646,1187,2019-06-20 14:00:00,2019-06-20 00:00:00,LABORABLE
20,6,2019,16,659,769,1428,2019-06-20 15:00:00,2019-06-20 00:00:00,LABORABLE
20,6,2019,17,505,622,1127,2019-06-20 16:00:00,2019-06-20 00:00:00,LABORABLE
20,6,2019,18,670,742,1412,2019-06-20 17:00:00,2019-06-20 00:00:00,LABORABLE
20,6,2019,19,670,767,1437,2019-06-20 18:00:00,2019-06-20 00:00:00,LABORABLE
20,6,2019,20,635,811,1446,2019-06-20 19:00:00,2019-06-20 00:00:00,LABORABLE
20,6,2019,21,684,764,1448,2019-06-20 20:00:00,2019-06-20 00:00:00,LABORABLE
20,6,2019,22,513,607,1120,2019-06-20 21:00:00,2019-06-20 00:00:00,LABORABLE
20,6,2019,23,497,526,1023,2019-06-20 22:00:00,2019-06-20 00:00:00,LABORABLE
20,6,2019,24,337,434,771,2019-06-20 23:00:00,2019-06-20 00:00:00,LABORABLE
21,6,2019,1,216,341,557,2019-06-21 00:00:00,2019-06-21 00:00:00,LABORABLE
21,6,2019,2,179,274,453,2019-06-21 01:00:00,2019-06-21 00:00:00,LABORABLE
21,6,2019,3,74,215,289,2019-06-21 02:00:00,2019-06-21 00:00:00,LABORABLE
21,6,2019,4,86,146,232,2019-06-21 03:00:00,2019-06-21 00:00:00,LABORABLE
21,6,2019,5,85,100,185,2019-06-21 04:00:00,2019-06-21 00:00:00,LABORABLE
21,6,2019,6,169,177,346,2019-06-21 05:00:00,2019-06-21 00:00:00,LABORABLE
21,6,2019,7,244,311,555,2019-06-21 06:00:00,2019-06-21 00:00:00,LABORABLE
21,6,2019,8,366,626,992,2019-06-21 07:00:00,2019-06-21 00:00:00,LABORABLE
21,6,2019,9,632,656,1288,2019-06-21 08:00:00,2019-06-21 00:00:00,LABORABLE
21,6,2019,10,650,702,1352,2019-06-21 09:00:00,2019-06-21 00:00:00,LABORABLE
21,6,2019,11,571,642,1213,2019-06-21 10:00:00,2019-06-21 00:00:00,LABORABLE
21,6,2019,12,585,730,1315,2019-06-21 11:00:00,2019-06-21 00:00:00,LABORABLE
21,6,2019,13,458,684,1142,2019-06-21 12:00:00,2019-06-21 00:00:00,LABORABLE
21,6,2019,14,677,744,1421,2019-06-21 13:00:00,2019-06-21 00:00:00,LABORABLE
21,6,2019,15,690,818,1508,2019-06-21 14:00:00,2019-06-21 00:00:00,LABORABLE
21,6,2019,16,611,706,1317,2019-06-21 15:00:00,2019-06-21 00:00:00,LABORABLE
21,6,2019,17,632,668,1300,2019-06-21 16:00:00,2019-06-21 00:00:00,LABORABLE
21,6,2019,18,661,802,1463,2019-06-21 17:00:00,2019-06-21 00:00:00,LABORABLE
21,6,2019,19,667,782,1449,2019-06-21 18:00:00,2019-06-21 00:00:00,LABORABLE
21,6,2019,20,666,826,1492,2019-06-21 19:00:00,2019-06-21 00:00:00,LABORABLE
21,6,2019,21,702,818,1520,2019-06-21 20:00:00,2019-06-21 00:00:00,LABORABLE
21,6,2019,22,632,718,1350,2019-06-21 21:00:00,2019-06-21 00:00:00,LABORABLE
21,6,2019,23,619,571,1190,2019-06-21 22:00:00,2019-06-21 00:00:00,LABORABLE
21,6,2019,24,406,562,968,2019-06-21 23:00:00,2019-06-21 00:00:00,LABORABLE
22,6,2019,1,346,456,802,2019-06-22 00:00:00,2019-06-22 00:00:00,LABORABLE
22,6,2019,2,228,390,618,2019-06-22 01:00:00,2019-06-22 00:00:00,LABORABLE
22,6,2019,3,215,327,542,2019-06-22 02:00:00,2019-06-22 00:00:00,LABORABLE
22,6,2019,4,161,250,411,2019-06-22 03:00:00,2019-06-22 00:00:00,LABORABLE
22,6,2019,5,129,205,334,2019-06-22 04:00:00,2019-06-22 00:00:00,LABORABLE
22,6,2019,6,150,198,348,2019-06-22 05:00:00,2019-06-22 00:00:00,LABORABLE
22,6,2019,7,226,283,509,2019-06-22 06:00:00,2019-06-22 00:00:00,LABORABLE
22,6,2019,8,352,341,693,2019-06-22 07:00:00,2019-06-22 00:00:00,LABORABLE
22,6,2019,9,372,450,822,2019-06-22 08:00:00,2019-06-22 00:00:00,LABORABLE
22,6,2019,10,434,496,930,2019-06-22 09:00:00,2019-06-22 00:00:00,LABORABLE
22,6,2019,11,558,626,1184,2019-06-22 10:00:00,2019-06-22 00:00:00,LABORABLE
22,6,2019,12,585,705,1290,2019-06-22 11:00:00,2019-06-22 00:00:00,LABORABLE
22,6,2019,13,626,682,1308,2019-06-22 12:00:00,2019-06-22 00:00:00,LABORABLE
22,6,2019,14,595,803,1398,2019-06-22 13:00:00,2019-06-22 00:00:00,LABORABLE
22,6,2019,15,587,720,1307,2019-06-22 14:00:00,2019-06-22 00:00:00,LABORABLE
22,6,2019,16,472,631,1103,2019-06-22 15:00:00,2019-06-22 00:00:00,LABORABLE
22,6,2019,17,494,640,1134,2019-06-22 16:00:00,2019-06-22 00:00:00,LABORABLE
22,6,2019,18,517,692,1209,2019-06-22 17:00:00,2019-06-22 00:00:00,LABORABLE
22,6,2019,19,610,718,1328,2019-06-22 18:00:00,2019-06-22 00:00:00,LABORABLE
22,6,2019,20,584,707,1291,2019-06-22 19:00:00,2019-06-22 00:00:00,LABORABLE
22,6,2019,21,558,697,1255,2019-06-22 20:00:00,2019-06-22 00:00:00,LABORABLE
22,6,2019,22,498,632,1130,2019-06-22 21:00:00,2019-06-22 00:00:00,LABORABLE
22,6,2019,23,507,627,1134,2019-06-22 22:00:00,2019-06-22 00:00:00,LABORABLE
22,6,2019,24,422,587,1009,2019-06-22 23:00:00,2019-06-22 00:00:00,LABORABLE
23,6,2019,1,436,530,966,2019-06-23 00:00:00,2019-06-23 00:00:00,LABORABLE
23,6,2019,2,407,432,839,2019-06-23 01:00:00,2019-06-23 00:00:00,LABORABLE
23,6,2019,3,272,417,689,2019-06-23 02:00:00,2019-06-23 00:00:00,LABORABLE
23,6,2019,4,183,347,530,2019-06-23 03:00:00,2019-06-23 00:00:00,LABORABLE
23,6,2019,5,161,227,388,2019-06-23 04:00:00,2019-06-23 00:00:00,LABORABLE
23,6,2019,6,159,230,389,2019-06-23 05:00:00,2019-06-23 00:00:00,LABORABLE
23,6,2019,7,200,292,492,2019-06-23 06:00:00,2019-06-23 00:00:00,LABORABLE
23,6,2019,8,215,232,447,2019-06-23 07:00:00,2019-06-23 00:00:00,LABORABLE
23,6,2019,9,234,289,523,2019-06-23 08:00:00,2019-06-23 00:00:00,LABORABLE
23,6,2019,10,305,427,732,2019-06-23 09:00:00,2019-06-23 00:00:00,LABORABLE
23,6,2019,11,400,452,852,2019-06-23 10:00:00,2019-06-23 00:00:00,LABORABLE
23,6,2019,12,432,626,1058,2019-06-23 11:00:00,2019-06-23 00:00:00,LABORABLE
23,6,2019,13,488,630,1118,2019-06-23 12:00:00,2019-06-23 00:00:00,LABORABLE
23,6,2019,14,538,664,1202,2019-06-23 13:00:00,2019-06-23 00:00:00,LABORABLE
23,6,2019,15,489,627,1116,2019-06-23 14:00:00,2019-06-23 00:00:00,LABORABLE
23,6,2019,16,388,508,896,2019-06-23 15:00:00,2019-06-23 00:00:00,LABORABLE
23,6,2019,17,438,584,1022,2019-06-23 16:00:00,2019-06-23 00:00:00,LABORABLE
23,6,2019,18,455,692,1147,2019-06-23 17:00:00,2019-06-23 00:00:00,LABORABLE
23,6,2019,19,488,598,1086,2019-06-23 18:00:00,2019-06-23 00:00:00,LABORABLE
23,6,2019,20,484,587,1071,2019-06-23 19:00:00,2019-06-23 00:00:00,LABORABLE
23,6,2019,21,485,657,1142,2019-06-23 20:00:00,2019-06-23 00:00:00,LABORABLE
23,6,2019,22,499,597,1096,2019-06-23 21:00:00,2019-06-23 00:00:00,LABORABLE
23,6,2019,23,468,586,1054,2019-06-23 22:00:00,2019-06-23 00:00:00,LABORABLE
23,6,2019,24,398,456,854,2019-06-23 23:00:00,2019-06-23 00:00:00,LABORABLE
24,6,2019,1,211,367,578,2019-06-24 00:00:00,2019-06-24 00:00:00,LABORABLE
24,6,2019,2,164,254,418,2019-06-24 01:00:00,2019-06-24 00:00:00,LABORABLE
24,6,2019,3,101,188,289,2019-06-24 02:00:00,2019-06-24 00:00:00,LABORABLE
24,6,2019,4,92,148,240,2019-06-24 03:00:00,2019-06-24 00:00:00,LABORABLE
24,6,2019,5,88,113,201,2019-06-24 04:00:00,2019-06-24 00:00:00,LABORABLE
24,6,2019,6,171,184,355,2019-06-24 05:00:00,2019-06-24 00:00:00,LABORABLE
24,6,2019,7,430,429,859,2019-06-24 06:00:00,2019-06-24 00:00:00,LABORABLE
24,6,2019,8,680,606,1286,2019-06-24 07:00:00,2019-06-24 00:00:00,LABORABLE
24,6,2019,9,637,612,1249,2019-06-24 08:00:00,2019-06-24 00:00:00,LABORABLE
24,6,2019,10,589,636,1225,2019-06-24 09:00:00,2019-06-24 00:00:00,LABORABLE
24,6,2019,11,551,571,1122,2019-06-24 10:00:00,2019-06-24 00:00:00,LABORABLE
24,6,2019,12,573,672,1245,2019-06-24 11:00:00,2019-06-24 00:00:00,LABORABLE
24,6,2019,13,617,708,1325,2019-06-24 12:00:00,2019-06-24 00:00:00,LABORABLE
24,6,2019,14,596,684,1280,2019-06-24 13:00:00,2019-06-24 00:00:00,LABORABLE
24,6,2019,15,622,684,1306,2019-06-24 14:00:00,2019-06-24 00:00:00,LABORABLE
24,6,2019,16,593,635,1228,2019-06-24 15:00:00,2019-06-24 00:00:00,LABORABLE
24,6,2019,17,604,689,1293,2019-06-24 16:00:00,2019-06-24 00:00:00,LABORABLE
24,6,2019,18,662,684,1346,2019-06-24 17:00:00,2019-06-24 00:00:00,LABORABLE
24,6,2019,19,658,751,1409,2019-06-24 18:00:00,2019-06-24 00:00:00,LABORABLE
24,6,2019,20,608,730,1338,2019-06-24 19:00:00,2019-06-24 00:00:00,LABORABLE
24,6,2019,21,587,758,1345,2019-06-24 20:00:00,2019-06-24 00:00:00,LABORABLE
24,6,2019,22,500,630,1130,2019-06-24 21:00:00,2019-06-24 00:00:00,LABORABLE
24,6,2019,23,404,463,867,2019-06-24 22:00:00,2019-06-24 00:00:00,LABORABLE
24,6,2019,24,253,360,613,2019-06-24 23:00:00,2019-06-24 00:00:00,LABORABLE
25,6,2019,1,186,279,465,2019-06-25 00:00:00,2019-06-25 00:00:00,LABORABLE
25,6,2019,2,112,173,285,2019-06-25 01:00:00,2019-06-25 00:00:00,LABORABLE
25,6,2019,3,85,142,227,2019-06-25 02:00:00,2019-06-25 00:00:00,LABORABLE
25,6,2019,4,86,106,192,2019-06-25 03:00:00,2019-06-25 00:00:00,LABORABLE
25,6,2019,5,92,89,181,2019-06-25 04:00:00,2019-06-25 00:00:00,LABORABLE
25,6,2019,6,112,197,309,2019-06-25 05:00:00,2019-06-25 00:00:00,LABORABLE
25,6,2019,7,429,406,835,2019-06-25 06:00:00,2019-06-25 00:00:00,LABORABLE
25,6,2019,8,651,551,1202,2019-06-25 07:00:00,2019-06-25 00:00:00,LABORABLE
25,6,2019,9,632,643,1275,2019-06-25 08:00:00,2019-06-25 00:00:00,LABORABLE
25,6,2019,10,616,663,1279,2019-06-25 09:00:00,2019-06-25 00:00:00,LABORABLE
25,6,2019,11,600,627,1227,2019-06-25 10:00:00,2019-06-25 00:00:00,LABORABLE
25,6,2019,12,499,730,1229,2019-06-25 11:00:00,2019-06-25 00:00:00,LABORABLE
25,6,2019,13,617,716,1333,2019-06-25 12:00:00,2019-06-25 00:00:00,LABORABLE
25,6,2019,14,601,724,1325,2019-06-25 13:00:00,2019-06-25 00:00:00,LABORABLE
25,6,2019,15,661,704,1365,2019-06-25 14:00:00,2019-06-25 00:00:00,LABORABLE
25,6,2019,16,609,684,1293,2019-06-25 15:00:00,2019-06-25 00:00:00,LABORABLE
25,6,2019,17,591,658,1249,2019-06-25 16:00:00,2019-06-25 00:00:00,LABORABLE
25,6,2019,18,662,746,1408,2019-06-25 17:00:00,2019-06-25 00:00:00,LABORABLE
25,6,2019,19,682,751,1433,2019-06-25 18:00:00,2019-06-25 00:00:00,LABORABLE
25,6,2019,20,638,816,1454,2019-06-25 19:00:00,2019-06-25 00:00:00,LABORABLE
25,6,2019,21,629,780,1409,2019-06-25 20:00:00,2019-06-25 00:00:00,LABORABLE
25,6,2019,22,550,652,1202,2019-06-25 21:00:00,2019-06-25 00:00:00,LABORABLE
25,6,2019,23,492,626,1118,2019-06-25 22:00:00,2019-06-25 00:00:00,LABORABLE
25,6,2019,24,294,398,692,2019-06-25 23:00:00,2019-06-25 00:00:00,LABORABLE
26,6,2019,1,200,323,523,2019-06-26 00:00:00,2019-06-26 00:00:00,LABORABLE
26,6,2019,2,139,212,351,2019-06-26 01:00:00,2019-06-26 00:00:00,LABORABLE
26,6,2019,3,93,141,234,2019-06-26 02:00:00,2019-06-26 00:00:00,LABORABLE
26,6,2019,4,86,114,200,2019-06-26 03:00:00,2019-06-26 00:00:00,LABORABLE
26,6,2019,5,91,95,186,2019-06-26 04:00:00,2019-06-26 00:00:00,LABORABLE
26,6,2019,6,167,174,341,2019-06-26 05:00:00,2019-06-26 00:00:00,LABORABLE
26,6,2019,7,414,440,854,2019-06-26 06:00:00,2019-06-26 00:00:00,LABORABLE
26,6,2019,8,692,605,1297,2019-06-26 07:00:00,2019-06-26 00:00:00,LABORABLE
26,6,2019,9,608,625,1233,2019-06-26 08:00:00,2019-06-26 00:00:00,LABORABLE
26,6,2019,10,585,662,1247,2019-06-26 09:00:00,2019-06-26 00:00:00,LABORABLE
26,6,2019,11,574,597,1171,2019-06-26 10:00:00,2019-06-26 00:00:00,LABORABLE
26,6,2019,12,624,619,1243,2019-06-26 11:00:00,2019-06-26 00:00:00,LABORABLE
26,6,2019,13,493,667,1160,2019-06-26 12:00:00,2019-06-26 00:00:00,LABORABLE
26,6,2019,14,632,723,1355,2019-06-26 13:00:00,2019-06-26 00:00:00,LABORABLE
26,6,2019,15,604,734,1338,2019-06-26 14:00:00,2019-06-26 00:00:00,LABORABLE
26,6,2019,16,611,643,1254,2019-06-26 15:00:00,2019-06-26 00:00:00,LABORABLE
26,6,2019,17,577,636,1213,2019-06-26 16:00:00,2019-06-26 00:00:00,LABORABLE
26,6,2019,18,625,679,1304,2019-06-26 17:00:00,2019-06-26 00:00:00,LABORABLE
26,6,2019,19,682,887,1569,2019-06-26 18:00:00,2019-06-26 00:00:00,LABORABLE
26,6,2019,20,632,750,1382,2019-06-26 19:00:00,2019-06-26 00:00:00,LABORABLE
26,6,2019,21,642,788,1430,2019-06-26 20:00:00,2019-06-26 00:00:00,LABORABLE
26,6,2019,22,519,662,1181,2019-06-26 21:00:00,2019-06-26 00:00:00,LABORABLE
26,6,2019,23,477,518,995,2019-06-26 22:00:00,2019-06-26 00:00:00,LABORABLE
26,6,2019,24,315,429,744,2019-06-26 23:00:00,2019-06-26 00:00:00,LABORABLE
27,6,2019,1,232,328,560,2019-06-27 00:00:00,2019-06-27 00:00:00,LABORABLE
27,6,2019,2,149,242,391,2019-06-27 01:00:00,2019-06-27 00:00:00,LABORABLE
27,6,2019,3,108,173,281,2019-06-27 02:00:00,2019-06-27 00:00:00,LABORABLE
27,6,2019,4,95,146,241,2019-06-27 03:00:00,2019-06-27 00:00:00,LABORABLE
27,6,2019,5,81,95,176,2019-06-27 04:00:00,2019-06-27 00:00:00,LABORABLE
27,6,2019,6,168,177,345,2019-06-27 05:00:00,2019-06-27 00:00:00,LABORABLE
27,6,2019,7,438,454,892,2019-06-27 06:00:00,2019-06-27 00:00:00,LABORABLE
27,6,2019,8,680,646,1326,2019-06-27 07:00:00,2019-06-27 00:00:00,LABORABLE
27,6,2019,9,679,630,1309,2019-06-27 08:00:00,2019-06-27 00:00:00,LABORABLE
27,6,2019,10,615,618,1233,2019-06-27 09:00:00,2019-06-27 00:00:00,LABORABLE
27,6,2019,11,590,633,1223,2019-06-27 10:00:00,2019-06-27 00:00:00,LABORABLE
27,6,2019,12,610,713,1323,2019-06-27 11:00:00,2019-06-27 00:00:00,LABORABLE
27,6,2019,13,594,725,1319,2019-06-27 12:00:00,2019-06-27 00:00:00,LABORABLE
27,6,2019,14,634,710,1344,2019-06-27 13:00:00,2019-06-27 00:00:00,LABORABLE
27,6,2019,15,632,738,1370,2019-06-27 14:00:00,2019-06-27 00:00:00,LABORABLE
27,6,2019,16,603,650,1253,2019-06-27 15:00:00,2019-06-27 00:00:00,LABORABLE
27,6,2019,17,603,677,1280,2019-06-27 16:00:00,2019-06-27 00:00:00,LABORABLE
27,6,2019,18,599,767,1366,2019-06-27 17:00:00,2019-06-27 00:00:00,LABORABLE
27,6,2019,19,673,797,1470,2019-06-27 18:00:00,2019-06-27 00:00:00,LABORABLE
27,6,2019,20,623,739,1362,2019-06-27 19:00:00,2019-06-27 00:00:00,LABORABLE
27,6,2019,21,647,744,1391,2019-06-27 20:00:00,2019-06-27 00:00:00,LABORABLE
27,6,2019,22,577,679,1256,2019-06-27 21:00:00,2019-06-27 00:00:00,LABORABLE
27,6,2019,23,491,540,1031,2019-06-27 22:00:00,2019-06-27 00:00:00,LABORABLE
27,6,2019,24,394,513,907,2019-06-27 23:00:00,2019-06-27 00:00:00,LABORABLE
28,6,2019,1,242,392,634,2019-06-28 00:00:00,2019-06-28 00:00:00,LABORABLE
28,6,2019,2,161,251,412,2019-06-28 01:00:00,2019-06-28 00:00:00,LABORABLE
28,6,2019,3,113,225,338,2019-06-28 02:00:00,2019-06-28 00:00:00,LABORABLE
28,6,2019,4,112,160,272,2019-06-28 03:00:00,2019-06-28 00:00:00,LABORABLE
28,6,2019,5,96,140,236,2019-06-28 04:00:00,2019-06-28 00:00:00,LABORABLE
28,6,2019,6,177,203,380,2019-06-28 05:00:00,2019-06-28 00:00:00,LABORABLE
28,6,2019,7,244,326,570,2019-06-28 06:00:00,2019-06-28 00:00:00,LABORABLE
28,6,2019,8,366,620,986,2019-06-28 07:00:00,2019-06-28 00:00:00,LABORABLE
28,6,2019,9,601,628,1229,2019-06-28 08:00:00,2019-06-28 00:00:00,LABORABLE
28,6,2019,10,637,632,1269,2019-06-28 09:00:00,2019-06-28 00:00:00,LABORABLE
28,6,2019,11,570,594,1164,2019-06-28 10:00:00,2019-06-28 00:00:00,LABORABLE
28,6,2019,12,627,671,1298,2019-06-28 11:00:00,2019-06-28 00:00:00,LABORABLE
28,6,2019,13,653,728,1381,2019-06-28 12:00:00,2019-06-28 00:00:00,LABORABLE
28,6,2019,14,654,755,1409,2019-06-28 13:00:00,2019-06-28 00:00:00,LABORABLE
28,6,2019,15,671,730,1401,2019-06-28 14:00:00,2019-06-28 00:00:00,LABORABLE
28,6,2019,16,606,663,1269,2019-06-28 15:00:00,2019-06-28 00:00:00,LABORABLE
28,6,2019,17,618,737,1355,2019-06-28 16:00:00,2019-06-28 00:00:00,LABORABLE
28,6,2019,18,655,720,1375,2019-06-28 17:00:00,2019-06-28 00:00:00,LABORABLE
28,6,2019,19,649,749,1398,2019-06-28 18:00:00,2019-06-28 00:00:00,LABORABLE
28,6,2019,20,669,823,1492,2019-06-28 19:00:00,2019-06-28 00:00:00,LABORABLE
28,6,2019,21,656,810,1466,2019-06-28 20:00:00,2019-06-28 00:00:00,LABORABLE
28,6,2019,22,602,690,1292,2019-06-28 21:00:00,2019-06-28 00:00:00,LABORABLE
28,6,2019,23,497,605,1102,2019-06-28 22:00:00,2019-06-28 00:00:00,LABORABLE
28,6,2019,24,409,582,991,2019-06-28 23:00:00,2019-06-28 00:00:00,LABORABLE
29,6,2019,1,358,500,858,2019-06-29 00:00:00,2019-06-29 00:00:00,LABORABLE
29,6,2019,2,277,418,695,2019-06-29 01:00:00,2019-06-29 00:00:00,LABORABLE
29,6,2019,3,215,334,549,2019-06-29 02:00:00,2019-06-29 00:00:00,LABORABLE
29,6,2019,4,174,291,465,2019-06-29 03:00:00,2019-06-29 00:00:00,LABORABLE
29,6,2019,5,172,244,416,2019-06-29 04:00:00,2019-06-29 00:00:00,LABORABLE
29,6,2019,6,168,240,408,2019-06-29 05:00:00,2019-06-29 00:00:00,LABORABLE
29,6,2019,7,243,296,539,2019-06-29 06:00:00,2019-06-29 00:00:00,LABORABLE
29,6,2019,8,310,338,648,2019-06-29 07:00:00,2019-06-29 00:00:00,LABORABLE
29,6,2019,9,378,423,801,2019-06-29 08:00:00,2019-06-29 00:00:00,LABORABLE
29,6,2019,10,474,532,1006,2019-06-29 09:00:00,2019-06-29 00:00:00,LABORABLE
29,6,2019,11,529,685,1214,2019-06-29 10:00:00,2019-06-29 00:00:00,LABORABLE
29,6,2019,12,640,683,1323,2019-06-29 11:00:00,2019-06-29 00:00:00,LABORABLE
29,6,2019,13,619,754,1373,2019-06-29 12:00:00,2019-06-29 00:00:00,LABORABLE
29,6,2019,14,612,772,1384,2019-06-29 13:00:00,2019-06-29 00:00:00,LABORABLE
29,6,2019,15,576,719,1295,2019-06-29 14:00:00,2019-06-29 00:00:00,LABORABLE
29,6,2019,16,455,690,1145,2019-06-29 15:00:00,2019-06-29 00:00:00,LABORABLE
29,6,2019,17,470,653,1123,2019-06-29 16:00:00,2019-06-29 00:00:00,LABORABLE
29,6,2019,18,516,608,1124,2019-06-29 17:00:00,2019-06-29 00:00:00,LABORABLE
29,6,2019,19,547,696,1243,2019-06-29 18:00:00,2019-06-29 00:00:00,LABORABLE
29,6,2019,20,587,663,1250,2019-06-29 19:00:00,2019-06-29 00:00:00,LABORABLE
29,6,2019,21,534,659,1193,2019-06-29 20:00:00,2019-06-29 00:00:00,LABORABLE
29,6,2019,22,501,690,1191,2019-06-29 21:00:00,2019-06-29 00:00:00,LABORABLE
29,6,2019,23,514,606,1120,2019-06-29 22:00:00,2019-06-29 00:00:00,LABORABLE
29,6,2019,24,439,629,1068,2019-06-29 23:00:00,2019-06-29 00:00:00,LABORABLE
30,6,2019,1,439,497,936,2019-06-30 00:00:00,2019-06-30 00:00:00,LABORABLE
30,6,2019,2,413,470,883,2019-06-30 01:00:00,2019-06-30 00:00:00,LABORABLE
30,6,2019,3,311,362,673,2019-06-30 02:00:00,2019-06-30 00:00:00,LABORABLE
30,6,2019,4,220,305,525,2019-06-30 03:00:00,2019-06-30 00:00:00,LABORABLE
30,6,2019,5,157,257,414,2019-06-30 04:00:00,2019-06-30 00:00:00,LABORABLE
30,6,2019,6,133,246,379,2019-06-30 05:00:00,2019-06-30 00:00:00,LABORABLE
30,6,2019,7,205,305,510,2019-06-30 06:00:00,2019-06-30 00:00:00,LABORABLE
30,6,2019,8,226,279,505,2019-06-30 07:00:00,2019-06-30 00:00:00,LABORABLE
30,6,2019,9,214,257,471,2019-06-30 08:00:00,2019-06-30 00:00:00,LABORABLE
30,6,2019,10,313,448,761,2019-06-30 09:00:00,2019-06-30 00:00:00,LABORABLE
30,6,2019,11,430,515,945,2019-06-30 10:00:00,2019-06-30 00:00:00,LABORABLE
30,6,2019,12,473,652,1125,2019-06-30 11:00:00,2019-06-30 00:00:00,LABORABLE
30,6,2019,13,562,618,1180,2019-06-30 12:00:00,2019-06-30 00:00:00,LABORABLE
30,6,2019,14,577,622,1199,2019-06-30 13:00:00,2019-06-30 00:00:00,LABORABLE
30,6,2019,15,496,651,1147,2019-06-30 14:00:00,2019-06-30 00:00:00,LABORABLE
30,6,2019,16,431,572,1003,2019-06-30 15:00:00,2019-06-30 00:00:00,LABORABLE
30,6,2019,17,414,549,963,2019-06-30 16:00:00,2019-06-30 00:00:00,LABORABLE
30,6,2019,18,436,634,1070,2019-06-30 17:00:00,2019-06-30 00:00:00,LABORABLE
30,6,2019,19,463,616,1079,2019-06-30 18:00:00,2019-06-30 00:00:00,LABORABLE
30,6,2019,20,504,649,1153,2019-06-30 19:00:00,2019-06-30 00:00:00,LABORABLE
30,6,2019,21,461,639,1100,2019-06-30 20:00:00,2019-06-30 00:00:00,LABORABLE
30,6,2019,22,538,654,1192,2019-06-30 21:00:00,2019-06-30 00:00:00,LABORABLE
30,6,2019,23,495,603,1098,2019-06-30 22:00:00,2019-06-30 00:00:00,LABORABLE
30,6,2019,24,380,485,865,2019-06-30 23:00:00,2019-06-30 00:00:00,LABORABLE
1,7,2019,1,254,435,689,2019-07-01 00:00:00,2019-01-07 00:00:00,LABORABLE
1,7,2019,2,183,239,422,2019-07-01 01:00:00,2019-01-07 00:00:00,LABORABLE
1,7,2019,3,140,236,376,2019-07-01 02:00:00,2019-01-07 00:00:00,LABORABLE
1,7,2019,4,101,144,245,2019-07-01 03:00:00,2019-01-07 00:00:00,LABORABLE
1,7,2019,5,94,138,232,2019-07-01 04:00:00,2019-01-07 00:00:00,LABORABLE
1,7,2019,6,111,186,297,2019-07-01 05:00:00,2019-01-07 00:00:00,LABORABLE
1,7,2019,7,288,441,729,2019-07-01 06:00:00,2019-01-07 00:00:00,LABORABLE
1,7,2019,8,664,650,1314,2019-07-01 07:00:00,2019-01-07 00:00:00,LABORABLE
1,7,2019,9,594,622,1216,2019-07-01 08:00:00,2019-01-07 00:00:00,LABORABLE
1,7,2019,10,561,587,1148,2019-07-01 09:00:00,2019-01-07 00:00:00,LABORABLE
1,7,2019,11,586,732,1318,2019-07-01 10:00:00,2019-01-07 00:00:00,LABORABLE
1,7,2019,12,592,759,1351,2019-07-01 11:00:00,2019-01-07 00:00:00,LABORABLE
1,7,2019,13,642,741,1383,2019-07-01 12:00:00,2019-01-07 00:00:00,LABORABLE
1,7,2019,14,655,786,1441,2019-07-01 13:00:00,2019-01-07 00:00:00,LABORABLE
1,7,2019,15,667,776,1443,2019-07-01 14:00:00,2019-01-07 00:00:00,LABORABLE
1,7,2019,16,544,660,1204,2019-07-01 15:00:00,2019-01-07 00:00:00,LABORABLE
1,7,2019,17,500,836,1336,2019-07-01 16:00:00,2019-01-07 00:00:00,LABORABLE
1,7,2019,18,663,759,1422,2019-07-01 17:00:00,2019-01-07 00:00:00,LABORABLE
1,7,2019,19,617,762,1379,2019-07-01 18:00:00,2019-01-07 00:00:00,LABORABLE
1,7,2019,20,640,844,1484,2019-07-01 19:00:00,2019-01-07 00:00:00,LABORABLE
1,7,2019,21,601,774,1375,2019-07-01 20:00:00,2019-01-07 00:00:00,LABORABLE
1,7,2019,22,569,672,1241,2019-07-01 21:00:00,2019-01-07 00:00:00,LABORABLE
1,7,2019,23,454,482,936,2019-07-01 22:00:00,2019-01-07 00:00:00,LABORABLE
1,7,2019,24,267,446,713,2019-07-01 23:00:00,2019-01-07 00:00:00,LABORABLE
2,7,2019,1,176,295,471,2019-07-02 00:00:00,2019-02-07 00:00:00,LABORABLE
2,7,2019,2,137,241,378,2019-07-02 01:00:00,2019-02-07 00:00:00,LABORABLE
2,7,2019,3,78,142,220,2019-07-02 02:00:00,2019-02-07 00:00:00,LABORABLE
2,7,2019,4,81,107,188,2019-07-02 03:00:00,2019-02-07 00:00:00,LABORABLE
2,7,2019,5,81,104,185,2019-07-02 04:00:00,2019-02-07 00:00:00,LABORABLE
2,7,2019,6,154,167,321,2019-07-02 05:00:00,2019-02-07 00:00:00,LABORABLE
2,7,2019,7,413,418,831,2019-07-02 06:00:00,2019-02-07 00:00:00,LABORABLE
2,7,2019,8,639,627,1266,2019-07-02 07:00:00,2019-02-07 00:00:00,LABORABLE
2,7,2019,9,579,680,1259,2019-07-02 08:00:00,2019-02-07 00:00:00,LABORABLE
2,7,2019,10,569,665,1234,2019-07-02 09:00:00,2019-02-07 00:00:00,LABORABLE
2,7,2019,11,568,615,1183,2019-07-02 10:00:00,2019-02-07 00:00:00,LABORABLE
2,7,2019,12,483,589,1072,2019-07-02 11:00:00,2019-02-07 00:00:00,LABORABLE
2,7,2019,13,477,623,1100,2019-07-02 12:00:00,2019-02-07 00:00:00,LABORABLE
2,7,2019,14,655,763,1418,2019-07-02 13:00:00,2019-02-07 00:00:00,LABORABLE
2,7,2019,15,644,759,1403,2019-07-02 14:00:00,2019-02-07 00:00:00,LABORABLE
2,7,2019,16,558,646,1204,2019-07-02 15:00:00,2019-02-07 00:00:00,LABORABLE
2,7,2019,17,570,713,1283,2019-07-02 16:00:00,2019-02-07 00:00:00,LABORABLE
2,7,2019,18,489,703,1192,2019-07-02 17:00:00,2019-02-07 00:00:00,LABORABLE
2,7,2019,19,629,807,1436,2019-07-02 18:00:00,2019-02-07 00:00:00,LABORABLE
2,7,2019,20,637,778,1415,2019-07-02 19:00:00,2019-02-07 00:00:00,LABORABLE
2,7,2019,21,601,778,1379,2019-07-02 20:00:00,2019-02-07 00:00:00,LABORABLE
2,7,2019,22,569,670,1239,2019-07-02 21:00:00,2019-02-07 00:00:00,LABORABLE
2,7,2019,23,419,548,967,2019-07-02 22:00:00,2019-02-07 00:00:00,LABORABLE
2,7,2019,24,311,434,745,2019-07-02 23:00:00,2019-02-07 00:00:00,LABORABLE
3,7,2019,1,212,309,521,2019-07-03 00:00:00,2019-03-07 00:00:00,LABORABLE
3,7,2019,2,164,193,357,2019-07-03 01:00:00,2019-03-07 00:00:00,LABORABLE
3,7,2019,3,84,165,249,2019-07-03 02:00:00,2019-03-07 00:00:00,LABORABLE
3,7,2019,4,92,117,209,2019-07-03 03:00:00,2019-03-07 00:00:00,LABORABLE
3,7,2019,5,75,116,191,2019-07-03 04:00:00,2019-03-07 00:00:00,LABORABLE
3,7,2019,6,108,167,275,2019-07-03 05:00:00,2019-03-07 00:00:00,LABORABLE
3,7,2019,7,283,412,695,2019-07-03 06:00:00,2019-03-07 00:00:00,LABORABLE
3,7,2019,8,672,597,1269,2019-07-03 07:00:00,2019-03-07 00:00:00,LABORABLE
3,7,2019,9,577,651,1228,2019-07-03 08:00:00,2019-03-07 00:00:00,LABORABLE
3,7,2019,10,578,652,1230,2019-07-03 09:00:00,2019-03-07 00:00:00,LABORABLE
3,7,2019,11,525,697,1222,2019-07-03 10:00:00,2019-03-07 00:00:00,LABORABLE
3,7,2019,12,441,592,1033,2019-07-03 11:00:00,2019-03-07 00:00:00,LABORABLE
3,7,2019,13,570,744,1314,2019-07-03 12:00:00,2019-03-07 00:00:00,LABORABLE
3,7,2019,14,639,748,1387,2019-07-03 13:00:00,2019-03-07 00:00:00,LABORABLE
3,7,2019,15,621,667,1288,2019-07-03 14:00:00,2019-03-07 00:00:00,LABORABLE
3,7,2019,16,584,609,1193,2019-07-03 15:00:00,2019-03-07 00:00:00,LABORABLE
3,7,2019,17,559,698,1257,2019-07-03 16:00:00,2019-03-07 00:00:00,LABORABLE
3,7,2019,18,626,750,1376,2019-07-03 17:00:00,2019-03-07 00:00:00,LABORABLE
3,7,2019,19,663,821,1484,2019-07-03 18:00:00,2019-03-07 00:00:00,LABORABLE
3,7,2019,20,648,778,1426,2019-07-03 19:00:00,2019-03-07 00:00:00,LABORABLE
3,7,2019,21,577,808,1385,2019-07-03 20:00:00,2019-03-07 00:00:00,LABORABLE
3,7,2019,22,557,705,1262,2019-07-03 21:00:00,2019-03-07 00:00:00,LABORABLE
3,7,2019,23,454,547,1001,2019-07-03 22:00:00,2019-03-07 00:00:00,LABORABLE
3,7,2019,24,335,439,774,2019-07-03 23:00:00,2019-03-07 00:00:00,LABORABLE
4,7,2019,1,216,367,583,2019-07-04 00:00:00,2019-04-07 00:00:00,LABORABLE
4,7,2019,2,148,268,416,2019-07-04 01:00:00,2019-04-07 00:00:00,LABORABLE
4,7,2019,3,131,175,306,2019-07-04 02:00:00,2019-04-07 00:00:00,LABORABLE
4,7,2019,4,93,136,229,2019-07-04 03:00:00,2019-04-07 00:00:00,LABORABLE
4,7,2019,5,107,153,260,2019-07-04 04:00:00,2019-04-07 00:00:00,LABORABLE
4,7,2019,6,110,187,297,2019-07-04 05:00:00,2019-04-07 00:00:00,LABORABLE
4,7,2019,7,291,440,731,2019-07-04 06:00:00,2019-04-07 00:00:00,LABORABLE
4,7,2019,8,655,612,1267,2019-07-04 07:00:00,2019-04-07 00:00:00,LABORABLE
4,7,2019,9,579,645,1224,2019-07-04 08:00:00,2019-04-07 00:00:00,LABORABLE
4,7,2019,10,596,624,1220,2019-07-04 09:00:00,2019-04-07 00:00:00,LABORABLE
4,7,2019,11,581,687,1268,2019-07-04 10:00:00,2019-04-07 00:00:00,LABORABLE
4,7,2019,12,602,668,1270,2019-07-04 11:00:00,2019-04-07 00:00:00,LABORABLE
4,7,2019,13,663,729,1392,2019-07-04 12:00:00,2019-04-07 00:00:00,LABORABLE
4,7,2019,14,655,765,1420,2019-07-04 13:00:00,2019-04-07 00:00:00,LABORABLE
4,7,2019,15,607,703,1310,2019-07-04 14:00:00,2019-04-07 00:00:00,LABORABLE
4,7,2019,16,573,699,1272,2019-07-04 15:00:00,2019-04-07 00:00:00,LABORABLE
4,7,2019,17,593,676,1269,2019-07-04 16:00:00,2019-04-07 00:00:00,LABORABLE
4,7,2019,18,619,733,1352,2019-07-04 17:00:00,2019-04-07 00:00:00,LABORABLE
4,7,2019,19,688,779,1467,2019-07-04 18:00:00,2019-04-07 00:00:00,LABORABLE
4,7,2019,20,677,820,1497,2019-07-04 19:00:00,2019-04-07 00:00:00,LABORABLE
4,7,2019,21,629,835,1464,2019-07-04 20:00:00,2019-04-07 00:00:00,LABORABLE
4,7,2019,22,586,664,1250,2019-07-04 21:00:00,2019-04-07 00:00:00,LABORABLE
4,7,2019,23,513,613,1126,2019-07-04 22:00:00,2019-04-07 00:00:00,LABORABLE
4,7,2019,24,336,451,787,2019-07-04 23:00:00,2019-04-07 00:00:00,LABORABLE
5,7,2019,1,254,391,645,2019-07-05 00:00:00,2019-05-07 00:00:00,LABORABLE
5,7,2019,2,183,291,474,2019-07-05 01:00:00,2019-05-07 00:00:00,LABORABLE
5,7,2019,3,122,217,339,2019-07-05 02:00:00,2019-05-07 00:00:00,LABORABLE
5,7,2019,4,106,167,273,2019-07-05 03:00:00,2019-05-07 00:00:00,LABORABLE
5,7,2019,5,99,144,243,2019-07-05 04:00:00,2019-05-07 00:00:00,LABORABLE
5,7,2019,6,190,185,375,2019-07-05 05:00:00,2019-05-07 00:00:00,LABORABLE
5,7,2019,7,285,435,720,2019-07-05 06:00:00,2019-05-07 00:00:00,LABORABLE
5,7,2019,8,671,614,1285,2019-07-05 07:00:00,2019-05-07 00:00:00,LABORABLE
5,7,2019,9,582,562,1144,2019-07-05 08:00:00,2019-05-07 00:00:00,LABORABLE
5,7,2019,10,579,680,1259,2019-07-05 09:00:00,2019-05-07 00:00:00,LABORABLE
5,7,2019,11,526,723,1249,2019-07-05 10:00:00,2019-05-07 00:00:00,LABORABLE
5,7,2019,12,606,741,1347,2019-07-05 11:00:00,2019-05-07 00:00:00,LABORABLE
5,7,2019,13,619,742,1361,2019-07-05 12:00:00,2019-05-07 00:00:00,LABORABLE
5,7,2019,14,570,701,1271,2019-07-05 13:00:00,2019-05-07 00:00:00,LABORABLE
5,7,2019,15,648,790,1438,2019-07-05 14:00:00,2019-05-07 00:00:00,LABORABLE
5,7,2019,16,618,632,1250,2019-07-05 15:00:00,2019-05-07 00:00:00,LABORABLE
5,7,2019,17,578,666,1244,2019-07-05 16:00:00,2019-05-07 00:00:00,LABORABLE
5,7,2019,18,676,744,1420,2019-07-05 17:00:00,2019-05-07 00:00:00,LABORABLE
5,7,2019,19,664,797,1461,2019-07-05 18:00:00,2019-05-07 00:00:00,LABORABLE
5,7,2019,20,646,817,1463,2019-07-05 19:00:00,2019-05-07 00:00:00,LABORABLE
5,7,2019,21,666,826,1492,2019-07-05 20:00:00,2019-05-07 00:00:00,LABORABLE
5,7,2019,22,582,773,1355,2019-07-05 21:00:00,2019-05-07 00:00:00,LABORABLE
5,7,2019,23,561,659,1220,2019-07-05 22:00:00,2019-05-07 00:00:00,LABORABLE
5,7,2019,24,406,602,1008,2019-07-05 23:00:00,2019-05-07 00:00:00,LABORABLE
6,7,2019,1,331,357,688,2019-07-06 00:00:00,2019-06-07 00:00:00,LABORABLE
6,7,2019,2,296,260,556,2019-07-06 01:00:00,2019-06-07 00:00:00,LABORABLE
6,7,2019,3,236,254,490,2019-07-06 02:00:00,2019-06-07 00:00:00,LABORABLE
6,7,2019,4,196,167,363,2019-07-06 03:00:00,2019-06-07 00:00:00,LABORABLE
6,7,2019,5,156,156,312,2019-07-06 04:00:00,2019-06-07 00:00:00,LABORABLE
6,7,2019,6,187,175,362,2019-07-06 05:00:00,2019-06-07 00:00:00,LABORABLE
6,7,2019,7,243,210,453,2019-07-06 06:00:00,2019-06-07 00:00:00,LABORABLE
6,7,2019,8,327,195,522,2019-07-06 07:00:00,2019-06-07 00:00:00,LABORABLE
6,7,2019,9,369,256,625,2019-07-06 08:00:00,2019-06-07 00:00:00,LABORABLE
6,7,2019,10,456,328,784,2019-07-06 09:00:00,2019-06-07 00:00:00,LABORABLE
6,7,2019,11,539,366,905,2019-07-06 10:00:00,2019-06-07 00:00:00,LABORABLE
6,7,2019,12,596,404,1000,2019-07-06 11:00:00,2019-06-07 00:00:00,LABORABLE
6,7,2019,13,624,454,1078,2019-07-06 12:00:00,2019-06-07 00:00:00,LABORABLE
6,7,2019,14,609,449,1058,2019-07-06 13:00:00,2019-06-07 00:00:00,LABORABLE
6,7,2019,15,569,418,987,2019-07-06 14:00:00,2019-06-07 00:00:00,LABORABLE
6,7,2019,16,438,367,805,2019-07-06 15:00:00,2019-06-07 00:00:00,LABORABLE
6,7,2019,17,389,371,760,2019-07-06 16:00:00,2019-06-07 00:00:00,LABORABLE
6,7,2019,18,439,407,846,2019-07-06 17:00:00,2019-06-07 00:00:00,LABORABLE
6,7,2019,19,481,423,904,2019-07-06 18:00:00,2019-06-07 00:00:00,LABORABLE
6,7,2019,20,590,428,1018,2019-07-06 19:00:00,2019-06-07 00:00:00,LABORABLE
6,7,2019,21,524,752,1276,2019-07-06 20:00:00,2019-06-07 00:00:00,LABORABLE
6,7,2019,22,491,402,893,2019-07-06 21:00:00,2019-06-07 00:00:00,LABORABLE
6,7,2019,23,485,354,839,2019-07-06 22:00:00,2019-06-07 00:00:00,LABORABLE
6,7,2019,24,425,370,795,2019-07-06 23:00:00,2019-06-07 00:00:00,LABORABLE
7,7,2019,1,408,382,790,2019-07-07 00:00:00,2019-07-07 00:00:00,LABORABLE
7,7,2019,2,331,321,652,2019-07-07 01:00:00,2019-07-07 00:00:00,LABORABLE
7,7,2019,3,283,319,602,2019-07-07 02:00:00,2019-07-07 00:00:00,LABORABLE
7,7,2019,4,203,251,454,2019-07-07 03:00:00,2019-07-07 00:00:00,LABORABLE
7,7,2019,5,216,244,460,2019-07-07 04:00:00,2019-07-07 00:00:00,LABORABLE
7,7,2019,6,165,185,350,2019-07-07 05:00:00,2019-07-07 00:00:00,LABORABLE
7,7,2019,7,241,211,452,2019-07-07 06:00:00,2019-07-07 00:00:00,LABORABLE
7,7,2019,8,244,184,428,2019-07-07 07:00:00,2019-07-07 00:00:00,LABORABLE
7,7,2019,9,199,184,383,2019-07-07 08:00:00,2019-07-07 00:00:00,LABORABLE
7,7,2019,10,331,229,560,2019-07-07 09:00:00,2019-07-07 00:00:00,LABORABLE
7,7,2019,11,375,280,655,2019-07-07 10:00:00,2019-07-07 00:00:00,LABORABLE
7,7,2019,12,458,359,817,2019-07-07 11:00:00,2019-07-07 00:00:00,LABORABLE
7,7,2019,13,543,387,930,2019-07-07 12:00:00,2019-07-07 00:00:00,LABORABLE
7,7,2019,14,483,361,844,2019-07-07 13:00:00,2019-07-07 00:00:00,LABORABLE
7,7,2019,15,489,371,860,2019-07-07 14:00:00,2019-07-07 00:00:00,LABORABLE
7,7,2019,16,391,331,722,2019-07-07 15:00:00,2019-07-07 00:00:00,LABORABLE
7,7,2019,17,343,347,690,2019-07-07 16:00:00,2019-07-07 00:00:00,LABORABLE
7,7,2019,18,442,403,845,2019-07-07 17:00:00,2019-07-07 00:00:00,LABORABLE
7,7,2019,19,414,393,807,2019-07-07 18:00:00,2019-07-07 00:00:00,LABORABLE
7,7,2019,20,480,424,904,2019-07-07 19:00:00,2019-07-07 00:00:00,LABORABLE
7,7,2019,21,435,394,829,2019-07-07 20:00:00,2019-07-07 00:00:00,LABORABLE
7,7,2019,22,513,381,894,2019-07-07 21:00:00,2019-07-07 00:00:00,LABORABLE
7,7,2019,23,492,362,854,2019-07-07 22:00:00,2019-07-07 00:00:00,LABORABLE
7,7,2019,24,352,305,657,2019-07-07 23:00:00,2019-07-07 00:00:00,LABORABLE
8,7,2019,1,303,396,699,2019-07-08 00:00:00,2019-08-07 00:00:00,LABORABLE
8,7,2019,2,199,268,467,2019-07-08 01:00:00,2019-08-07 00:00:00,LABORABLE
8,7,2019,3,127,206,333,2019-07-08 02:00:00,2019-08-07 00:00:00,LABORABLE
8,7,2019,4,90,147,237,2019-07-08 03:00:00,2019-08-07 00:00:00,LABORABLE
8,7,2019,5,86,124,210,2019-07-08 04:00:00,2019-08-07 00:00:00,LABORABLE
8,7,2019,6,111,184,295,2019-07-08 05:00:00,2019-08-07 00:00:00,LABORABLE
8,7,2019,7,288,396,684,2019-07-08 06:00:00,2019-08-07 00:00:00,LABORABLE
8,7,2019,8,648,522,1170,2019-07-08 07:00:00,2019-08-07 00:00:00,LABORABLE
8,7,2019,9,572,602,1174,2019-07-08 08:00:00,2019-08-07 00:00:00,LABORABLE
8,7,2019,10,561,628,1189,2019-07-08 09:00:00,2019-08-07 00:00:00,LABORABLE
8,7,2019,11,481,703,1184,2019-07-08 10:00:00,2019-08-07 00:00:00,LABORABLE
8,7,2019,12,587,716,1303,2019-07-08 11:00:00,2019-08-07 00:00:00,LABORABLE
8,7,2019,13,558,706,1264,2019-07-08 12:00:00,2019-08-07 00:00:00,LABORABLE
8,7,2019,14,618,780,1398,2019-07-08 13:00:00,2019-08-07 00:00:00,LABORABLE
8,7,2019,15,606,734,1340,2019-07-08 14:00:00,2019-08-07 00:00:00,LABORABLE
8,7,2019,16,583,599,1182,2019-07-08 15:00:00,2019-08-07 00:00:00,LABORABLE
8,7,2019,17,557,683,1240,2019-07-08 16:00:00,2019-08-07 00:00:00,LABORABLE
8,7,2019,18,607,752,1359,2019-07-08 17:00:00,2019-08-07 00:00:00,LABORABLE
8,7,2019,19,645,809,1454,2019-07-08 18:00:00,2019-08-07 00:00:00,LABORABLE
8,7,2019,20,598,747,1345,2019-07-08 19:00:00,2019-08-07 00:00:00,LABORABLE
8,7,2019,21,575,841,1416,2019-07-08 20:00:00,2019-08-07 00:00:00,LABORABLE
8,7,2019,22,510,632,1142,2019-07-08 21:00:00,2019-08-07 00:00:00,LABORABLE
8,7,2019,23,402,509,911,2019-07-08 22:00:00,2019-08-07 00:00:00,LABORABLE
8,7,2019,24,262,395,657,2019-07-08 23:00:00,2019-08-07 00:00:00,LABORABLE
9,7,2019,1,181,324,505,2019-07-09 00:00:00,2019-09-07 00:00:00,LABORABLE
9,7,2019,2,156,214,370,2019-07-09 01:00:00,2019-09-07 00:00:00,LABORABLE
9,7,2019,3,105,162,267,2019-07-09 02:00:00,2019-09-07 00:00:00,LABORABLE
9,7,2019,4,74,108,182,2019-07-09 03:00:00,2019-09-07 00:00:00,LABORABLE
9,7,2019,5,69,95,164,2019-07-09 04:00:00,2019-09-07 00:00:00,LABORABLE
9,7,2019,6,104,162,266,2019-07-09 05:00:00,2019-09-07 00:00:00,LABORABLE
9,7,2019,7,416,375,791,2019-07-09 06:00:00,2019-09-07 00:00:00,LABORABLE
9,7,2019,8,634,562,1196,2019-07-09 07:00:00,2019-09-07 00:00:00,LABORABLE
9,7,2019,9,534,617,1151,2019-07-09 08:00:00,2019-09-07 00:00:00,LABORABLE
9,7,2019,10,558,680,1238,2019-07-09 09:00:00,2019-09-07 00:00:00,LABORABLE
9,7,2019,11,547,651,1198,2019-07-09 10:00:00,2019-09-07 00:00:00,LABORABLE
9,7,2019,12,610,783,1393,2019-07-09 11:00:00,2019-09-07 00:00:00,LABORABLE
9,7,2019,13,463,672,1135,2019-07-09 12:00:00,2019-09-07 00:00:00,LABORABLE
9,7,2019,14,620,812,1432,2019-07-09 13:00:00,2019-09-07 00:00:00,LABORABLE
9,7,2019,15,577,755,1332,2019-07-09 14:00:00,2019-09-07 00:00:00,LABORABLE
9,7,2019,16,554,636,1190,2019-07-09 15:00:00,2019-09-07 00:00:00,LABORABLE
9,7,2019,17,572,700,1272,2019-07-09 16:00:00,2019-09-07 00:00:00,LABORABLE
9,7,2019,18,596,759,1355,2019-07-09 17:00:00,2019-09-07 00:00:00,LABORABLE
9,7,2019,19,641,788,1429,2019-07-09 18:00:00,2019-09-07 00:00:00,LABORABLE
9,7,2019,20,614,833,1447,2019-07-09 19:00:00,2019-09-07 00:00:00,LABORABLE
9,7,2019,21,599,757,1356,2019-07-09 20:00:00,2019-09-07 00:00:00,LABORABLE
9,7,2019,22,546,680,1226,2019-07-09 21:00:00,2019-09-07 00:00:00,LABORABLE
9,7,2019,23,454,567,1021,2019-07-09 22:00:00,2019-09-07 00:00:00,LABORABLE
9,7,2019,24,285,410,695,2019-07-09 23:00:00,2019-09-07 00:00:00,LABORABLE
10,7,2019,1,202,316,518,2019-07-10 00:00:00,2019-10-07 00:00:00,LABORABLE
10,7,2019,2,116,232,348,2019-07-10 01:00:00,2019-10-07 00:00:00,LABORABLE
10,7,2019,3,89,201,290,2019-07-10 02:00:00,2019-10-07 00:00:00,LABORABLE
10,7,2019,4,76,134,210,2019-07-10 03:00:00,2019-10-07 00:00:00,LABORABLE
10,7,2019,5,83,105,188,2019-07-10 04:00:00,2019-10-07 00:00:00,LABORABLE
10,7,2019,6,108,151,259,2019-07-10 05:00:00,2019-10-07 00:00:00,LABORABLE
10,7,2019,7,407,385,792,2019-07-10 06:00:00,2019-10-07 00:00:00,LABORABLE
10,7,2019,8,646,602,1248,2019-07-10 07:00:00,2019-10-07 00:00:00,LABORABLE
10,7,2019,9,551,590,1141,2019-07-10 08:00:00,2019-10-07 00:00:00,LABORABLE
10,7,2019,10,565,669,1234,2019-07-10 09:00:00,2019-10-07 00:00:00,LABORABLE
10,7,2019,11,521,661,1182,2019-07-10 10:00:00,2019-10-07 00:00:00,LABORABLE
10,7,2019,12,568,727,1295,2019-07-10 11:00:00,2019-10-07 00:00:00,LABORABLE
10,7,2019,13,518,678,1196,2019-07-10 12:00:00,2019-10-07 00:00:00,LABORABLE
10,7,2019,14,546,788,1334,2019-07-10 13:00:00,2019-10-07 00:00:00,LABORABLE
10,7,2019,15,576,804,1380,2019-07-10 14:00:00,2019-10-07 00:00:00,LABORABLE
10,7,2019,16,556,666,1222,2019-07-10 15:00:00,2019-10-07 00:00:00,LABORABLE
10,7,2019,17,548,688,1236,2019-07-10 16:00:00,2019-10-07 00:00:00,LABORABLE
10,7,2019,18,657,766,1423,2019-07-10 17:00:00,2019-10-07 00:00:00,LABORABLE
10,7,2019,19,639,827,1466,2019-07-10 18:00:00,2019-10-07 00:00:00,LABORABLE
10,7,2019,20,662,798,1460,2019-07-10 19:00:00,2019-10-07 00:00:00,LABORABLE
10,7,2019,21,653,769,1422,2019-07-10 20:00:00,2019-10-07 00:00:00,LABORABLE
10,7,2019,22,514,713,1227,2019-07-10 21:00:00,2019-10-07 00:00:00,LABORABLE
10,7,2019,23,448,561,1009,2019-07-10 22:00:00,2019-10-07 00:00:00,LABORABLE
10,7,2019,24,349,447,796,2019-07-10 23:00:00,2019-10-07 00:00:00,LABORABLE
11,7,2019,1,250,370,620,2019-07-11 00:00:00,2019-11-07 00:00:00,LABORABLE
11,7,2019,2,145,256,401,2019-07-11 01:00:00,2019-11-07 00:00:00,LABORABLE
11,7,2019,3,104,190,294,2019-07-11 02:00:00,2019-11-07 00:00:00,LABORABLE
11,7,2019,4,86,131,217,2019-07-11 03:00:00,2019-11-07 00:00:00,LABORABLE
11,7,2019,5,91,113,204,2019-07-11 04:00:00,2019-11-07 00:00:00,LABORABLE
11,7,2019,6,110,161,271,2019-07-11 05:00:00,2019-11-07 00:00:00,LABORABLE
11,7,2019,7,291,396,687,2019-07-11 06:00:00,2019-11-07 00:00:00,LABORABLE
11,7,2019,8,663,568,1231,2019-07-11 07:00:00,2019-11-07 00:00:00,LABORABLE
11,7,2019,9,600,649,1249,2019-07-11 08:00:00,2019-11-07 00:00:00,LABORABLE
11,7,2019,10,606,680,1286,2019-07-11 09:00:00,2019-11-07 00:00:00,LABORABLE
11,7,2019,11,589,678,1267,2019-07-11 10:00:00,2019-11-07 00:00:00,LABORABLE
11,7,2019,12,596,723,1319,2019-07-11 11:00:00,2019-11-07 00:00:00,LABORABLE
11,7,2019,13,648,771,1419,2019-07-11 12:00:00,2019-11-07 00:00:00,LABORABLE
11,7,2019,14,593,835,1428,2019-07-11 13:00:00,2019-11-07 00:00:00,LABORABLE
11,7,2019,15,633,769,1402,2019-07-11 14:00:00,2019-11-07 00:00:00,LABORABLE
11,7,2019,16,539,691,1230,2019-07-11 15:00:00,2019-11-07 00:00:00,LABORABLE
11,7,2019,17,600,671,1271,2019-07-11 16:00:00,2019-11-07 00:00:00,LABORABLE
11,7,2019,18,631,740,1371,2019-07-11 17:00:00,2019-11-07 00:00:00,LABORABLE
11,7,2019,19,698,797,1495,2019-07-11 18:00:00,2019-11-07 00:00:00,LABORABLE
11,7,2019,20,644,814,1458,2019-07-11 19:00:00,2019-11-07 00:00:00,LABORABLE
11,7,2019,21,626,853,1479,2019-07-11 20:00:00,2019-11-07 00:00:00,LABORABLE
11,7,2019,22,562,693,1255,2019-07-11 21:00:00,2019-11-07 00:00:00,LABORABLE
11,7,2019,23,487,585,1072,2019-07-11 22:00:00,2019-11-07 00:00:00,LABORABLE
11,7,2019,24,344,469,813,2019-07-11 23:00:00,2019-11-07 00:00:00,LABORABLE
12,7,2019,1,263,399,662,2019-07-12 00:00:00,2019-12-07 00:00:00,LABORABLE
12,7,2019,2,164,294,458,2019-07-12 01:00:00,2019-12-07 00:00:00,LABORABLE
12,7,2019,3,134,216,350,2019-07-12 02:00:00,2019-12-07 00:00:00,LABORABLE
12,7,2019,4,113,156,269,2019-07-12 03:00:00,2019-12-07 00:00:00,LABORABLE
12,7,2019,5,92,149,241,2019-07-12 04:00:00,2019-12-07 00:00:00,LABORABLE
12,7,2019,6,177,178,355,2019-07-12 05:00:00,2019-12-07 00:00:00,LABORABLE
12,7,2019,7,425,408,833,2019-07-12 06:00:00,2019-12-07 00:00:00,LABORABLE
12,7,2019,8,655,553,1208,2019-07-12 07:00:00,2019-12-07 00:00:00,LABORABLE
12,7,2019,9,551,612,1163,2019-07-12 08:00:00,2019-12-07 00:00:00,LABORABLE
12,7,2019,10,618,648,1266,2019-07-12 09:00:00,2019-12-07 00:00:00,LABORABLE
12,7,2019,11,566,745,1311,2019-07-12 10:00:00,2019-12-07 00:00:00,LABORABLE
12,7,2019,12,602,713,1315,2019-07-12 11:00:00,2019-12-07 00:00:00,LABORABLE
12,7,2019,13,530,911,1441,2019-07-12 12:00:00,2019-12-07 00:00:00,LABORABLE
12,7,2019,14,650,801,1451,2019-07-12 13:00:00,2019-12-07 00:00:00,LABORABLE
12,7,2019,15,582,792,1374,2019-07-12 14:00:00,2019-12-07 00:00:00,LABORABLE
12,7,2019,16,629,680,1309,2019-07-12 15:00:00,2019-12-07 00:00:00,LABORABLE
12,7,2019,17,577,710,1287,2019-07-12 16:00:00,2019-12-07 00:00:00,LABORABLE
12,7,2019,18,621,763,1384,2019-07-12 17:00:00,2019-12-07 00:00:00,LABORABLE
12,7,2019,19,631,774,1405,2019-07-12 18:00:00,2019-12-07 00:00:00,LABORABLE
12,7,2019,20,668,799,1467,2019-07-12 19:00:00,2019-12-07 00:00:00,LABORABLE
12,7,2019,21,657,800,1457,2019-07-12 20:00:00,2019-12-07 00:00:00,LABORABLE
12,7,2019,22,599,719,1318,2019-07-12 21:00:00,2019-12-07 00:00:00,LABORABLE
12,7,2019,23,524,674,1198,2019-07-12 22:00:00,2019-12-07 00:00:00,LABORABLE
12,7,2019,24,428,546,974,2019-07-12 23:00:00,2019-12-07 00:00:00,LABORABLE
13,7,2019,1,335,300,635,2019-07-13 00:00:00,2019-07-13 00:00:00,LABORABLE
13,7,2019,2,279,233,512,2019-07-13 01:00:00,2019-07-13 00:00:00,LABORABLE
13,7,2019,3,202,199,401,2019-07-13 02:00:00,2019-07-13 00:00:00,LABORABLE
13,7,2019,4,138,162,300,2019-07-13 03:00:00,2019-07-13 00:00:00,LABORABLE
13,7,2019,5,131,153,284,2019-07-13 04:00:00,2019-07-13 00:00:00,LABORABLE
13,7,2019,6,138,152,290,2019-07-13 05:00:00,2019-07-13 00:00:00,LABORABLE
13,7,2019,7,231,202,433,2019-07-13 06:00:00,2019-07-13 00:00:00,LABORABLE
13,7,2019,8,290,219,509,2019-07-13 07:00:00,2019-07-13 00:00:00,LABORABLE
13,7,2019,9,331,271,602,2019-07-13 08:00:00,2019-07-13 00:00:00,LABORABLE
13,7,2019,10,412,307,719,2019-07-13 09:00:00,2019-07-13 00:00:00,LABORABLE
13,7,2019,11,500,354,854,2019-07-13 10:00:00,2019-07-13 00:00:00,LABORABLE
13,7,2019,12,595,417,1012,2019-07-13 11:00:00,2019-07-13 00:00:00,LABORABLE
13,7,2019,13,601,435,1036,2019-07-13 12:00:00,2019-07-13 00:00:00,LABORABLE
13,7,2019,14,540,480,1020,2019-07-13 13:00:00,2019-07-13 00:00:00,LABORABLE
13,7,2019,15,522,413,935,2019-07-13 14:00:00,2019-07-13 00:00:00,LABORABLE
13,7,2019,16,454,394,848,2019-07-13 15:00:00,2019-07-13 00:00:00,LABORABLE
13,7,2019,17,405,397,802,2019-07-13 16:00:00,2019-07-13 00:00:00,LABORABLE
13,7,2019,18,466,380,846,2019-07-13 17:00:00,2019-07-13 00:00:00,LABORABLE
13,7,2019,19,497,363,860,2019-07-13 18:00:00,2019-07-13 00:00:00,LABORABLE
13,7,2019,20,553,438,991,2019-07-13 19:00:00,2019-07-13 00:00:00,LABORABLE
13,7,2019,21,535,413,948,2019-07-13 20:00:00,2019-07-13 00:00:00,LABORABLE
13,7,2019,22,519,417,936,2019-07-13 21:00:00,2019-07-13 00:00:00,LABORABLE
13,7,2019,23,517,352,869,2019-07-13 22:00:00,2019-07-13 00:00:00,LABORABLE
13,7,2019,24,422,361,783,2019-07-13 23:00:00,2019-07-13 00:00:00,LABORABLE
14,7,2019,1,414,318,732,2019-07-14 00:00:00,2019-07-14 00:00:00,LABORABLE
14,7,2019,2,302,284,586,2019-07-14 01:00:00,2019-07-14 00:00:00,LABORABLE
14,7,2019,3,265,237,502,2019-07-14 02:00:00,2019-07-14 00:00:00,LABORABLE
14,7,2019,4,213,188,401,2019-07-14 03:00:00,2019-07-14 00:00:00,LABORABLE
14,7,2019,5,162,183,345,2019-07-14 04:00:00,2019-07-14 00:00:00,LABORABLE
14,7,2019,6,141,141,282,2019-07-14 05:00:00,2019-07-14 00:00:00,LABORABLE
14,7,2019,7,197,172,369,2019-07-14 06:00:00,2019-07-14 00:00:00,LABORABLE
14,7,2019,8,207,180,387,2019-07-14 07:00:00,2019-07-14 00:00:00,LABORABLE
14,7,2019,9,213,177,390,2019-07-14 08:00:00,2019-07-14 00:00:00,LABORABLE
14,7,2019,10,338,235,573,2019-07-14 09:00:00,2019-07-14 00:00:00,LABORABLE
14,7,2019,11,383,498,881,2019-07-14 10:00:00,2019-07-14 00:00:00,LABORABLE
14,7,2019,12,428,555,983,2019-07-14 11:00:00,2019-07-14 00:00:00,LABORABLE
14,7,2019,13,528,591,1119,2019-07-14 12:00:00,2019-07-14 00:00:00,LABORABLE
14,7,2019,14,523,687,1210,2019-07-14 13:00:00,2019-07-14 00:00:00,LABORABLE
14,7,2019,15,464,648,1112,2019-07-14 14:00:00,2019-07-14 00:00:00,LABORABLE
14,7,2019,16,395,599,994,2019-07-14 15:00:00,2019-07-14 00:00:00,LABORABLE
14,7,2019,17,403,552,955,2019-07-14 16:00:00,2019-07-14 00:00:00,LABORABLE
14,7,2019,18,423,571,994,2019-07-14 17:00:00,2019-07-14 00:00:00,LABORABLE
14,7,2019,19,459,565,1024,2019-07-14 18:00:00,2019-07-14 00:00:00,LABORABLE
14,7,2019,20,447,684,1131,2019-07-14 19:00:00,2019-07-14 00:00:00,LABORABLE
14,7,2019,21,474,618,1092,2019-07-14 20:00:00,2019-07-14 00:00:00,LABORABLE
14,7,2019,22,476,598,1074,2019-07-14 21:00:00,2019-07-14 00:00:00,LABORABLE
14,7,2019,23,469,630,1099,2019-07-14 22:00:00,2019-07-14 00:00:00,LABORABLE
14,7,2019,24,354,469,823,2019-07-14 23:00:00,2019-07-14 00:00:00,LABORABLE
15,7,2019,1,228,323,551,2019-07-15 00:00:00,2019-07-15 00:00:00,LABORABLE
15,7,2019,2,137,264,401,2019-07-15 01:00:00,2019-07-15 00:00:00,LABORABLE
15,7,2019,3,117,193,310,2019-07-15 02:00:00,2019-07-15 00:00:00,LABORABLE
15,7,2019,4,89,132,221,2019-07-15 03:00:00,2019-07-15 00:00:00,LABORABLE
15,7,2019,5,85,123,208,2019-07-15 04:00:00,2019-07-15 00:00:00,LABORABLE
15,7,2019,6,111,167,278,2019-07-15 05:00:00,2019-07-15 00:00:00,LABORABLE
15,7,2019,7,288,422,710,2019-07-15 06:00:00,2019-07-15 00:00:00,LABORABLE
15,7,2019,8,635,625,1260,2019-07-15 07:00:00,2019-07-15 00:00:00,LABORABLE
15,7,2019,9,541,600,1141,2019-07-15 08:00:00,2019-07-15 00:00:00,LABORABLE
15,7,2019,10,591,642,1233,2019-07-15 09:00:00,2019-07-15 00:00:00,LABORABLE
15,7,2019,11,552,714,1266,2019-07-15 10:00:00,2019-07-15 00:00:00,LABORABLE
15,7,2019,12,592,759,1351,2019-07-15 11:00:00,2019-07-15 00:00:00,LABORABLE
15,7,2019,13,657,714,1371,2019-07-15 12:00:00,2019-07-15 00:00:00,LABORABLE
15,7,2019,14,612,677,1289,2019-07-15 13:00:00,2019-07-15 00:00:00,LABORABLE
15,7,2019,15,609,749,1358,2019-07-15 14:00:00,2019-07-15 00:00:00,LABORABLE
15,7,2019,16,522,657,1179,2019-07-15 15:00:00,2019-07-15 00:00:00,LABORABLE
15,7,2019,17,564,667,1231,2019-07-15 16:00:00,2019-07-15 00:00:00,LABORABLE
15,7,2019,18,602,727,1329,2019-07-15 17:00:00,2019-07-15 00:00:00,LABORABLE
15,7,2019,19,670,828,1498,2019-07-15 18:00:00,2019-07-15 00:00:00,LABORABLE
15,7,2019,20,662,743,1405,2019-07-15 19:00:00,2019-07-15 00:00:00,LABORABLE
15,7,2019,21,578,794,1372,2019-07-15 20:00:00,2019-07-15 00:00:00,LABORABLE
15,7,2019,22,493,636,1129,2019-07-15 21:00:00,2019-07-15 00:00:00,LABORABLE
15,7,2019,23,411,518,929,2019-07-15 22:00:00,2019-07-15 00:00:00,LABORABLE
15,7,2019,24,291,451,742,2019-07-15 23:00:00,2019-07-15 00:00:00,LABORABLE
16,7,2019,1,195,315,510,2019-07-16 00:00:00,2019-07-16 00:00:00,LABORABLE
16,7,2019,2,123,212,335,2019-07-16 01:00:00,2019-07-16 00:00:00,LABORABLE
16,7,2019,3,90,179,269,2019-07-16 02:00:00,2019-07-16 00:00:00,LABORABLE
16,7,2019,4,94,111,205,2019-07-16 03:00:00,2019-07-16 00:00:00,LABORABLE
16,7,2019,5,79,96,175,2019-07-16 04:00:00,2019-07-16 00:00:00,LABORABLE
16,7,2019,6,104,160,264,2019-07-16 05:00:00,2019-07-16 00:00:00,LABORABLE
16,7,2019,7,409,438,847,2019-07-16 06:00:00,2019-07-16 00:00:00,LABORABLE
16,7,2019,8,634,610,1244,2019-07-16 07:00:00,2019-07-16 00:00:00,LABORABLE
16,7,2019,9,589,614,1203,2019-07-16 08:00:00,2019-07-16 00:00:00,LABORABLE
16,7,2019,10,559,644,1203,2019-07-16 09:00:00,2019-07-16 00:00:00,LABORABLE
16,7,2019,11,556,711,1267,2019-07-16 10:00:00,2019-07-16 00:00:00,LABORABLE
16,7,2019,12,534,635,1169,2019-07-16 11:00:00,2019-07-16 00:00:00,LABORABLE
16,7,2019,13,594,683,1277,2019-07-16 12:00:00,2019-07-16 00:00:00,LABORABLE
16,7,2019,14,607,763,1370,2019-07-16 13:00:00,2019-07-16 00:00:00,LABORABLE
16,7,2019,15,599,731,1330,2019-07-16 14:00:00,2019-07-16 00:00:00,LABORABLE
16,7,2019,16,581,638,1219,2019-07-16 15:00:00,2019-07-16 00:00:00,LABORABLE
16,7,2019,17,603,707,1310,2019-07-16 16:00:00,2019-07-16 00:00:00,LABORABLE
16,7,2019,18,633,751,1384,2019-07-16 17:00:00,2019-07-16 00:00:00,LABORABLE
16,7,2019,19,625,776,1401,2019-07-16 18:00:00,2019-07-16 00:00:00,LABORABLE
16,7,2019,20,598,790,1388,2019-07-16 19:00:00,2019-07-16 00:00:00,LABORABLE
16,7,2019,21,603,746,1349,2019-07-16 20:00:00,2019-07-16 00:00:00,LABORABLE
16,7,2019,22,536,667,1203,2019-07-16 21:00:00,2019-07-16 00:00:00,LABORABLE
16,7,2019,23,392,527,919,2019-07-16 22:00:00,2019-07-16 00:00:00,LABORABLE
16,7,2019,24,270,428,698,2019-07-16 23:00:00,2019-07-16 00:00:00,LABORABLE
17,7,2019,1,214,314,528,2019-07-17 00:00:00,2019-07-17 00:00:00,LABORABLE
17,7,2019,2,143,241,384,2019-07-17 01:00:00,2019-07-17 00:00:00,LABORABLE
17,7,2019,3,108,138,246,2019-07-17 02:00:00,2019-07-17 00:00:00,LABORABLE
17,7,2019,4,77,136,213,2019-07-17 03:00:00,2019-07-17 00:00:00,LABORABLE
17,7,2019,5,86,89,175,2019-07-17 04:00:00,2019-07-17 00:00:00,LABORABLE
17,7,2019,6,108,156,264,2019-07-17 05:00:00,2019-07-17 00:00:00,LABORABLE
17,7,2019,7,407,380,787,2019-07-17 06:00:00,2019-07-17 00:00:00,LABORABLE
17,7,2019,8,666,576,1242,2019-07-17 07:00:00,2019-07-17 00:00:00,LABORABLE
17,7,2019,9,571,592,1163,2019-07-17 08:00:00,2019-07-17 00:00:00,LABORABLE
17,7,2019,10,547,671,1218,2019-07-17 09:00:00,2019-07-17 00:00:00,LABORABLE
17,7,2019,11,407,520,927,2019-07-17 10:00:00,2019-07-17 00:00:00,LABORABLE
17,7,2019,12,532,672,1204,2019-07-17 11:00:00,2019-07-17 00:00:00,LABORABLE
17,7,2019,13,565,852,1417,2019-07-17 12:00:00,2019-07-17 00:00:00,LABORABLE
17,7,2019,14,584,670,1254,2019-07-17 13:00:00,2019-07-17 00:00:00,LABORABLE
17,7,2019,15,626,634,1260,2019-07-17 14:00:00,2019-07-17 00:00:00,LABORABLE
17,7,2019,16,536,663,1199,2019-07-17 15:00:00,2019-07-17 00:00:00,LABORABLE
17,7,2019,17,577,668,1245,2019-07-17 16:00:00,2019-07-17 00:00:00,LABORABLE
17,7,2019,18,620,735,1355,2019-07-17 17:00:00,2019-07-17 00:00:00,LABORABLE
17,7,2019,19,678,774,1452,2019-07-17 18:00:00,2019-07-17 00:00:00,LABORABLE
17,7,2019,20,678,808,1486,2019-07-17 19:00:00,2019-07-17 00:00:00,LABORABLE
17,7,2019,21,590,741,1331,2019-07-17 20:00:00,2019-07-17 00:00:00,LABORABLE
17,7,2019,22,536,647,1183,2019-07-17 21:00:00,2019-07-17 00:00:00,LABORABLE
17,7,2019,23,422,519,941,2019-07-17 22:00:00,2019-07-17 00:00:00,LABORABLE
17,7,2019,24,324,429,753,2019-07-17 23:00:00,2019-07-17 00:00:00,LABORABLE
18,7,2019,1,218,344,562,2019-07-18 00:00:00,2019-07-18 00:00:00,LABORABLE
18,7,2019,2,134,225,359,2019-07-18 01:00:00,2019-07-18 00:00:00,LABORABLE
18,7,2019,3,92,184,276,2019-07-18 02:00:00,2019-07-18 00:00:00,LABORABLE
18,7,2019,4,70,127,197,2019-07-18 03:00:00,2019-07-18 00:00:00,LABORABLE
18,7,2019,5,93,106,199,2019-07-18 04:00:00,2019-07-18 00:00:00,LABORABLE
18,7,2019,6,163,180,343,2019-07-18 05:00:00,2019-07-18 00:00:00,LABORABLE
18,7,2019,7,419,378,797,2019-07-18 06:00:00,2019-07-18 00:00:00,LABORABLE
18,7,2019,8,656,596,1252,2019-07-18 07:00:00,2019-07-18 00:00:00,LABORABLE
18,7,2019,9,574,613,1187,2019-07-18 08:00:00,2019-07-18 00:00:00,LABORABLE
18,7,2019,10,541,616,1157,2019-07-18 09:00:00,2019-07-18 00:00:00,LABORABLE
18,7,2019,11,567,650,1217,2019-07-18 10:00:00,2019-07-18 00:00:00,LABORABLE
18,7,2019,12,614,753,1367,2019-07-18 11:00:00,2019-07-18 00:00:00,LABORABLE
18,7,2019,13,612,745,1357,2019-07-18 12:00:00,2019-07-18 00:00:00,LABORABLE
18,7,2019,14,590,756,1346,2019-07-18 13:00:00,2019-07-18 00:00:00,LABORABLE
18,7,2019,15,572,718,1290,2019-07-18 14:00:00,2019-07-18 00:00:00,LABORABLE
18,7,2019,16,547,650,1197,2019-07-18 15:00:00,2019-07-18 00:00:00,LABORABLE
18,7,2019,17,576,672,1248,2019-07-18 16:00:00,2019-07-18 00:00:00,LABORABLE
18,7,2019,18,611,639,1250,2019-07-18 17:00:00,2019-07-18 00:00:00,LABORABLE
18,7,2019,19,671,758,1429,2019-07-18 18:00:00,2019-07-18 00:00:00,LABORABLE
18,7,2019,20,648,789,1437,2019-07-18 19:00:00,2019-07-18 00:00:00,LABORABLE
18,7,2019,21,617,783,1400,2019-07-18 20:00:00,2019-07-18 00:00:00,LABORABLE
18,7,2019,22,576,687,1263,2019-07-18 21:00:00,2019-07-18 00:00:00,LABORABLE
18,7,2019,23,481,572,1053,2019-07-18 22:00:00,2019-07-18 00:00:00,LABORABLE
18,7,2019,24,378,444,822,2019-07-18 23:00:00,2019-07-18 00:00:00,LABORABLE
19,7,2019,1,238,374,612,2019-07-19 00:00:00,2019-07-19 00:00:00,LABORABLE
19,7,2019,2,168,248,416,2019-07-19 01:00:00,2019-07-19 00:00:00,LABORABLE
19,7,2019,3,102,192,294,2019-07-19 02:00:00,2019-07-19 00:00:00,LABORABLE
19,7,2019,4,101,163,264,2019-07-19 03:00:00,2019-07-19 00:00:00,LABORABLE
19,7,2019,5,98,131,229,2019-07-19 04:00:00,2019-07-19 00:00:00,LABORABLE
19,7,2019,6,188,187,375,2019-07-19 05:00:00,2019-07-19 00:00:00,LABORABLE
19,7,2019,7,424,422,846,2019-07-19 06:00:00,2019-07-19 00:00:00,LABORABLE
19,7,2019,8,654,575,1229,2019-07-19 07:00:00,2019-07-19 00:00:00,LABORABLE
19,7,2019,9,556,584,1140,2019-07-19 08:00:00,2019-07-19 00:00:00,LABORABLE
19,7,2019,10,595,609,1204,2019-07-19 09:00:00,2019-07-19 00:00:00,LABORABLE
19,7,2019,11,505,693,1198,2019-07-19 10:00:00,2019-07-19 00:00:00,LABORABLE
19,7,2019,12,399,550,949,2019-07-19 11:00:00,2019-07-19 00:00:00,LABORABLE
19,7,2019,13,614,693,1307,2019-07-19 12:00:00,2019-07-19 00:00:00,LABORABLE
19,7,2019,14,618,773,1391,2019-07-19 13:00:00,2019-07-19 00:00:00,LABORABLE
19,7,2019,15,619,768,1387,2019-07-19 14:00:00,2019-07-19 00:00:00,LABORABLE
19,7,2019,16,601,626,1227,2019-07-19 15:00:00,2019-07-19 00:00:00,LABORABLE
19,7,2019,17,564,657,1221,2019-07-19 16:00:00,2019-07-19 00:00:00,LABORABLE
19,7,2019,18,587,758,1345,2019-07-19 17:00:00,2019-07-19 00:00:00,LABORABLE
19,7,2019,19,700,766,1466,2019-07-19 18:00:00,2019-07-19 00:00:00,LABORABLE
19,7,2019,20,676,832,1508,2019-07-19 19:00:00,2019-07-19 00:00:00,LABORABLE
19,7,2019,21,658,819,1477,2019-07-19 20:00:00,2019-07-19 00:00:00,LABORABLE
19,7,2019,22,549,730,1279,2019-07-19 21:00:00,2019-07-19 00:00:00,LABORABLE
19,7,2019,23,526,603,1129,2019-07-19 22:00:00,2019-07-19 00:00:00,LABORABLE
19,7,2019,24,382,537,919,2019-07-19 23:00:00,2019-07-19 00:00:00,LABORABLE
20,7,2019,1,305,477,782,2019-07-20 00:00:00,2019-07-20 00:00:00,LABORABLE
20,7,2019,2,269,376,645,2019-07-20 01:00:00,2019-07-20 00:00:00,LABORABLE
20,7,2019,3,187,320,507,2019-07-20 02:00:00,2019-07-20 00:00:00,LABORABLE
20,7,2019,4,179,268,447,2019-07-20 03:00:00,2019-07-20 00:00:00,LABORABLE
20,7,2019,5,151,244,395,2019-07-20 04:00:00,2019-07-20 00:00:00,LABORABLE
20,7,2019,6,178,241,419,2019-07-20 05:00:00,2019-07-20 00:00:00,LABORABLE
20,7,2019,7,226,313,539,2019-07-20 06:00:00,2019-07-20 00:00:00,LABORABLE
20,7,2019,8,289,306,595,2019-07-20 07:00:00,2019-07-20 00:00:00,LABORABLE
20,7,2019,9,358,397,755,2019-07-20 08:00:00,2019-07-20 00:00:00,LABORABLE
20,7,2019,10,395,478,873,2019-07-20 09:00:00,2019-07-20 00:00:00,LABORABLE
20,7,2019,11,509,576,1085,2019-07-20 10:00:00,2019-07-20 00:00:00,LABORABLE
20,7,2019,12,526,653,1179,2019-07-20 11:00:00,2019-07-20 00:00:00,LABORABLE
20,7,2019,13,609,700,1309,2019-07-20 12:00:00,2019-07-20 00:00:00,LABORABLE
20,7,2019,14,541,736,1277,2019-07-20 13:00:00,2019-07-20 00:00:00,LABORABLE
20,7,2019,15,542,745,1287,2019-07-20 14:00:00,2019-07-20 00:00:00,LABORABLE
20,7,2019,16,431,601,1032,2019-07-20 15:00:00,2019-07-20 00:00:00,LABORABLE
20,7,2019,17,405,557,962,2019-07-20 16:00:00,2019-07-20 00:00:00,LABORABLE
20,7,2019,18,434,604,1038,2019-07-20 17:00:00,2019-07-20 00:00:00,LABORABLE
20,7,2019,19,469,584,1053,2019-07-20 18:00:00,2019-07-20 00:00:00,LABORABLE
20,7,2019,20,570,709,1279,2019-07-20 19:00:00,2019-07-20 00:00:00,LABORABLE
20,7,2019,21,497,659,1156,2019-07-20 20:00:00,2019-07-20 00:00:00,LABORABLE
20,7,2019,22,492,671,1163,2019-07-20 21:00:00,2019-07-20 00:00:00,LABORABLE
20,7,2019,23,477,589,1066,2019-07-20 22:00:00,2019-07-20 00:00:00,LABORABLE
20,7,2019,24,407,537,944,2019-07-20 23:00:00,2019-07-20 00:00:00,LABORABLE
21,7,2019,1,382,483,865,2019-07-21 00:00:00,2019-07-21 00:00:00,LABORABLE
21,7,2019,2,326,477,803,2019-07-21 01:00:00,2019-07-21 00:00:00,LABORABLE
21,7,2019,3,201,346,547,2019-07-21 02:00:00,2019-07-21 00:00:00,LABORABLE
21,7,2019,4,218,319,537,2019-07-21 03:00:00,2019-07-21 00:00:00,LABORABLE
21,7,2019,5,154,270,424,2019-07-21 04:00:00,2019-07-21 00:00:00,LABORABLE
21,7,2019,6,143,248,391,2019-07-21 05:00:00,2019-07-21 00:00:00,LABORABLE
21,7,2019,7,173,284,457,2019-07-21 06:00:00,2019-07-21 00:00:00,LABORABLE
21,7,2019,8,205,257,462,2019-07-21 07:00:00,2019-07-21 00:00:00,LABORABLE
21,7,2019,9,211,281,492,2019-07-21 08:00:00,2019-07-21 00:00:00,LABORABLE
21,7,2019,10,293,362,655,2019-07-21 09:00:00,2019-07-21 00:00:00,LABORABLE
21,7,2019,11,367,443,810,2019-07-21 10:00:00,2019-07-21 00:00:00,LABORABLE
21,7,2019,12,457,572,1029,2019-07-21 11:00:00,2019-07-21 00:00:00,LABORABLE
21,7,2019,13,455,629,1084,2019-07-21 12:00:00,2019-07-21 00:00:00,LABORABLE
21,7,2019,14,501,632,1133,2019-07-21 13:00:00,2019-07-21 00:00:00,LABORABLE
21,7,2019,15,457,605,1062,2019-07-21 14:00:00,2019-07-21 00:00:00,LABORABLE
21,7,2019,16,389,555,944,2019-07-21 15:00:00,2019-07-21 00:00:00,LABORABLE
21,7,2019,17,340,580,920,2019-07-21 16:00:00,2019-07-21 00:00:00,LABORABLE
21,7,2019,18,375,522,897,2019-07-21 17:00:00,2019-07-21 00:00:00,LABORABLE
21,7,2019,19,420,537,957,2019-07-21 18:00:00,2019-07-21 00:00:00,LABORABLE
21,7,2019,20,494,620,1114,2019-07-21 19:00:00,2019-07-21 00:00:00,LABORABLE
21,7,2019,21,524,634,1158,2019-07-21 20:00:00,2019-07-21 00:00:00,LABORABLE
21,7,2019,22,486,633,1119,2019-07-21 21:00:00,2019-07-21 00:00:00,LABORABLE
21,7,2019,23,510,578,1088,2019-07-21 22:00:00,2019-07-21 00:00:00,LABORABLE
21,7,2019,24,299,477,776,2019-07-21 23:00:00,2019-07-21 00:00:00,LABORABLE
22,7,2019,1,235,363,598,2019-07-22 00:00:00,2019-07-22 00:00:00,LABORABLE
22,7,2019,2,155,273,428,2019-07-22 01:00:00,2019-07-22 00:00:00,LABORABLE
22,7,2019,3,114,188,302,2019-07-22 02:00:00,2019-07-22 00:00:00,LABORABLE
22,7,2019,4,82,114,196,2019-07-22 03:00:00,2019-07-22 00:00:00,LABORABLE
22,7,2019,5,90,125,215,2019-07-22 04:00:00,2019-07-22 00:00:00,LABORABLE
22,7,2019,6,111,165,276,2019-07-22 05:00:00,2019-07-22 00:00:00,LABORABLE
22,7,2019,7,417,385,802,2019-07-22 06:00:00,2019-07-22 00:00:00,LABORABLE
22,7,2019,8,606,558,1164,2019-07-22 07:00:00,2019-07-22 00:00:00,LABORABLE
22,7,2019,9,549,633,1182,2019-07-22 08:00:00,2019-07-22 00:00:00,LABORABLE
22,7,2019,10,582,632,1214,2019-07-22 09:00:00,2019-07-22 00:00:00,LABORABLE
22,7,2019,11,545,707,1252,2019-07-22 10:00:00,2019-07-22 00:00:00,LABORABLE
22,7,2019,12,552,730,1282,2019-07-22 11:00:00,2019-07-22 00:00:00,LABORABLE
22,7,2019,13,473,656,1129,2019-07-22 12:00:00,2019-07-22 00:00:00,LABORABLE
22,7,2019,14,523,686,1209,2019-07-22 13:00:00,2019-07-22 00:00:00,LABORABLE
22,7,2019,15,598,710,1308,2019-07-22 14:00:00,2019-07-22 00:00:00,LABORABLE
22,7,2019,16,516,652,1168,2019-07-22 15:00:00,2019-07-22 00:00:00,LABORABLE
22,7,2019,17,526,652,1178,2019-07-22 16:00:00,2019-07-22 00:00:00,LABORABLE
22,7,2019,18,583,677,1260,2019-07-22 17:00:00,2019-07-22 00:00:00,LABORABLE
22,7,2019,19,626,822,1448,2019-07-22 18:00:00,2019-07-22 00:00:00,LABORABLE
22,7,2019,20,620,808,1428,2019-07-22 19:00:00,2019-07-22 00:00:00,LABORABLE
22,7,2019,21,599,713,1312,2019-07-22 20:00:00,2019-07-22 00:00:00,LABORABLE
22,7,2019,22,491,632,1123,2019-07-22 21:00:00,2019-07-22 00:00:00,LABORABLE
22,7,2019,23,397,486,883,2019-07-22 22:00:00,2019-07-22 00:00:00,LABORABLE
22,7,2019,24,251,380,631,2019-07-22 23:00:00,2019-07-22 00:00:00,LABORABLE
23,7,2019,1,195,302,497,2019-07-23 00:00:00,2019-07-23 00:00:00,LABORABLE
23,7,2019,2,135,211,346,2019-07-23 01:00:00,2019-07-23 00:00:00,LABORABLE
23,7,2019,3,86,157,243,2019-07-23 02:00:00,2019-07-23 00:00:00,LABORABLE
23,7,2019,4,79,110,189,2019-07-23 03:00:00,2019-07-23 00:00:00,LABORABLE
23,7,2019,5,78,112,190,2019-07-23 04:00:00,2019-07-23 00:00:00,LABORABLE
23,7,2019,6,104,177,281,2019-07-23 05:00:00,2019-07-23 00:00:00,LABORABLE
23,7,2019,7,415,370,785,2019-07-23 06:00:00,2019-07-23 00:00:00,LABORABLE
23,7,2019,8,613,619,1232,2019-07-23 07:00:00,2019-07-23 00:00:00,LABORABLE
23,7,2019,9,572,585,1157,2019-07-23 08:00:00,2019-07-23 00:00:00,LABORABLE
23,7,2019,10,545,660,1205,2019-07-23 09:00:00,2019-07-23 00:00:00,LABORABLE
23,7,2019,11,520,701,1221,2019-07-23 10:00:00,2019-07-23 00:00:00,LABORABLE
23,7,2019,12,566,687,1253,2019-07-23 11:00:00,2019-07-23 00:00:00,LABORABLE
23,7,2019,13,587,708,1295,2019-07-23 12:00:00,2019-07-23 00:00:00,LABORABLE
23,7,2019,14,577,678,1255,2019-07-23 13:00:00,2019-07-23 00:00:00,LABORABLE
23,7,2019,15,613,683,1296,2019-07-23 14:00:00,2019-07-23 00:00:00,LABORABLE
23,7,2019,16,519,654,1173,2019-07-23 15:00:00,2019-07-23 00:00:00,LABORABLE
23,7,2019,17,554,670,1224,2019-07-23 16:00:00,2019-07-23 00:00:00,LABORABLE
23,7,2019,18,599,677,1276,2019-07-23 17:00:00,2019-07-23 00:00:00,LABORABLE
23,7,2019,19,617,821,1438,2019-07-23 18:00:00,2019-07-23 00:00:00,LABORABLE
23,7,2019,20,671,802,1473,2019-07-23 19:00:00,2019-07-23 00:00:00,LABORABLE
23,7,2019,21,566,760,1326,2019-07-23 20:00:00,2019-07-23 00:00:00,LABORABLE
23,7,2019,22,515,609,1124,2019-07-23 21:00:00,2019-07-23 00:00:00,LABORABLE
23,7,2019,23,385,461,846,2019-07-23 22:00:00,2019-07-23 00:00:00,LABORABLE
23,7,2019,24,274,370,644,2019-07-23 23:00:00,2019-07-23 00:00:00,LABORABLE
24,7,2019,1,197,264,461,2019-07-24 00:00:00,2019-07-24 00:00:00,LABORABLE
24,7,2019,2,165,209,374,2019-07-24 01:00:00,2019-07-24 00:00:00,LABORABLE
24,7,2019,3,90,138,228,2019-07-24 02:00:00,2019-07-24 00:00:00,LABORABLE
24,7,2019,4,76,109,185,2019-07-24 03:00:00,2019-07-24 00:00:00,LABORABLE
24,7,2019,5,83,100,183,2019-07-24 04:00:00,2019-07-24 00:00:00,LABORABLE
24,7,2019,6,108,173,281,2019-07-24 05:00:00,2019-07-24 00:00:00,LABORABLE
24,7,2019,7,416,395,811,2019-07-24 06:00:00,2019-07-24 00:00:00,LABORABLE
24,7,2019,8,612,541,1153,2019-07-24 07:00:00,2019-07-24 00:00:00,LABORABLE
24,7,2019,9,582,613,1195,2019-07-24 08:00:00,2019-07-24 00:00:00,LABORABLE
24,7,2019,10,607,684,1291,2019-07-24 09:00:00,2019-07-24 00:00:00,LABORABLE
24,7,2019,11,529,699,1228,2019-07-24 10:00:00,2019-07-24 00:00:00,LABORABLE
24,7,2019,12,522,714,1236,2019-07-24 11:00:00,2019-07-24 00:00:00,LABORABLE
24,7,2019,13,448,589,1037,2019-07-24 12:00:00,2019-07-24 00:00:00,LABORABLE
24,7,2019,14,581,670,1251,2019-07-24 13:00:00,2019-07-24 00:00:00,LABORABLE
24,7,2019,15,576,706,1282,2019-07-24 14:00:00,2019-07-24 00:00:00,LABORABLE
24,7,2019,16,513,632,1145,2019-07-24 15:00:00,2019-07-24 00:00:00,LABORABLE
24,7,2019,17,567,623,1190,2019-07-24 16:00:00,2019-07-24 00:00:00,LABORABLE
24,7,2019,18,570,698,1268,2019-07-24 17:00:00,2019-07-24 00:00:00,LABORABLE
24,7,2019,19,649,788,1437,2019-07-24 18:00:00,2019-07-24 00:00:00,LABORABLE
24,7,2019,20,635,815,1450,2019-07-24 19:00:00,2019-07-24 00:00:00,LABORABLE
24,7,2019,21,557,682,1239,2019-07-24 20:00:00,2019-07-24 00:00:00,LABORABLE
24,7,2019,22,499,641,1140,2019-07-24 21:00:00,2019-07-24 00:00:00,LABORABLE
24,7,2019,23,423,552,975,2019-07-24 22:00:00,2019-07-24 00:00:00,LABORABLE
24,7,2019,24,277,425,702,2019-07-24 23:00:00,2019-07-24 00:00:00,LABORABLE
25,7,2019,1,247,387,634,2019-07-25 00:00:00,2019-07-25 00:00:00,LABORABLE
25,7,2019,2,166,211,377,2019-07-25 01:00:00,2019-07-25 00:00:00,LABORABLE
25,7,2019,3,118,169,287,2019-07-25 02:00:00,2019-07-25 00:00:00,LABORABLE
25,7,2019,4,95,139,234,2019-07-25 03:00:00,2019-07-25 00:00:00,LABORABLE
25,7,2019,5,105,109,214,2019-07-25 04:00:00,2019-07-25 00:00:00,LABORABLE
25,7,2019,6,110,169,279,2019-07-25 05:00:00,2019-07-25 00:00:00,LABORABLE
25,7,2019,7,425,375,800,2019-07-25 06:00:00,2019-07-25 00:00:00,LABORABLE
25,7,2019,8,625,562,1187,2019-07-25 07:00:00,2019-07-25 00:00:00,LABORABLE
25,7,2019,9,579,608,1187,2019-07-25 08:00:00,2019-07-25 00:00:00,LABORABLE
25,7,2019,10,577,610,1187,2019-07-25 09:00:00,2019-07-25 00:00:00,LABORABLE
25,7,2019,11,558,655,1213,2019-07-25 10:00:00,2019-07-25 00:00:00,LABORABLE
25,7,2019,12,552,750,1302,2019-07-25 11:00:00,2019-07-25 00:00:00,LABORABLE
25,7,2019,13,622,730,1352,2019-07-25 12:00:00,2019-07-25 00:00:00,LABORABLE
25,7,2019,14,634,728,1362,2019-07-25 13:00:00,2019-07-25 00:00:00,LABORABLE
25,7,2019,15,615,705,1320,2019-07-25 14:00:00,2019-07-25 00:00:00,LABORABLE
25,7,2019,16,581,601,1182,2019-07-25 15:00:00,2019-07-25 00:00:00,LABORABLE
25,7,2019,17,585,685,1270,2019-07-25 16:00:00,2019-07-25 00:00:00,LABORABLE
25,7,2019,18,598,734,1332,2019-07-25 17:00:00,2019-07-25 00:00:00,LABORABLE
25,7,2019,19,656,782,1438,2019-07-25 18:00:00,2019-07-25 00:00:00,LABORABLE
25,7,2019,20,648,774,1422,2019-07-25 19:00:00,2019-07-25 00:00:00,LABORABLE
25,7,2019,21,638,742,1380,2019-07-25 20:00:00,2019-07-25 00:00:00,LABORABLE
25,7,2019,22,532,620,1152,2019-07-25 21:00:00,2019-07-25 00:00:00,LABORABLE
25,7,2019,23,488,653,1141,2019-07-25 22:00:00,2019-07-25 00:00:00,LABORABLE
25,7,2019,24,318,477,795,2019-07-25 23:00:00,2019-07-25 00:00:00,LABORABLE
26,7,2019,1,235,352,587,2019-07-26 00:00:00,2019-07-26 00:00:00,LABORABLE
26,7,2019,2,175,300,475,2019-07-26 01:00:00,2019-07-26 00:00:00,LABORABLE
26,7,2019,3,124,219,343,2019-07-26 02:00:00,2019-07-26 00:00:00,LABORABLE
26,7,2019,4,100,153,253,2019-07-26 03:00:00,2019-07-26 00:00:00,LABORABLE
26,7,2019,5,108,165,273,2019-07-26 04:00:00,2019-07-26 00:00:00,LABORABLE
26,7,2019,6,127,186,313,2019-07-26 05:00:00,2019-07-26 00:00:00,LABORABLE
26,7,2019,7,414,369,783,2019-07-26 06:00:00,2019-07-26 00:00:00,LABORABLE
26,7,2019,8,636,592,1228,2019-07-26 07:00:00,2019-07-26 00:00:00,LABORABLE
26,7,2019,9,557,599,1156,2019-07-26 08:00:00,2019-07-26 00:00:00,LABORABLE
26,7,2019,10,591,619,1210,2019-07-26 09:00:00,2019-07-26 00:00:00,LABORABLE
26,7,2019,11,497,694,1191,2019-07-26 10:00:00,2019-07-26 00:00:00,LABORABLE
26,7,2019,12,574,732,1306,2019-07-26 11:00:00,2019-07-26 00:00:00,LABORABLE
26,7,2019,13,573,722,1295,2019-07-26 12:00:00,2019-07-26 00:00:00,LABORABLE
26,7,2019,14,497,626,1123,2019-07-26 13:00:00,2019-07-26 00:00:00,LABORABLE
26,7,2019,15,628,687,1315,2019-07-26 14:00:00,2019-07-26 00:00:00,LABORABLE
26,7,2019,16,592,618,1210,2019-07-26 15:00:00,2019-07-26 00:00:00,LABORABLE
26,7,2019,17,578,702,1280,2019-07-26 16:00:00,2019-07-26 00:00:00,LABORABLE
26,7,2019,18,626,779,1405,2019-07-26 17:00:00,2019-07-26 00:00:00,LABORABLE
26,7,2019,19,679,747,1426,2019-07-26 18:00:00,2019-07-26 00:00:00,LABORABLE
26,7,2019,20,668,865,1533,2019-07-26 19:00:00,2019-07-26 00:00:00,LABORABLE
26,7,2019,21,608,748,1356,2019-07-26 20:00:00,2019-07-26 00:00:00,LABORABLE
26,7,2019,22,564,744,1308,2019-07-26 21:00:00,2019-07-26 00:00:00,LABORABLE
26,7,2019,23,496,612,1108,2019-07-26 22:00:00,2019-07-26 00:00:00,LABORABLE
26,7,2019,24,413,518,931,2019-07-26 23:00:00,2019-07-26 00:00:00,LABORABLE
27,7,2019,1,350,482,832,2019-07-27 00:00:00,2019-07-27 00:00:00,LABORABLE
27,7,2019,2,296,370,666,2019-07-27 01:00:00,2019-07-27 00:00:00,LABORABLE
27,7,2019,3,213,332,545,2019-07-27 02:00:00,2019-07-27 00:00:00,LABORABLE
27,7,2019,4,146,223,369,2019-07-27 03:00:00,2019-07-27 00:00:00,LABORABLE
27,7,2019,5,134,202,336,2019-07-27 04:00:00,2019-07-27 00:00:00,LABORABLE
27,7,2019,6,152,211,363,2019-07-27 05:00:00,2019-07-27 00:00:00,LABORABLE
27,7,2019,7,223,264,487,2019-07-27 06:00:00,2019-07-27 00:00:00,LABORABLE
27,7,2019,8,285,301,586,2019-07-27 07:00:00,2019-07-27 00:00:00,LABORABLE
27,7,2019,9,353,380,733,2019-07-27 08:00:00,2019-07-27 00:00:00,LABORABLE
27,7,2019,10,425,472,897,2019-07-27 09:00:00,2019-07-27 00:00:00,LABORABLE
27,7,2019,11,481,527,1008,2019-07-27 10:00:00,2019-07-27 00:00:00,LABORABLE
27,7,2019,12,562,650,1212,2019-07-27 11:00:00,2019-07-27 00:00:00,LABORABLE
27,7,2019,13,583,666,1249,2019-07-27 12:00:00,2019-07-27 00:00:00,LABORABLE
27,7,2019,14,556,790,1346,2019-07-27 13:00:00,2019-07-27 00:00:00,LABORABLE
27,7,2019,15,520,743,1263,2019-07-27 14:00:00,2019-07-27 00:00:00,LABORABLE
27,7,2019,16,415,640,1055,2019-07-27 15:00:00,2019-07-27 00:00:00,LABORABLE
27,7,2019,17,405,596,1001,2019-07-27 16:00:00,2019-07-27 00:00:00,LABORABLE
27,7,2019,18,443,675,1118,2019-07-27 17:00:00,2019-07-27 00:00:00,LABORABLE
27,7,2019,19,518,637,1155,2019-07-27 18:00:00,2019-07-27 00:00:00,LABORABLE
27,7,2019,20,538,693,1231,2019-07-27 19:00:00,2019-07-27 00:00:00,LABORABLE
27,7,2019,21,525,699,1224,2019-07-27 20:00:00,2019-07-27 00:00:00,LABORABLE
27,7,2019,22,493,634,1127,2019-07-27 21:00:00,2019-07-27 00:00:00,LABORABLE
27,7,2019,23,523,608,1131,2019-07-27 22:00:00,2019-07-27 00:00:00,LABORABLE
27,7,2019,24,412,529,941,2019-07-27 23:00:00,2019-07-27 00:00:00,LABORABLE
28,7,2019,1,365,452,817,2019-07-28 00:00:00,2019-07-28 00:00:00,LABORABLE
28,7,2019,2,384,429,813,2019-07-28 01:00:00,2019-07-28 00:00:00,LABORABLE
28,7,2019,3,246,396,642,2019-07-28 02:00:00,2019-07-28 00:00:00,LABORABLE
28,7,2019,4,184,303,487,2019-07-28 03:00:00,2019-07-28 00:00:00,LABORABLE
28,7,2019,5,154,272,426,2019-07-28 04:00:00,2019-07-28 00:00:00,LABORABLE
28,7,2019,6,158,272,430,2019-07-28 05:00:00,2019-07-28 00:00:00,LABORABLE
28,7,2019,7,191,278,469,2019-07-28 06:00:00,2019-07-28 00:00:00,LABORABLE
28,7,2019,8,198,234,432,2019-07-28 07:00:00,2019-07-28 00:00:00,LABORABLE
28,7,2019,9,193,250,443,2019-07-28 08:00:00,2019-07-28 00:00:00,LABORABLE
28,7,2019,10,313,364,677,2019-07-28 09:00:00,2019-07-28 00:00:00,LABORABLE
28,7,2019,11,379,451,830,2019-07-28 10:00:00,2019-07-28 00:00:00,LABORABLE
28,7,2019,12,416,522,938,2019-07-28 11:00:00,2019-07-28 00:00:00,LABORABLE
28,7,2019,13,454,573,1027,2019-07-28 12:00:00,2019-07-28 00:00:00,LABORABLE
28,7,2019,14,509,652,1161,2019-07-28 13:00:00,2019-07-28 00:00:00,LABORABLE
28,7,2019,15,474,629,1103,2019-07-28 14:00:00,2019-07-28 00:00:00,LABORABLE
28,7,2019,16,349,554,903,2019-07-28 15:00:00,2019-07-28 00:00:00,LABORABLE
28,7,2019,17,352,553,905,2019-07-28 16:00:00,2019-07-28 00:00:00,LABORABLE
28,7,2019,18,392,521,913,2019-07-28 17:00:00,2019-07-28 00:00:00,LABORABLE
28,7,2019,19,465,602,1067,2019-07-28 18:00:00,2019-07-28 00:00:00,LABORABLE
28,7,2019,20,479,675,1154,2019-07-28 19:00:00,2019-07-28 00:00:00,LABORABLE
28,7,2019,21,455,632,1087,2019-07-28 20:00:00,2019-07-28 00:00:00,LABORABLE
28,7,2019,22,502,675,1177,2019-07-28 21:00:00,2019-07-28 00:00:00,LABORABLE
28,7,2019,23,407,574,981,2019-07-28 22:00:00,2019-07-28 00:00:00,LABORABLE
28,7,2019,24,353,462,815,2019-07-28 23:00:00,2019-07-28 00:00:00,LABORABLE
29,7,2019,1,252,382,634,2019-07-29 00:00:00,2019-07-29 00:00:00,LABORABLE
29,7,2019,2,147,254,401,2019-07-29 01:00:00,2019-07-29 00:00:00,LABORABLE
29,7,2019,3,106,190,296,2019-07-29 02:00:00,2019-07-29 00:00:00,LABORABLE
29,7,2019,4,68,128,196,2019-07-29 03:00:00,2019-07-29 00:00:00,LABORABLE
29,7,2019,5,83,121,204,2019-07-29 04:00:00,2019-07-29 00:00:00,LABORABLE
29,7,2019,6,165,153,318,2019-07-29 05:00:00,2019-07-29 00:00:00,LABORABLE
29,7,2019,7,288,383,671,2019-07-29 06:00:00,2019-07-29 00:00:00,LABORABLE
29,7,2019,8,609,535,1144,2019-07-29 07:00:00,2019-07-29 00:00:00,LABORABLE
29,7,2019,9,523,563,1086,2019-07-29 08:00:00,2019-07-29 00:00:00,LABORABLE
29,7,2019,10,581,651,1232,2019-07-29 09:00:00,2019-07-29 00:00:00,LABORABLE
29,7,2019,11,505,709,1214,2019-07-29 10:00:00,2019-07-29 00:00:00,LABORABLE
29,7,2019,12,565,721,1286,2019-07-29 11:00:00,2019-07-29 00:00:00,LABORABLE
29,7,2019,13,548,663,1211,2019-07-29 12:00:00,2019-07-29 00:00:00,LABORABLE
29,7,2019,14,562,701,1263,2019-07-29 13:00:00,2019-07-29 00:00:00,LABORABLE
29,7,2019,15,583,695,1278,2019-07-29 14:00:00,2019-07-29 00:00:00,LABORABLE
29,7,2019,16,530,622,1152,2019-07-29 15:00:00,2019-07-29 00:00:00,LABORABLE
29,7,2019,17,551,702,1253,2019-07-29 16:00:00,2019-07-29 00:00:00,LABORABLE
29,7,2019,18,577,740,1317,2019-07-29 17:00:00,2019-07-29 00:00:00,LABORABLE
29,7,2019,19,613,761,1374,2019-07-29 18:00:00,2019-07-29 00:00:00,LABORABLE
29,7,2019,20,611,739,1350,2019-07-29 19:00:00,2019-07-29 00:00:00,LABORABLE
29,7,2019,21,591,758,1349,2019-07-29 20:00:00,2019-07-29 00:00:00,LABORABLE
29,7,2019,22,468,620,1088,2019-07-29 21:00:00,2019-07-29 00:00:00,LABORABLE
29,7,2019,23,389,506,895,2019-07-29 22:00:00,2019-07-29 00:00:00,LABORABLE
29,7,2019,24,256,358,614,2019-07-29 23:00:00,2019-07-29 00:00:00,LABORABLE
30,7,2019,1,179,282,461,2019-07-30 00:00:00,2019-07-30 00:00:00,LABORABLE
30,7,2019,2,137,210,347,2019-07-30 01:00:00,2019-07-30 00:00:00,LABORABLE
30,7,2019,3,93,162,255,2019-07-30 02:00:00,2019-07-30 00:00:00,LABORABLE
30,7,2019,4,86,102,188,2019-07-30 03:00:00,2019-07-30 00:00:00,LABORABLE
30,7,2019,5,88,100,188,2019-07-30 04:00:00,2019-07-30 00:00:00,LABORABLE
30,7,2019,6,104,170,274,2019-07-30 05:00:00,2019-07-30 00:00:00,LABORABLE
30,7,2019,7,282,404,686,2019-07-30 06:00:00,2019-07-30 00:00:00,LABORABLE
30,7,2019,8,613,559,1172,2019-07-30 07:00:00,2019-07-30 00:00:00,LABORABLE
30,7,2019,9,541,585,1126,2019-07-30 08:00:00,2019-07-30 00:00:00,LABORABLE
30,7,2019,10,566,667,1233,2019-07-30 09:00:00,2019-07-30 00:00:00,LABORABLE
30,7,2019,11,534,646,1180,2019-07-30 10:00:00,2019-07-30 00:00:00,LABORABLE
30,7,2019,12,570,686,1256,2019-07-30 11:00:00,2019-07-30 00:00:00,LABORABLE
30,7,2019,13,573,766,1339,2019-07-30 12:00:00,2019-07-30 00:00:00,LABORABLE
30,7,2019,14,591,758,1349,2019-07-30 13:00:00,2019-07-30 00:00:00,LABORABLE
30,7,2019,15,608,686,1294,2019-07-30 14:00:00,2019-07-30 00:00:00,LABORABLE
30,7,2019,16,539,662,1201,2019-07-30 15:00:00,2019-07-30 00:00:00,LABORABLE
30,7,2019,17,596,646,1242,2019-07-30 16:00:00,2019-07-30 00:00:00,LABORABLE
30,7,2019,18,599,702,1301,2019-07-30 17:00:00,2019-07-30 00:00:00,LABORABLE
30,7,2019,19,629,822,1451,2019-07-30 18:00:00,2019-07-30 00:00:00,LABORABLE
30,7,2019,20,632,787,1419,2019-07-30 19:00:00,2019-07-30 00:00:00,LABORABLE
30,7,2019,21,622,764,1386,2019-07-30 20:00:00,2019-07-30 00:00:00,LABORABLE
30,7,2019,22,527,728,1255,2019-07-30 21:00:00,2019-07-30 00:00:00,LABORABLE
30,7,2019,23,416,591,1007,2019-07-30 22:00:00,2019-07-30 00:00:00,LABORABLE
30,7,2019,24,273,431,704,2019-07-30 23:00:00,2019-07-30 00:00:00,LABORABLE
31,7,2019,1,206,218,424,2019-07-31 00:00:00,2019-07-31 00:00:00,LABORABLE
31,7,2019,2,168,146,314,2019-07-31 01:00:00,2019-07-31 00:00:00,LABORABLE
31,7,2019,3,111,90,201,2019-07-31 02:00:00,2019-07-31 00:00:00,LABORABLE
31,7,2019,4,82,83,165,2019-07-31 03:00:00,2019-07-31 00:00:00,LABORABLE
31,7,2019,5,84,70,154,2019-07-31 04:00:00,2019-07-31 00:00:00,LABORABLE
31,7,2019,6,173,125,298,2019-07-31 05:00:00,2019-07-31 00:00:00,LABORABLE
31,7,2019,7,439,292,731,2019-07-31 06:00:00,2019-07-31 00:00:00,LABORABLE
31,7,2019,8,644,398,1042,2019-07-31 07:00:00,2019-07-31 00:00:00,LABORABLE
31,7,2019,9,534,406,940,2019-07-31 08:00:00,2019-07-31 00:00:00,LABORABLE
31,7,2019,10,591,408,999,2019-07-31 09:00:00,2019-07-31 00:00:00,LABORABLE
31,7,2019,11,508,429,937,2019-07-31 10:00:00,2019-07-31 00:00:00,LABORABLE
31,7,2019,12,543,444,987,2019-07-31 11:00:00,2019-07-31 00:00:00,LABORABLE
31,7,2019,13,599,463,1062,2019-07-31 12:00:00,2019-07-31 00:00:00,LABORABLE
31,7,2019,14,531,400,931,2019-07-31 13:00:00,2019-07-31 00:00:00,LABORABLE
31,7,2019,15,617,409,1026,2019-07-31 14:00:00,2019-07-31 00:00:00,LABORABLE
31,7,2019,16,579,411,990,2019-07-31 15:00:00,2019-07-31 00:00:00,LABORABLE
31,7,2019,17,557,439,996,2019-07-31 16:00:00,2019-07-31 00:00:00,LABORABLE
31,7,2019,18,632,426,1058,2019-07-31 17:00:00,2019-07-31 00:00:00,LABORABLE
31,7,2019,19,657,508,1165,2019-07-31 18:00:00,2019-07-31 00:00:00,LABORABLE
31,7,2019,20,704,454,1158,2019-07-31 19:00:00,2019-07-31 00:00:00,LABORABLE
31,7,2019,21,676,495,1171,2019-07-31 20:00:00,2019-07-31 00:00:00,LABORABLE
31,7,2019,22,531,388,919,2019-07-31 21:00:00,2019-07-31 00:00:00,LABORABLE
31,7,2019,23,422,336,758,2019-07-31 22:00:00,2019-07-31 00:00:00,LABORABLE
31,7,2019,24,353,230,583,2019-07-31 23:00:00,2019-07-31 00:00:00,LABORABLE
1,8,2019,1,223,347,570,2019-08-01 00:00:00,2019-01-08 00:00:00,LABORABLE
1,8,2019,2,173,231,404,2019-08-01 01:00:00,2019-01-08 00:00:00,LABORABLE
1,8,2019,3,107,180,287,2019-08-01 02:00:00,2019-01-08 00:00:00,LABORABLE
1,8,2019,4,80,129,209,2019-08-01 03:00:00,2019-01-08 00:00:00,LABORABLE
1,8,2019,5,89,105,194,2019-08-01 04:00:00,2019-01-08 00:00:00,LABORABLE
1,8,2019,6,102,157,259,2019-08-01 05:00:00,2019-01-08 00:00:00,LABORABLE
1,8,2019,7,239,336,575,2019-08-01 06:00:00,2019-01-08 00:00:00,LABORABLE
1,8,2019,8,628,495,1123,2019-08-01 07:00:00,2019-01-08 00:00:00,LABORABLE
1,8,2019,9,514,534,1048,2019-08-01 08:00:00,2019-01-08 00:00:00,LABORABLE
1,8,2019,10,550,606,1156,2019-08-01 09:00:00,2019-01-08 00:00:00,LABORABLE
1,8,2019,11,526,655,1181,2019-08-01 10:00:00,2019-01-08 00:00:00,LABORABLE
1,8,2019,12,549,680,1229,2019-08-01 11:00:00,2019-01-08 00:00:00,LABORABLE
1,8,2019,13,576,692,1268,2019-08-01 12:00:00,2019-01-08 00:00:00,LABORABLE
1,8,2019,14,576,697,1273,2019-08-01 13:00:00,2019-01-08 00:00:00,LABORABLE
1,8,2019,15,574,679,1253,2019-08-01 14:00:00,2019-01-08 00:00:00,LABORABLE
1,8,2019,16,505,642,1147,2019-08-01 15:00:00,2019-01-08 00:00:00,LABORABLE
1,8,2019,17,503,585,1088,2019-08-01 16:00:00,2019-01-08 00:00:00,LABORABLE
1,8,2019,18,577,668,1245,2019-08-01 17:00:00,2019-01-08 00:00:00,LABORABLE
1,8,2019,19,642,790,1432,2019-08-01 18:00:00,2019-01-08 00:00:00,LABORABLE
1,8,2019,20,671,776,1447,2019-08-01 19:00:00,2019-01-08 00:00:00,LABORABLE
1,8,2019,21,644,782,1426,2019-08-01 20:00:00,2019-01-08 00:00:00,LABORABLE
1,8,2019,22,553,660,1213,2019-08-01 21:00:00,2019-01-08 00:00:00,LABORABLE
1,8,2019,23,519,588,1107,2019-08-01 22:00:00,2019-01-08 00:00:00,LABORABLE
1,8,2019,24,326,473,799,2019-08-01 23:00:00,2019-01-08 00:00:00,LABORABLE
2,8,2019,1,242,362,604,2019-08-02 00:00:00,2019-02-08 00:00:00,LABORABLE
2,8,2019,2,157,263,420,2019-08-02 01:00:00,2019-02-08 00:00:00,LABORABLE
2,8,2019,3,102,179,281,2019-08-02 02:00:00,2019-02-08 00:00:00,LABORABLE
2,8,2019,4,95,156,251,2019-08-02 03:00:00,2019-02-08 00:00:00,LABORABLE
2,8,2019,5,79,111,190,2019-08-02 04:00:00,2019-02-08 00:00:00,LABORABLE
2,8,2019,6,149,181,330,2019-08-02 05:00:00,2019-02-08 00:00:00,LABORABLE
2,8,2019,7,384,367,751,2019-08-02 06:00:00,2019-02-08 00:00:00,LABORABLE
2,8,2019,8,599,542,1141,2019-08-02 07:00:00,2019-02-08 00:00:00,LABORABLE
2,8,2019,9,631,450,1081,2019-08-02 08:00:00,2019-02-08 00:00:00,LABORABLE
2,8,2019,10,521,596,1117,2019-08-02 09:00:00,2019-02-08 00:00:00,LABORABLE
2,8,2019,11,491,630,1121,2019-08-02 10:00:00,2019-02-08 00:00:00,LABORABLE
2,8,2019,12,539,718,1257,2019-08-02 11:00:00,2019-02-08 00:00:00,LABORABLE
2,8,2019,13,580,750,1330,2019-08-02 12:00:00,2019-02-08 00:00:00,LABORABLE
2,8,2019,14,652,701,1353,2019-08-02 13:00:00,2019-02-08 00:00:00,LABORABLE
2,8,2019,15,597,675,1272,2019-08-02 14:00:00,2019-02-08 00:00:00,LABORABLE
2,8,2019,16,615,655,1270,2019-08-02 15:00:00,2019-02-08 00:00:00,LABORABLE
2,8,2019,17,532,617,1149,2019-08-02 16:00:00,2019-02-08 00:00:00,LABORABLE
2,8,2019,18,591,740,1331,2019-08-02 17:00:00,2019-02-08 00:00:00,LABORABLE
2,8,2019,19,621,779,1400,2019-08-02 18:00:00,2019-02-08 00:00:00,LABORABLE
2,8,2019,20,656,792,1448,2019-08-02 19:00:00,2019-02-08 00:00:00,LABORABLE
2,8,2019,21,585,804,1389,2019-08-02 20:00:00,2019-02-08 00:00:00,LABORABLE
2,8,2019,22,607,705,1312,2019-08-02 21:00:00,2019-02-08 00:00:00,LABORABLE
2,8,2019,23,531,611,1142,2019-08-02 22:00:00,2019-02-08 00:00:00,LABORABLE
2,8,2019,24,406,536,942,2019-08-02 23:00:00,2019-02-08 00:00:00,LABORABLE
3,8,2019,1,0,361,361,2019-08-03 00:00:00,2019-03-08 00:00:00,LABORABLE
3,8,2019,2,0,229,229,2019-08-03 01:00:00,2019-03-08 00:00:00,LABORABLE
3,8,2019,3,0,183,183,2019-08-03 02:00:00,2019-03-08 00:00:00,LABORABLE
3,8,2019,4,0,113,113,2019-08-03 03:00:00,2019-03-08 00:00:00,LABORABLE
3,8,2019,5,0,99,99,2019-08-03 04:00:00,2019-03-08 00:00:00,LABORABLE
3,8,2019,6,0,139,139,2019-08-03 05:00:00,2019-03-08 00:00:00,LABORABLE
3,8,2019,7,0,335,335,2019-08-03 06:00:00,2019-03-08 00:00:00,LABORABLE
3,8,2019,8,0,517,517,2019-08-03 07:00:00,2019-03-08 00:00:00,LABORABLE
3,8,2019,9,0,576,576,2019-08-03 08:00:00,2019-03-08 00:00:00,LABORABLE
3,8,2019,10,0,641,641,2019-08-03 09:00:00,2019-03-08 00:00:00,LABORABLE
3,8,2019,11,0,634,634,2019-08-03 10:00:00,2019-03-08 00:00:00,LABORABLE
3,8,2019,12,0,693,693,2019-08-03 11:00:00,2019-03-08 00:00:00,LABORABLE
3,8,2019,13,0,687,687,2019-08-03 12:00:00,2019-03-08 00:00:00,LABORABLE
3,8,2019,14,0,700,700,2019-08-03 13:00:00,2019-03-08 00:00:00,LABORABLE
3,8,2019,15,0,672,672,2019-08-03 14:00:00,2019-03-08 00:00:00,LABORABLE
3,8,2019,16,0,576,576,2019-08-03 15:00:00,2019-03-08 00:00:00,LABORABLE
3,8,2019,17,0,626,626,2019-08-03 16:00:00,2019-03-08 00:00:00,LABORABLE
3,8,2019,18,0,680,680,2019-08-03 17:00:00,2019-03-08 00:00:00,LABORABLE
3,8,2019,19,0,722,722,2019-08-03 18:00:00,2019-03-08 00:00:00,LABORABLE
3,8,2019,20,0,805,805,2019-08-03 19:00:00,2019-03-08 00:00:00,LABORABLE
3,8,2019,21,0,719,719,2019-08-03 20:00:00,2019-03-08 00:00:00,LABORABLE
3,8,2019,22,0,691,691,2019-08-03 21:00:00,2019-03-08 00:00:00,LABORABLE
3,8,2019,23,0,592,592,2019-08-03 22:00:00,2019-03-08 00:00:00,LABORABLE
3,8,2019,24,0,419,419,2019-08-03 23:00:00,2019-03-08 00:00:00,LABORABLE
4,8,2019,1,0,330,330,2019-08-04 00:00:00,2019-04-08 00:00:00,LABORABLE
4,8,2019,2,0,229,229,2019-08-04 01:00:00,2019-04-08 00:00:00,LABORABLE
4,8,2019,3,0,203,203,2019-08-04 02:00:00,2019-04-08 00:00:00,LABORABLE
4,8,2019,4,0,141,141,2019-08-04 03:00:00,2019-04-08 00:00:00,LABORABLE
4,8,2019,5,0,114,114,2019-08-04 04:00:00,2019-04-08 00:00:00,LABORABLE
4,8,2019,6,0,170,170,2019-08-04 05:00:00,2019-04-08 00:00:00,LABORABLE
4,8,2019,7,0,351,351,2019-08-04 06:00:00,2019-04-08 00:00:00,LABORABLE
4,8,2019,8,0,474,474,2019-08-04 07:00:00,2019-04-08 00:00:00,LABORABLE
4,8,2019,9,0,559,559,2019-08-04 08:00:00,2019-04-08 00:00:00,LABORABLE
4,8,2019,10,0,600,600,2019-08-04 09:00:00,2019-04-08 00:00:00,LABORABLE
4,8,2019,11,0,701,701,2019-08-04 10:00:00,2019-04-08 00:00:00,LABORABLE
4,8,2019,12,0,736,736,2019-08-04 11:00:00,2019-04-08 00:00:00,LABORABLE
4,8,2019,13,0,732,732,2019-08-04 12:00:00,2019-04-08 00:00:00,LABORABLE
4,8,2019,14,0,754,754,2019-08-04 13:00:00,2019-04-08 00:00:00,LABORABLE
4,8,2019,15,0,764,764,2019-08-04 14:00:00,2019-04-08 00:00:00,LABORABLE
4,8,2019,16,0,643,643,2019-08-04 15:00:00,2019-04-08 00:00:00,LABORABLE
4,8,2019,17,0,689,689,2019-08-04 16:00:00,2019-04-08 00:00:00,LABORABLE
4,8,2019,18,0,644,644,2019-08-04 17:00:00,2019-04-08 00:00:00,LABORABLE
4,8,2019,19,0,726,726,2019-08-04 18:00:00,2019-04-08 00:00:00,LABORABLE
4,8,2019,20,0,811,811,2019-08-04 19:00:00,2019-04-08 00:00:00,LABORABLE
4,8,2019,21,0,811,811,2019-08-04 20:00:00,2019-04-08 00:00:00,LABORABLE
4,8,2019,22,0,756,756,2019-08-04 21:00:00,2019-04-08 00:00:00,LABORABLE
4,8,2019,23,0,567,567,2019-08-04 22:00:00,2019-04-08 00:00:00,LABORABLE
4,8,2019,24,0,506,506,2019-08-04 23:00:00,2019-04-08 00:00:00,LABORABLE
5,8,2019,1,245,376,621,2019-08-05 00:00:00,2019-05-08 00:00:00,LABORABLE
5,8,2019,2,159,315,474,2019-08-05 01:00:00,2019-05-08 00:00:00,LABORABLE
5,8,2019,3,108,215,323,2019-08-05 02:00:00,2019-05-08 00:00:00,LABORABLE
5,8,2019,4,77,155,232,2019-08-05 03:00:00,2019-05-08 00:00:00,LABORABLE
5,8,2019,5,80,143,223,2019-08-05 04:00:00,2019-05-08 00:00:00,LABORABLE
5,8,2019,6,112,181,293,2019-08-05 05:00:00,2019-05-08 00:00:00,LABORABLE
5,8,2019,7,249,336,585,2019-08-05 06:00:00,2019-05-08 00:00:00,LABORABLE
5,8,2019,8,559,444,1003,2019-08-05 07:00:00,2019-05-08 00:00:00,LABORABLE
5,8,2019,9,496,461,957,2019-08-05 08:00:00,2019-05-08 00:00:00,LABORABLE
5,8,2019,10,493,540,1033,2019-08-05 09:00:00,2019-05-08 00:00:00,LABORABLE
5,8,2019,11,475,621,1096,2019-08-05 10:00:00,2019-05-08 00:00:00,LABORABLE
5,8,2019,12,582,723,1305,2019-08-05 11:00:00,2019-05-08 00:00:00,LABORABLE
5,8,2019,13,515,702,1217,2019-08-05 12:00:00,2019-05-08 00:00:00,LABORABLE
5,8,2019,14,533,712,1245,2019-08-05 13:00:00,2019-05-08 00:00:00,LABORABLE
5,8,2019,15,579,707,1286,2019-08-05 14:00:00,2019-05-08 00:00:00,LABORABLE
5,8,2019,16,504,611,1115,2019-08-05 15:00:00,2019-05-08 00:00:00,LABORABLE
5,8,2019,17,481,615,1096,2019-08-05 16:00:00,2019-05-08 00:00:00,LABORABLE
5,8,2019,18,478,715,1193,2019-08-05 17:00:00,2019-05-08 00:00:00,LABORABLE
5,8,2019,19,597,727,1324,2019-08-05 18:00:00,2019-05-08 00:00:00,LABORABLE
5,8,2019,20,593,777,1370,2019-08-05 19:00:00,2019-05-08 00:00:00,LABORABLE
5,8,2019,21,535,690,1225,2019-08-05 20:00:00,2019-05-08 00:00:00,LABORABLE
5,8,2019,22,459,628,1087,2019-08-05 21:00:00,2019-05-08 00:00:00,LABORABLE
5,8,2019,23,381,516,897,2019-08-05 22:00:00,2019-05-08 00:00:00,LABORABLE
5,8,2019,24,262,398,660,2019-08-05 23:00:00,2019-05-08 00:00:00,LABORABLE
6,8,2019,1,180,292,472,2019-08-06 00:00:00,2019-06-08 00:00:00,LABORABLE
6,8,2019,2,136,216,352,2019-08-06 01:00:00,2019-06-08 00:00:00,LABORABLE
6,8,2019,3,80,141,221,2019-08-06 02:00:00,2019-06-08 00:00:00,LABORABLE
6,8,2019,4,84,110,194,2019-08-06 03:00:00,2019-06-08 00:00:00,LABORABLE
6,8,2019,5,72,78,150,2019-08-06 04:00:00,2019-06-08 00:00:00,LABORABLE
6,8,2019,6,97,141,238,2019-08-06 05:00:00,2019-06-08 00:00:00,LABORABLE
6,8,2019,7,234,326,560,2019-08-06 06:00:00,2019-06-08 00:00:00,LABORABLE
6,8,2019,8,567,478,1045,2019-08-06 07:00:00,2019-06-08 00:00:00,LABORABLE
6,8,2019,9,489,521,1010,2019-08-06 08:00:00,2019-06-08 00:00:00,LABORABLE
6,8,2019,10,478,557,1035,2019-08-06 09:00:00,2019-06-08 00:00:00,LABORABLE
6,8,2019,11,507,636,1143,2019-08-06 10:00:00,2019-06-08 00:00:00,LABORABLE
6,8,2019,12,471,655,1126,2019-08-06 11:00:00,2019-06-08 00:00:00,LABORABLE
6,8,2019,13,564,707,1271,2019-08-06 12:00:00,2019-06-08 00:00:00,LABORABLE
6,8,2019,14,583,713,1296,2019-08-06 13:00:00,2019-06-08 00:00:00,LABORABLE
6,8,2019,15,555,708,1263,2019-08-06 14:00:00,2019-06-08 00:00:00,LABORABLE
6,8,2019,16,441,579,1020,2019-08-06 15:00:00,2019-06-08 00:00:00,LABORABLE
6,8,2019,17,444,611,1055,2019-08-06 16:00:00,2019-06-08 00:00:00,LABORABLE
6,8,2019,18,493,675,1168,2019-08-06 17:00:00,2019-06-08 00:00:00,LABORABLE
6,8,2019,19,600,721,1321,2019-08-06 18:00:00,2019-06-08 00:00:00,LABORABLE
6,8,2019,20,598,791,1389,2019-08-06 19:00:00,2019-06-08 00:00:00,LABORABLE
6,8,2019,21,559,734,1293,2019-08-06 20:00:00,2019-06-08 00:00:00,LABORABLE
6,8,2019,22,481,625,1106,2019-08-06 21:00:00,2019-06-08 00:00:00,LABORABLE
6,8,2019,23,408,499,907,2019-08-06 22:00:00,2019-06-08 00:00:00,LABORABLE
6,8,2019,24,259,410,669,2019-08-06 23:00:00,2019-06-08 00:00:00,LABORABLE
7,8,2019,1,193,285,478,2019-08-07 00:00:00,2019-07-08 00:00:00,LABORABLE
7,8,2019,2,134,216,350,2019-08-07 01:00:00,2019-07-08 00:00:00,LABORABLE
7,8,2019,3,84,153,237,2019-08-07 02:00:00,2019-07-08 00:00:00,LABORABLE
7,8,2019,4,77,128,205,2019-08-07 03:00:00,2019-07-08 00:00:00,LABORABLE
7,8,2019,5,79,100,179,2019-08-07 04:00:00,2019-07-08 00:00:00,LABORABLE
7,8,2019,6,97,145,242,2019-08-07 05:00:00,2019-07-08 00:00:00,LABORABLE
7,8,2019,7,353,306,659,2019-08-07 06:00:00,2019-07-08 00:00:00,LABORABLE
7,8,2019,8,577,453,1030,2019-08-07 07:00:00,2019-07-08 00:00:00,LABORABLE
7,8,2019,9,479,521,1000,2019-08-07 08:00:00,2019-07-08 00:00:00,LABORABLE
7,8,2019,10,495,550,1045,2019-08-07 09:00:00,2019-07-08 00:00:00,LABORABLE
7,8,2019,11,483,567,1050,2019-08-07 10:00:00,2019-07-08 00:00:00,LABORABLE
7,8,2019,12,518,642,1160,2019-08-07 11:00:00,2019-07-08 00:00:00,LABORABLE
7,8,2019,13,577,650,1227,2019-08-07 12:00:00,2019-07-08 00:00:00,LABORABLE
7,8,2019,14,540,634,1174,2019-08-07 13:00:00,2019-07-08 00:00:00,LABORABLE
7,8,2019,15,584,721,1305,2019-08-07 14:00:00,2019-07-08 00:00:00,LABORABLE
7,8,2019,16,458,629,1087,2019-08-07 15:00:00,2019-07-08 00:00:00,LABORABLE
7,8,2019,17,481,607,1088,2019-08-07 16:00:00,2019-07-08 00:00:00,LABORABLE
7,8,2019,18,552,609,1161,2019-08-07 17:00:00,2019-07-08 00:00:00,LABORABLE
7,8,2019,19,609,741,1350,2019-08-07 18:00:00,2019-07-08 00:00:00,LABORABLE
7,8,2019,20,584,825,1409,2019-08-07 19:00:00,2019-07-08 00:00:00,LABORABLE
7,8,2019,21,531,705,1236,2019-08-07 20:00:00,2019-07-08 00:00:00,LABORABLE
7,8,2019,22,484,676,1160,2019-08-07 21:00:00,2019-07-08 00:00:00,LABORABLE
7,8,2019,23,416,523,939,2019-08-07 22:00:00,2019-07-08 00:00:00,LABORABLE
7,8,2019,24,270,407,677,2019-08-07 23:00:00,2019-07-08 00:00:00,LABORABLE
8,8,2019,1,208,341,549,2019-08-08 00:00:00,2019-08-08 00:00:00,LABORABLE
8,8,2019,2,134,246,380,2019-08-08 01:00:00,2019-08-08 00:00:00,LABORABLE
8,8,2019,3,101,168,269,2019-08-08 02:00:00,2019-08-08 00:00:00,LABORABLE
8,8,2019,4,66,117,183,2019-08-08 03:00:00,2019-08-08 00:00:00,LABORABLE
8,8,2019,5,76,101,177,2019-08-08 04:00:00,2019-08-08 00:00:00,LABORABLE
8,8,2019,6,144,160,304,2019-08-08 05:00:00,2019-08-08 00:00:00,LABORABLE
8,8,2019,7,348,295,643,2019-08-08 06:00:00,2019-08-08 00:00:00,LABORABLE
8,8,2019,8,600,432,1032,2019-08-08 07:00:00,2019-08-08 00:00:00,LABORABLE
8,8,2019,9,470,515,985,2019-08-08 08:00:00,2019-08-08 00:00:00,LABORABLE
8,8,2019,10,396,518,914,2019-08-08 09:00:00,2019-08-08 00:00:00,LABORABLE
8,8,2019,11,507,586,1093,2019-08-08 10:00:00,2019-08-08 00:00:00,LABORABLE
8,8,2019,12,466,648,1114,2019-08-08 11:00:00,2019-08-08 00:00:00,LABORABLE
8,8,2019,13,544,668,1212,2019-08-08 12:00:00,2019-08-08 00:00:00,LABORABLE
8,8,2019,14,533,708,1241,2019-08-08 13:00:00,2019-08-08 00:00:00,LABORABLE
8,8,2019,15,531,696,1227,2019-08-08 14:00:00,2019-08-08 00:00:00,LABORABLE
8,8,2019,16,449,590,1039,2019-08-08 15:00:00,2019-08-08 00:00:00,LABORABLE
8,8,2019,17,471,614,1085,2019-08-08 16:00:00,2019-08-08 00:00:00,LABORABLE
8,8,2019,18,514,676,1190,2019-08-08 17:00:00,2019-08-08 00:00:00,LABORABLE
8,8,2019,19,567,753,1320,2019-08-08 18:00:00,2019-08-08 00:00:00,LABORABLE
8,8,2019,20,596,741,1337,2019-08-08 19:00:00,2019-08-08 00:00:00,LABORABLE
8,8,2019,21,573,762,1335,2019-08-08 20:00:00,2019-08-08 00:00:00,LABORABLE
8,8,2019,22,566,640,1206,2019-08-08 21:00:00,2019-08-08 00:00:00,LABORABLE
8,8,2019,23,468,538,1006,2019-08-08 22:00:00,2019-08-08 00:00:00,LABORABLE
8,8,2019,24,321,420,741,2019-08-08 23:00:00,2019-08-08 00:00:00,LABORABLE
9,8,2019,1,211,334,545,2019-08-09 00:00:00,2019-09-08 00:00:00,LABORABLE
9,8,2019,2,152,240,392,2019-08-09 01:00:00,2019-09-08 00:00:00,LABORABLE
9,8,2019,3,106,185,291,2019-08-09 02:00:00,2019-09-08 00:00:00,LABORABLE
9,8,2019,4,86,153,239,2019-08-09 03:00:00,2019-09-08 00:00:00,LABORABLE
9,8,2019,5,99,122,221,2019-08-09 04:00:00,2019-09-08 00:00:00,LABORABLE
9,8,2019,6,141,163,304,2019-08-09 05:00:00,2019-09-08 00:00:00,LABORABLE
9,8,2019,7,338,310,648,2019-08-09 06:00:00,2019-09-08 00:00:00,LABORABLE
9,8,2019,8,528,458,986,2019-08-09 07:00:00,2019-09-08 00:00:00,LABORABLE
9,8,2019,9,437,480,917,2019-08-09 08:00:00,2019-09-08 00:00:00,LABORABLE
9,8,2019,10,500,566,1066,2019-08-09 09:00:00,2019-09-08 00:00:00,LABORABLE
9,8,2019,11,493,595,1088,2019-08-09 10:00:00,2019-09-08 00:00:00,LABORABLE
9,8,2019,12,533,629,1162,2019-08-09 11:00:00,2019-09-08 00:00:00,LABORABLE
9,8,2019,13,462,597,1059,2019-08-09 12:00:00,2019-09-08 00:00:00,LABORABLE
9,8,2019,14,575,707,1282,2019-08-09 13:00:00,2019-09-08 00:00:00,LABORABLE
9,8,2019,15,563,711,1274,2019-08-09 14:00:00,2019-09-08 00:00:00,LABORABLE
9,8,2019,16,519,632,1151,2019-08-09 15:00:00,2019-09-08 00:00:00,LABORABLE
9,8,2019,17,527,643,1170,2019-08-09 16:00:00,2019-09-08 00:00:00,LABORABLE
9,8,2019,18,531,682,1213,2019-08-09 17:00:00,2019-09-08 00:00:00,LABORABLE
9,8,2019,19,564,686,1250,2019-08-09 18:00:00,2019-09-08 00:00:00,LABORABLE
9,8,2019,20,630,772,1402,2019-08-09 19:00:00,2019-09-08 00:00:00,LABORABLE
9,8,2019,21,612,737,1349,2019-08-09 20:00:00,2019-09-08 00:00:00,LABORABLE
9,8,2019,22,543,678,1221,2019-08-09 21:00:00,2019-09-08 00:00:00,LABORABLE
9,8,2019,23,463,586,1049,2019-08-09 22:00:00,2019-09-08 00:00:00,LABORABLE
9,8,2019,24,355,537,892,2019-08-09 23:00:00,2019-09-08 00:00:00,LABORABLE
10,8,2019,1,0,311,311,2019-08-10 00:00:00,2019-10-08 00:00:00,LABORABLE
10,8,2019,2,0,209,209,2019-08-10 01:00:00,2019-10-08 00:00:00,LABORABLE
10,8,2019,3,0,142,142,2019-08-10 02:00:00,2019-10-08 00:00:00,LABORABLE
10,8,2019,4,0,98,98,2019-08-10 03:00:00,2019-10-08 00:00:00,LABORABLE
10,8,2019,5,0,90,90,2019-08-10 04:00:00,2019-10-08 00:00:00,LABORABLE
10,8,2019,6,0,157,157,2019-08-10 05:00:00,2019-10-08 00:00:00,LABORABLE
10,8,2019,7,0,292,292,2019-08-10 06:00:00,2019-10-08 00:00:00,LABORABLE
10,8,2019,8,0,492,492,2019-08-10 07:00:00,2019-10-08 00:00:00,LABORABLE
10,8,2019,9,0,509,509,2019-08-10 08:00:00,2019-10-08 00:00:00,LABORABLE
10,8,2019,10,0,598,598,2019-08-10 09:00:00,2019-10-08 00:00:00,LABORABLE
10,8,2019,11,0,591,591,2019-08-10 10:00:00,2019-10-08 00:00:00,LABORABLE
10,8,2019,12,0,580,580,2019-08-10 11:00:00,2019-10-08 00:00:00,LABORABLE
10,8,2019,13,0,600,600,2019-08-10 12:00:00,2019-10-08 00:00:00,LABORABLE
10,8,2019,14,0,766,766,2019-08-10 13:00:00,2019-10-08 00:00:00,LABORABLE
10,8,2019,15,0,650,650,2019-08-10 14:00:00,2019-10-08 00:00:00,LABORABLE
10,8,2019,16,0,576,576,2019-08-10 15:00:00,2019-10-08 00:00:00,LABORABLE
10,8,2019,17,0,636,636,2019-08-10 16:00:00,2019-10-08 00:00:00,LABORABLE
10,8,2019,18,0,695,695,2019-08-10 17:00:00,2019-10-08 00:00:00,LABORABLE
10,8,2019,19,0,769,769,2019-08-10 18:00:00,2019-10-08 00:00:00,LABORABLE
10,8,2019,20,0,848,848,2019-08-10 19:00:00,2019-10-08 00:00:00,LABORABLE
10,8,2019,21,0,781,781,2019-08-10 20:00:00,2019-10-08 00:00:00,LABORABLE
10,8,2019,22,0,672,672,2019-08-10 21:00:00,2019-10-08 00:00:00,LABORABLE
10,8,2019,23,0,541,541,2019-08-10 22:00:00,2019-10-08 00:00:00,LABORABLE
10,8,2019,24,0,442,442,2019-08-10 23:00:00,2019-10-08 00:00:00,LABORABLE
11,8,2019,1,0,346,346,2019-08-11 00:00:00,2019-11-08 00:00:00,LABORABLE
11,8,2019,2,0,256,256,2019-08-11 01:00:00,2019-11-08 00:00:00,LABORABLE
11,8,2019,3,0,165,165,2019-08-11 02:00:00,2019-11-08 00:00:00,LABORABLE
11,8,2019,4,0,118,118,2019-08-11 03:00:00,2019-11-08 00:00:00,LABORABLE
11,8,2019,5,0,96,96,2019-08-11 04:00:00,2019-11-08 00:00:00,LABORABLE
11,8,2019,6,0,153,153,2019-08-11 05:00:00,2019-11-08 00:00:00,LABORABLE
11,8,2019,7,0,311,311,2019-08-11 06:00:00,2019-11-08 00:00:00,LABORABLE
11,8,2019,8,0,474,474,2019-08-11 07:00:00,2019-11-08 00:00:00,LABORABLE
11,8,2019,9,0,517,517,2019-08-11 08:00:00,2019-11-08 00:00:00,LABORABLE
11,8,2019,10,0,609,609,2019-08-11 09:00:00,2019-11-08 00:00:00,LABORABLE
11,8,2019,11,0,584,584,2019-08-11 10:00:00,2019-11-08 00:00:00,LABORABLE
11,8,2019,12,0,658,658,2019-08-11 11:00:00,2019-11-08 00:00:00,LABORABLE
11,8,2019,13,0,684,684,2019-08-11 12:00:00,2019-11-08 00:00:00,LABORABLE
11,8,2019,14,0,750,750,2019-08-11 13:00:00,2019-11-08 00:00:00,LABORABLE
11,8,2019,15,0,685,685,2019-08-11 14:00:00,2019-11-08 00:00:00,LABORABLE
11,8,2019,16,0,653,653,2019-08-11 15:00:00,2019-11-08 00:00:00,LABORABLE
11,8,2019,17,0,629,629,2019-08-11 16:00:00,2019-11-08 00:00:00,LABORABLE
11,8,2019,18,0,688,688,2019-08-11 17:00:00,2019-11-08 00:00:00,LABORABLE
11,8,2019,19,0,710,710,2019-08-11 18:00:00,2019-11-08 00:00:00,LABORABLE
11,8,2019,20,0,831,831,2019-08-11 19:00:00,2019-11-08 00:00:00,LABORABLE
11,8,2019,21,0,765,765,2019-08-11 20:00:00,2019-11-08 00:00:00,LABORABLE
11,8,2019,22,0,698,698,2019-08-11 21:00:00,2019-11-08 00:00:00,LABORABLE
11,8,2019,23,0,593,593,2019-08-11 22:00:00,2019-11-08 00:00:00,LABORABLE
11,8,2019,24,0,518,518,2019-08-11 23:00:00,2019-11-08 00:00:00,LABORABLE
12,8,2019,1,211,365,576,2019-08-12 00:00:00,2019-12-08 00:00:00,LABORABLE
12,8,2019,2,161,230,391,2019-08-12 01:00:00,2019-12-08 00:00:00,LABORABLE
12,8,2019,3,94,168,262,2019-08-12 02:00:00,2019-12-08 00:00:00,LABORABLE
12,8,2019,4,85,130,215,2019-08-12 03:00:00,2019-12-08 00:00:00,LABORABLE
12,8,2019,5,88,102,190,2019-08-12 04:00:00,2019-12-08 00:00:00,LABORABLE
12,8,2019,6,149,184,333,2019-08-12 05:00:00,2019-12-08 00:00:00,LABORABLE
12,8,2019,7,331,303,634,2019-08-12 06:00:00,2019-12-08 00:00:00,LABORABLE
12,8,2019,8,509,441,950,2019-08-12 07:00:00,2019-12-08 00:00:00,LABORABLE
12,8,2019,9,469,442,911,2019-08-12 08:00:00,2019-12-08 00:00:00,LABORABLE
12,8,2019,10,440,561,1001,2019-08-12 09:00:00,2019-12-08 00:00:00,LABORABLE
12,8,2019,11,401,517,918,2019-08-12 10:00:00,2019-12-08 00:00:00,LABORABLE
12,8,2019,12,501,587,1088,2019-08-12 11:00:00,2019-12-08 00:00:00,LABORABLE
12,8,2019,13,519,603,1122,2019-08-12 12:00:00,2019-12-08 00:00:00,LABORABLE
12,8,2019,14,529,628,1157,2019-08-12 13:00:00,2019-12-08 00:00:00,LABORABLE
12,8,2019,15,524,643,1167,2019-08-12 14:00:00,2019-12-08 00:00:00,LABORABLE
12,8,2019,16,444,631,1075,2019-08-12 15:00:00,2019-12-08 00:00:00,LABORABLE
12,8,2019,17,464,620,1084,2019-08-12 16:00:00,2019-12-08 00:00:00,LABORABLE
12,8,2019,18,540,658,1198,2019-08-12 17:00:00,2019-12-08 00:00:00,LABORABLE
12,8,2019,19,546,704,1250,2019-08-12 18:00:00,2019-12-08 00:00:00,LABORABLE
12,8,2019,20,606,711,1317,2019-08-12 19:00:00,2019-12-08 00:00:00,LABORABLE
12,8,2019,21,465,699,1164,2019-08-12 20:00:00,2019-12-08 00:00:00,LABORABLE
12,8,2019,22,454,599,1053,2019-08-12 21:00:00,2019-12-08 00:00:00,LABORABLE
12,8,2019,23,358,464,822,2019-08-12 22:00:00,2019-12-08 00:00:00,LABORABLE
12,8,2019,24,254,366,620,2019-08-12 23:00:00,2019-12-08 00:00:00,LABORABLE
13,8,2019,1,180,302,482,2019-08-13 00:00:00,2019-08-13 00:00:00,LABORABLE
13,8,2019,2,124,193,317,2019-08-13 01:00:00,2019-08-13 00:00:00,LABORABLE
13,8,2019,3,78,144,222,2019-08-13 02:00:00,2019-08-13 00:00:00,LABORABLE
13,8,2019,4,61,102,163,2019-08-13 03:00:00,2019-08-13 00:00:00,LABORABLE
13,8,2019,5,65,84,149,2019-08-13 04:00:00,2019-08-13 00:00:00,LABORABLE
13,8,2019,6,138,150,288,2019-08-13 05:00:00,2019-08-13 00:00:00,LABORABLE
13,8,2019,7,336,326,662,2019-08-13 06:00:00,2019-08-13 00:00:00,LABORABLE
13,8,2019,8,518,468,986,2019-08-13 07:00:00,2019-08-13 00:00:00,LABORABLE
13,8,2019,9,470,471,941,2019-08-13 08:00:00,2019-08-13 00:00:00,LABORABLE
13,8,2019,10,462,505,967,2019-08-13 09:00:00,2019-08-13 00:00:00,LABORABLE
13,8,2019,11,476,553,1029,2019-08-13 10:00:00,2019-08-13 00:00:00,LABORABLE
13,8,2019,12,468,590,1058,2019-08-13 11:00:00,2019-08-13 00:00:00,LABORABLE
13,8,2019,13,546,599,1145,2019-08-13 12:00:00,2019-08-13 00:00:00,LABORABLE
13,8,2019,14,512,677,1189,2019-08-13 13:00:00,2019-08-13 00:00:00,LABORABLE
13,8,2019,15,501,699,1200,2019-08-13 14:00:00,2019-08-13 00:00:00,LABORABLE
13,8,2019,16,468,608,1076,2019-08-13 15:00:00,2019-08-13 00:00:00,LABORABLE
13,8,2019,17,464,575,1039,2019-08-13 16:00:00,2019-08-13 00:00:00,LABORABLE
13,8,2019,18,509,685,1194,2019-08-13 17:00:00,2019-08-13 00:00:00,LABORABLE
13,8,2019,19,545,717,1262,2019-08-13 18:00:00,2019-08-13 00:00:00,LABORABLE
13,8,2019,20,542,729,1271,2019-08-13 19:00:00,2019-08-13 00:00:00,LABORABLE
13,8,2019,21,493,680,1173,2019-08-13 20:00:00,2019-08-13 00:00:00,LABORABLE
13,8,2019,22,485,580,1065,2019-08-13 21:00:00,2019-08-13 00:00:00,LABORABLE
13,8,2019,23,369,468,837,2019-08-13 22:00:00,2019-08-13 00:00:00,LABORABLE
13,8,2019,24,238,380,618,2019-08-13 23:00:00,2019-08-13 00:00:00,LABORABLE
14,8,2019,1,183,317,500,2019-08-14 00:00:00,2019-08-14 00:00:00,LABORABLE
14,8,2019,2,131,214,345,2019-08-14 01:00:00,2019-08-14 00:00:00,LABORABLE
14,8,2019,3,88,140,228,2019-08-14 02:00:00,2019-08-14 00:00:00,LABORABLE
14,8,2019,4,73,107,180,2019-08-14 03:00:00,2019-08-14 00:00:00,LABORABLE
14,8,2019,5,93,86,179,2019-08-14 04:00:00,2019-08-14 00:00:00,LABORABLE
14,8,2019,6,125,137,262,2019-08-14 05:00:00,2019-08-14 00:00:00,LABORABLE
14,8,2019,7,289,308,597,2019-08-14 06:00:00,2019-08-14 00:00:00,LABORABLE
14,8,2019,8,529,434,963,2019-08-14 07:00:00,2019-08-14 00:00:00,LABORABLE
14,8,2019,9,457,455,912,2019-08-14 08:00:00,2019-08-14 00:00:00,LABORABLE
14,8,2019,10,458,552,1010,2019-08-14 09:00:00,2019-08-14 00:00:00,LABORABLE
14,8,2019,11,489,583,1072,2019-08-14 10:00:00,2019-08-14 00:00:00,LABORABLE
14,8,2019,12,470,583,1053,2019-08-14 11:00:00,2019-08-14 00:00:00,LABORABLE
14,8,2019,13,561,654,1215,2019-08-14 12:00:00,2019-08-14 00:00:00,LABORABLE
14,8,2019,14,503,648,1151,2019-08-14 13:00:00,2019-08-14 00:00:00,LABORABLE
14,8,2019,15,416,554,970,2019-08-14 14:00:00,2019-08-14 00:00:00,LABORABLE
14,8,2019,16,471,590,1061,2019-08-14 15:00:00,2019-08-14 00:00:00,LABORABLE
14,8,2019,17,496,583,1079,2019-08-14 16:00:00,2019-08-14 00:00:00,LABORABLE
14,8,2019,18,499,614,1113,2019-08-14 17:00:00,2019-08-14 00:00:00,LABORABLE
14,8,2019,19,578,743,1321,2019-08-14 18:00:00,2019-08-14 00:00:00,LABORABLE
14,8,2019,20,597,763,1360,2019-08-14 19:00:00,2019-08-14 00:00:00,LABORABLE
14,8,2019,21,572,712,1284,2019-08-14 20:00:00,2019-08-14 00:00:00,LABORABLE
14,8,2019,22,500,619,1119,2019-08-14 21:00:00,2019-08-14 00:00:00,LABORABLE
14,8,2019,23,405,520,925,2019-08-14 22:00:00,2019-08-14 00:00:00,LABORABLE
14,8,2019,24,276,382,658,2019-08-14 23:00:00,2019-08-14 00:00:00,LABORABLE
15,8,2019,1,250,331,581,2019-08-15 00:00:00,2019-08-15 00:00:00,FESTIVO
15,8,2019,2,157,276,433,2019-08-15 01:00:00,2019-08-15 00:00:00,FESTIVO
15,8,2019,3,142,205,347,2019-08-15 02:00:00,2019-08-15 00:00:00,FESTIVO
15,8,2019,4,74,147,221,2019-08-15 03:00:00,2019-08-15 00:00:00,FESTIVO
15,8,2019,5,70,118,188,2019-08-15 04:00:00,2019-08-15 00:00:00,FESTIVO
15,8,2019,6,112,143,255,2019-08-15 05:00:00,2019-08-15 00:00:00,FESTIVO
15,8,2019,7,183,284,467,2019-08-15 06:00:00,2019-08-15 00:00:00,FESTIVO
15,8,2019,8,432,443,875,2019-08-15 07:00:00,2019-08-15 00:00:00,FESTIVO
15,8,2019,9,453,536,989,2019-08-15 08:00:00,2019-08-15 00:00:00,FESTIVO
15,8,2019,10,337,537,874,2019-08-15 09:00:00,2019-08-15 00:00:00,FESTIVO
15,8,2019,11,379,481,860,2019-08-15 10:00:00,2019-08-15 00:00:00,FESTIVO
15,8,2019,12,433,545,978,2019-08-15 11:00:00,2019-08-15 00:00:00,FESTIVO
15,8,2019,13,444,571,1015,2019-08-15 12:00:00,2019-08-15 00:00:00,FESTIVO
15,8,2019,14,401,582,983,2019-08-15 13:00:00,2019-08-15 00:00:00,FESTIVO
15,8,2019,15,592,532,1124,2019-08-15 14:00:00,2019-08-15 00:00:00,FESTIVO
15,8,2019,16,351,510,861,2019-08-15 15:00:00,2019-08-15 00:00:00,FESTIVO
15,8,2019,17,486,535,1021,2019-08-15 16:00:00,2019-08-15 00:00:00,FESTIVO
15,8,2019,18,384,539,923,2019-08-15 17:00:00,2019-08-15 00:00:00,FESTIVO
15,8,2019,19,602,576,1178,2019-08-15 18:00:00,2019-08-15 00:00:00,FESTIVO
15,8,2019,20,447,588,1035,2019-08-15 19:00:00,2019-08-15 00:00:00,FESTIVO
15,8,2019,21,420,563,983,2019-08-15 20:00:00,2019-08-15 00:00:00,FESTIVO
15,8,2019,22,393,589,982,2019-08-15 21:00:00,2019-08-15 00:00:00,FESTIVO
15,8,2019,23,428,522,950,2019-08-15 22:00:00,2019-08-15 00:00:00,FESTIVO
15,8,2019,24,322,494,816,2019-08-15 23:00:00,2019-08-15 00:00:00,FESTIVO
16,8,2019,1,232,341,573,2019-08-16 00:00:00,2019-08-16 00:00:00,LABORABLE
16,8,2019,2,187,244,431,2019-08-16 01:00:00,2019-08-16 00:00:00,LABORABLE
16,8,2019,3,123,212,335,2019-08-16 02:00:00,2019-08-16 00:00:00,LABORABLE
16,8,2019,4,121,150,271,2019-08-16 03:00:00,2019-08-16 00:00:00,LABORABLE
16,8,2019,5,78,96,174,2019-08-16 04:00:00,2019-08-16 00:00:00,LABORABLE
16,8,2019,6,148,138,286,2019-08-16 05:00:00,2019-08-16 00:00:00,LABORABLE
16,8,2019,7,250,281,531,2019-08-16 06:00:00,2019-08-16 00:00:00,LABORABLE
16,8,2019,8,381,368,749,2019-08-16 07:00:00,2019-08-16 00:00:00,LABORABLE
16,8,2019,9,427,421,848,2019-08-16 08:00:00,2019-08-16 00:00:00,LABORABLE
16,8,2019,10,383,502,885,2019-08-16 09:00:00,2019-08-16 00:00:00,LABORABLE
16,8,2019,11,403,585,988,2019-08-16 10:00:00,2019-08-16 00:00:00,LABORABLE
16,8,2019,12,486,624,1110,2019-08-16 11:00:00,2019-08-16 00:00:00,LABORABLE
16,8,2019,13,534,709,1243,2019-08-16 12:00:00,2019-08-16 00:00:00,LABORABLE
16,8,2019,14,495,680,1175,2019-08-16 13:00:00,2019-08-16 00:00:00,LABORABLE
16,8,2019,15,454,627,1081,2019-08-16 14:00:00,2019-08-16 00:00:00,LABORABLE
16,8,2019,16,478,568,1046,2019-08-16 15:00:00,2019-08-16 00:00:00,LABORABLE
16,8,2019,17,417,559,976,2019-08-16 16:00:00,2019-08-16 00:00:00,LABORABLE
16,8,2019,18,435,635,1070,2019-08-16 17:00:00,2019-08-16 00:00:00,LABORABLE
16,8,2019,19,481,621,1102,2019-08-16 18:00:00,2019-08-16 00:00:00,LABORABLE
16,8,2019,20,525,737,1262,2019-08-16 19:00:00,2019-08-16 00:00:00,LABORABLE
16,8,2019,21,517,661,1178,2019-08-16 20:00:00,2019-08-16 00:00:00,LABORABLE
16,8,2019,22,451,651,1102,2019-08-16 21:00:00,2019-08-16 00:00:00,LABORABLE
16,8,2019,23,433,508,941,2019-08-16 22:00:00,2019-08-16 00:00:00,LABORABLE
16,8,2019,24,313,422,735,2019-08-16 23:00:00,2019-08-16 00:00:00,LABORABLE
17,8,2019,1,0,259,259,2019-08-17 00:00:00,2019-08-17 00:00:00,LABORABLE
17,8,2019,2,0,236,236,2019-08-17 01:00:00,2019-08-17 00:00:00,LABORABLE
17,8,2019,3,0,153,153,2019-08-17 02:00:00,2019-08-17 00:00:00,LABORABLE
17,8,2019,4,0,92,92,2019-08-17 03:00:00,2019-08-17 00:00:00,LABORABLE
17,8,2019,5,0,82,82,2019-08-17 04:00:00,2019-08-17 00:00:00,LABORABLE
17,8,2019,6,0,119,119,2019-08-17 05:00:00,2019-08-17 00:00:00,LABORABLE
17,8,2019,7,0,294,294,2019-08-17 06:00:00,2019-08-17 00:00:00,LABORABLE
17,8,2019,8,0,475,475,2019-08-17 07:00:00,2019-08-17 00:00:00,LABORABLE
17,8,2019,9,0,449,449,2019-08-17 08:00:00,2019-08-17 00:00:00,LABORABLE
17,8,2019,10,0,590,590,2019-08-17 09:00:00,2019-08-17 00:00:00,LABORABLE
17,8,2019,11,0,467,467,2019-08-17 10:00:00,2019-08-17 00:00:00,LABORABLE
17,8,2019,12,0,579,579,2019-08-17 11:00:00,2019-08-17 00:00:00,LABORABLE
17,8,2019,13,0,665,665,2019-08-17 12:00:00,2019-08-17 00:00:00,LABORABLE
17,8,2019,14,0,703,703,2019-08-17 13:00:00,2019-08-17 00:00:00,LABORABLE
17,8,2019,15,0,647,647,2019-08-17 14:00:00,2019-08-17 00:00:00,LABORABLE
17,8,2019,16,0,570,570,2019-08-17 15:00:00,2019-08-17 00:00:00,LABORABLE
17,8,2019,17,0,589,589,2019-08-17 16:00:00,2019-08-17 00:00:00,LABORABLE
17,8,2019,18,0,701,701,2019-08-17 17:00:00,2019-08-17 00:00:00,LABORABLE
17,8,2019,19,0,676,676,2019-08-17 18:00:00,2019-08-17 00:00:00,LABORABLE
17,8,2019,20,0,730,730,2019-08-17 19:00:00,2019-08-17 00:00:00,LABORABLE
17,8,2019,21,0,712,712,2019-08-17 20:00:00,2019-08-17 00:00:00,LABORABLE
17,8,2019,22,0,564,564,2019-08-17 21:00:00,2019-08-17 00:00:00,LABORABLE
17,8,2019,23,0,437,437,2019-08-17 22:00:00,2019-08-17 00:00:00,LABORABLE
17,8,2019,24,0,343,343,2019-08-17 23:00:00,2019-08-17 00:00:00,LABORABLE
18,8,2019,1,0,357,357,2019-08-18 00:00:00,2019-08-18 00:00:00,LABORABLE
18,8,2019,2,0,192,192,2019-08-18 01:00:00,2019-08-18 00:00:00,LABORABLE
18,8,2019,3,0,159,159,2019-08-18 02:00:00,2019-08-18 00:00:00,LABORABLE
18,8,2019,4,0,122,122,2019-08-18 03:00:00,2019-08-18 00:00:00,LABORABLE
18,8,2019,5,0,107,107,2019-08-18 04:00:00,2019-08-18 00:00:00,LABORABLE
18,8,2019,6,0,127,127,2019-08-18 05:00:00,2019-08-18 00:00:00,LABORABLE
18,8,2019,7,0,270,270,2019-08-18 06:00:00,2019-08-18 00:00:00,LABORABLE
18,8,2019,8,0,456,456,2019-08-18 07:00:00,2019-08-18 00:00:00,LABORABLE
18,8,2019,9,0,461,461,2019-08-18 08:00:00,2019-08-18 00:00:00,LABORABLE
18,8,2019,10,0,491,491,2019-08-18 09:00:00,2019-08-18 00:00:00,LABORABLE
18,8,2019,11,0,571,571,2019-08-18 10:00:00,2019-08-18 00:00:00,LABORABLE
18,8,2019,12,0,609,609,2019-08-18 11:00:00,2019-08-18 00:00:00,LABORABLE
18,8,2019,13,0,483,483,2019-08-18 12:00:00,2019-08-18 00:00:00,LABORABLE
18,8,2019,14,0,680,680,2019-08-18 13:00:00,2019-08-18 00:00:00,LABORABLE
18,8,2019,15,0,608,608,2019-08-18 14:00:00,2019-08-18 00:00:00,LABORABLE
18,8,2019,16,0,591,591,2019-08-18 15:00:00,2019-08-18 00:00:00,LABORABLE
18,8,2019,17,0,573,573,2019-08-18 16:00:00,2019-08-18 00:00:00,LABORABLE
18,8,2019,18,0,598,598,2019-08-18 17:00:00,2019-08-18 00:00:00,LABORABLE
18,8,2019,19,0,648,648,2019-08-18 18:00:00,2019-08-18 00:00:00,LABORABLE
18,8,2019,20,0,711,711,2019-08-18 19:00:00,2019-08-18 00:00:00,LABORABLE
18,8,2019,21,0,752,752,2019-08-18 20:00:00,2019-08-18 00:00:00,LABORABLE
18,8,2019,22,0,640,640,2019-08-18 21:00:00,2019-08-18 00:00:00,LABORABLE
18,8,2019,23,0,540,540,2019-08-18 22:00:00,2019-08-18 00:00:00,LABORABLE
18,8,2019,24,0,426,426,2019-08-18 23:00:00,2019-08-18 00:00:00,LABORABLE
19,8,2019,1,232,341,573,2019-08-19 00:00:00,2019-08-19 00:00:00,LABORABLE
19,8,2019,2,187,244,431,2019-08-19 01:00:00,2019-08-19 00:00:00,LABORABLE
19,8,2019,3,123,212,335,2019-08-19 02:00:00,2019-08-19 00:00:00,LABORABLE
19,8,2019,4,121,150,271,2019-08-19 03:00:00,2019-08-19 00:00:00,LABORABLE
19,8,2019,5,78,96,174,2019-08-19 04:00:00,2019-08-19 00:00:00,LABORABLE
19,8,2019,6,148,138,286,2019-08-19 05:00:00,2019-08-19 00:00:00,LABORABLE
19,8,2019,7,250,281,531,2019-08-19 06:00:00,2019-08-19 00:00:00,LABORABLE
19,8,2019,8,381,368,749,2019-08-19 07:00:00,2019-08-19 00:00:00,LABORABLE
19,8,2019,9,427,421,848,2019-08-19 08:00:00,2019-08-19 00:00:00,LABORABLE
19,8,2019,10,383,502,885,2019-08-19 09:00:00,2019-08-19 00:00:00,LABORABLE
19,8,2019,11,403,585,988,2019-08-19 10:00:00,2019-08-19 00:00:00,LABORABLE
19,8,2019,12,486,624,1110,2019-08-19 11:00:00,2019-08-19 00:00:00,LABORABLE
19,8,2019,13,534,709,1243,2019-08-19 12:00:00,2019-08-19 00:00:00,LABORABLE
19,8,2019,14,495,680,1175,2019-08-19 13:00:00,2019-08-19 00:00:00,LABORABLE
19,8,2019,15,454,627,1081,2019-08-19 14:00:00,2019-08-19 00:00:00,LABORABLE
19,8,2019,16,478,568,1046,2019-08-19 15:00:00,2019-08-19 00:00:00,LABORABLE
19,8,2019,17,417,559,976,2019-08-19 16:00:00,2019-08-19 00:00:00,LABORABLE
19,8,2019,18,435,635,1070,2019-08-19 17:00:00,2019-08-19 00:00:00,LABORABLE
19,8,2019,19,481,621,1102,2019-08-19 18:00:00,2019-08-19 00:00:00,LABORABLE
19,8,2019,20,525,737,1262,2019-08-19 19:00:00,2019-08-19 00:00:00,LABORABLE
19,8,2019,21,517,661,1178,2019-08-19 20:00:00,2019-08-19 00:00:00,LABORABLE
19,8,2019,22,451,651,1102,2019-08-19 21:00:00,2019-08-19 00:00:00,LABORABLE
19,8,2019,23,433,508,941,2019-08-19 22:00:00,2019-08-19 00:00:00,LABORABLE
19,8,2019,24,313,422,735,2019-08-19 23:00:00,2019-08-19 00:00:00,LABORABLE
20,8,2019,1,172,242,414,2019-08-20 00:00:00,2019-08-20 00:00:00,LABORABLE
20,8,2019,2,120,196,316,2019-08-20 01:00:00,2019-08-20 00:00:00,LABORABLE
20,8,2019,3,91,147,238,2019-08-20 02:00:00,2019-08-20 00:00:00,LABORABLE
20,8,2019,4,54,87,141,2019-08-20 03:00:00,2019-08-20 00:00:00,LABORABLE
20,8,2019,5,68,79,147,2019-08-20 04:00:00,2019-08-20 00:00:00,LABORABLE
20,8,2019,6,134,123,257,2019-08-20 05:00:00,2019-08-20 00:00:00,LABORABLE
20,8,2019,7,316,291,607,2019-08-20 06:00:00,2019-08-20 00:00:00,LABORABLE
20,8,2019,8,523,438,961,2019-08-20 07:00:00,2019-08-20 00:00:00,LABORABLE
20,8,2019,9,435,467,902,2019-08-20 08:00:00,2019-08-20 00:00:00,LABORABLE
20,8,2019,10,442,542,984,2019-08-20 09:00:00,2019-08-20 00:00:00,LABORABLE
20,8,2019,11,520,485,1005,2019-08-20 10:00:00,2019-08-20 00:00:00,LABORABLE
20,8,2019,12,491,621,1112,2019-08-20 11:00:00,2019-08-20 00:00:00,LABORABLE
20,8,2019,13,511,614,1125,2019-08-20 12:00:00,2019-08-20 00:00:00,LABORABLE
20,8,2019,14,516,701,1217,2019-08-20 13:00:00,2019-08-20 00:00:00,LABORABLE
20,8,2019,15,498,634,1132,2019-08-20 14:00:00,2019-08-20 00:00:00,LABORABLE
20,8,2019,16,427,535,962,2019-08-20 15:00:00,2019-08-20 00:00:00,LABORABLE
20,8,2019,17,420,605,1025,2019-08-20 16:00:00,2019-08-20 00:00:00,LABORABLE
20,8,2019,18,482,620,1102,2019-08-20 17:00:00,2019-08-20 00:00:00,LABORABLE
20,8,2019,19,582,706,1288,2019-08-20 18:00:00,2019-08-20 00:00:00,LABORABLE
20,8,2019,20,566,676,1242,2019-08-20 19:00:00,2019-08-20 00:00:00,LABORABLE
20,8,2019,21,490,719,1209,2019-08-20 20:00:00,2019-08-20 00:00:00,LABORABLE
20,8,2019,22,474,565,1039,2019-08-20 21:00:00,2019-08-20 00:00:00,LABORABLE
20,8,2019,23,396,463,859,2019-08-20 22:00:00,2019-08-20 00:00:00,LABORABLE
20,8,2019,24,252,351,603,2019-08-20 23:00:00,2019-08-20 00:00:00,LABORABLE
21,8,2019,1,170,256,426,2019-08-21 00:00:00,2019-08-21 00:00:00,LABORABLE
21,8,2019,2,114,210,324,2019-08-21 01:00:00,2019-08-21 00:00:00,LABORABLE
21,8,2019,3,95,151,246,2019-08-21 02:00:00,2019-08-21 00:00:00,LABORABLE
21,8,2019,4,66,92,158,2019-08-21 03:00:00,2019-08-21 00:00:00,LABORABLE
21,8,2019,5,65,80,145,2019-08-21 04:00:00,2019-08-21 00:00:00,LABORABLE
21,8,2019,6,129,148,277,2019-08-21 05:00:00,2019-08-21 00:00:00,LABORABLE
21,8,2019,7,309,302,611,2019-08-21 06:00:00,2019-08-21 00:00:00,LABORABLE
21,8,2019,8,512,461,973,2019-08-21 07:00:00,2019-08-21 00:00:00,LABORABLE
21,8,2019,9,491,451,942,2019-08-21 08:00:00,2019-08-21 00:00:00,LABORABLE
21,8,2019,10,446,515,961,2019-08-21 09:00:00,2019-08-21 00:00:00,LABORABLE
21,8,2019,11,412,526,938,2019-08-21 10:00:00,2019-08-21 00:00:00,LABORABLE
21,8,2019,12,481,590,1071,2019-08-21 11:00:00,2019-08-21 00:00:00,LABORABLE
21,8,2019,13,516,632,1148,2019-08-21 12:00:00,2019-08-21 00:00:00,LABORABLE
21,8,2019,14,509,627,1136,2019-08-21 13:00:00,2019-08-21 00:00:00,LABORABLE
21,8,2019,15,512,646,1158,2019-08-21 14:00:00,2019-08-21 00:00:00,LABORABLE
21,8,2019,16,444,589,1033,2019-08-21 15:00:00,2019-08-21 00:00:00,LABORABLE
21,8,2019,17,430,588,1018,2019-08-21 16:00:00,2019-08-21 00:00:00,LABORABLE
21,8,2019,18,465,596,1061,2019-08-21 17:00:00,2019-08-21 00:00:00,LABORABLE
21,8,2019,19,591,735,1326,2019-08-21 18:00:00,2019-08-21 00:00:00,LABORABLE
21,8,2019,20,553,623,1176,2019-08-21 19:00:00,2019-08-21 00:00:00,LABORABLE
21,8,2019,21,508,599,1107,2019-08-21 20:00:00,2019-08-21 00:00:00,LABORABLE
21,8,2019,22,451,577,1028,2019-08-21 21:00:00,2019-08-21 00:00:00,LABORABLE
21,8,2019,23,354,435,789,2019-08-21 22:00:00,2019-08-21 00:00:00,LABORABLE
21,8,2019,24,278,341,619,2019-08-21 23:00:00,2019-08-21 00:00:00,LABORABLE
22,8,2019,1,197,297,494,2019-08-22 00:00:00,2019-08-22 00:00:00,LABORABLE
22,8,2019,2,120,202,322,2019-08-22 01:00:00,2019-08-22 00:00:00,LABORABLE
22,8,2019,3,77,160,237,2019-08-22 02:00:00,2019-08-22 00:00:00,LABORABLE
22,8,2019,4,76,103,179,2019-08-22 03:00:00,2019-08-22 00:00:00,LABORABLE
22,8,2019,5,78,88,166,2019-08-22 04:00:00,2019-08-22 00:00:00,LABORABLE
22,8,2019,6,137,130,267,2019-08-22 05:00:00,2019-08-22 00:00:00,LABORABLE
22,8,2019,7,315,312,627,2019-08-22 06:00:00,2019-08-22 00:00:00,LABORABLE
22,8,2019,8,542,432,974,2019-08-22 07:00:00,2019-08-22 00:00:00,LABORABLE
22,8,2019,9,450,455,905,2019-08-22 08:00:00,2019-08-22 00:00:00,LABORABLE
22,8,2019,10,461,558,1019,2019-08-22 09:00:00,2019-08-22 00:00:00,LABORABLE
22,8,2019,11,434,517,951,2019-08-22 10:00:00,2019-08-22 00:00:00,LABORABLE
22,8,2019,12,518,608,1126,2019-08-22 11:00:00,2019-08-22 00:00:00,LABORABLE
22,8,2019,13,511,632,1143,2019-08-22 12:00:00,2019-08-22 00:00:00,LABORABLE
22,8,2019,14,427,696,1123,2019-08-22 13:00:00,2019-08-22 00:00:00,LABORABLE
22,8,2019,15,512,612,1124,2019-08-22 14:00:00,2019-08-22 00:00:00,LABORABLE
22,8,2019,16,433,544,977,2019-08-22 15:00:00,2019-08-22 00:00:00,LABORABLE
22,8,2019,17,451,529,980,2019-08-22 16:00:00,2019-08-22 00:00:00,LABORABLE
22,8,2019,18,516,609,1125,2019-08-22 17:00:00,2019-08-22 00:00:00,LABORABLE
22,8,2019,19,540,695,1235,2019-08-22 18:00:00,2019-08-22 00:00:00,LABORABLE
22,8,2019,20,558,719,1277,2019-08-22 19:00:00,2019-08-22 00:00:00,LABORABLE
22,8,2019,21,551,684,1235,2019-08-22 20:00:00,2019-08-22 00:00:00,LABORABLE
22,8,2019,22,508,626,1134,2019-08-22 21:00:00,2019-08-22 00:00:00,LABORABLE
22,8,2019,23,409,488,897,2019-08-22 22:00:00,2019-08-22 00:00:00,LABORABLE
22,8,2019,24,303,318,621,2019-08-22 23:00:00,2019-08-22 00:00:00,LABORABLE
23,8,2019,1,227,333,560,2019-08-23 00:00:00,2019-08-23 00:00:00,LABORABLE
23,8,2019,2,145,219,364,2019-08-23 01:00:00,2019-08-23 00:00:00,LABORABLE
23,8,2019,3,111,158,269,2019-08-23 02:00:00,2019-08-23 00:00:00,LABORABLE
23,8,2019,4,68,119,187,2019-08-23 03:00:00,2019-08-23 00:00:00,LABORABLE
23,8,2019,5,75,114,189,2019-08-23 04:00:00,2019-08-23 00:00:00,LABORABLE
23,8,2019,6,134,136,270,2019-08-23 05:00:00,2019-08-23 00:00:00,LABORABLE
23,8,2019,7,335,330,665,2019-08-23 06:00:00,2019-08-23 00:00:00,LABORABLE
23,8,2019,8,503,438,941,2019-08-23 07:00:00,2019-08-23 00:00:00,LABORABLE
23,8,2019,9,458,472,930,2019-08-23 08:00:00,2019-08-23 00:00:00,LABORABLE
23,8,2019,10,430,536,966,2019-08-23 09:00:00,2019-08-23 00:00:00,LABORABLE
23,8,2019,11,442,539,981,2019-08-23 10:00:00,2019-08-23 00:00:00,LABORABLE
23,8,2019,12,505,613,1118,2019-08-23 11:00:00,2019-08-23 00:00:00,LABORABLE
23,8,2019,13,534,671,1205,2019-08-23 12:00:00,2019-08-23 00:00:00,LABORABLE
23,8,2019,14,481,604,1085,2019-08-23 13:00:00,2019-08-23 00:00:00,LABORABLE
23,8,2019,15,510,643,1153,2019-08-23 14:00:00,2019-08-23 00:00:00,LABORABLE
23,8,2019,16,482,578,1060,2019-08-23 15:00:00,2019-08-23 00:00:00,LABORABLE
23,8,2019,17,502,595,1097,2019-08-23 16:00:00,2019-08-23 00:00:00,LABORABLE
23,8,2019,18,507,615,1122,2019-08-23 17:00:00,2019-08-23 00:00:00,LABORABLE
23,8,2019,19,568,672,1240,2019-08-23 18:00:00,2019-08-23 00:00:00,LABORABLE
23,8,2019,20,587,740,1327,2019-08-23 19:00:00,2019-08-23 00:00:00,LABORABLE
23,8,2019,21,533,734,1267,2019-08-23 20:00:00,2019-08-23 00:00:00,LABORABLE
23,8,2019,22,504,666,1170,2019-08-23 21:00:00,2019-08-23 00:00:00,LABORABLE
23,8,2019,23,445,564,1009,2019-08-23 22:00:00,2019-08-23 00:00:00,LABORABLE
23,8,2019,24,361,446,807,2019-08-23 23:00:00,2019-08-23 00:00:00,LABORABLE
24,8,2019,1,0,268,268,2019-08-24 00:00:00,2019-08-24 00:00:00,LABORABLE
24,8,2019,2,0,211,211,2019-08-24 01:00:00,2019-08-24 00:00:00,LABORABLE
24,8,2019,3,0,173,173,2019-08-24 02:00:00,2019-08-24 00:00:00,LABORABLE
24,8,2019,4,0,115,115,2019-08-24 03:00:00,2019-08-24 00:00:00,LABORABLE
24,8,2019,5,0,81,81,2019-08-24 04:00:00,2019-08-24 00:00:00,LABORABLE
24,8,2019,6,0,141,141,2019-08-24 05:00:00,2019-08-24 00:00:00,LABORABLE
24,8,2019,7,0,261,261,2019-08-24 06:00:00,2019-08-24 00:00:00,LABORABLE
24,8,2019,8,0,503,503,2019-08-24 07:00:00,2019-08-24 00:00:00,LABORABLE
24,8,2019,9,0,518,518,2019-08-24 08:00:00,2019-08-24 00:00:00,LABORABLE
24,8,2019,10,0,611,611,2019-08-24 09:00:00,2019-08-24 00:00:00,LABORABLE
24,8,2019,11,0,545,545,2019-08-24 10:00:00,2019-08-24 00:00:00,LABORABLE
24,8,2019,12,0,651,651,2019-08-24 11:00:00,2019-08-24 00:00:00,LABORABLE
24,8,2019,13,0,709,709,2019-08-24 12:00:00,2019-08-24 00:00:00,LABORABLE
24,8,2019,14,0,683,683,2019-08-24 13:00:00,2019-08-24 00:00:00,LABORABLE
24,8,2019,15,0,690,690,2019-08-24 14:00:00,2019-08-24 00:00:00,LABORABLE
24,8,2019,16,0,560,560,2019-08-24 15:00:00,2019-08-24 00:00:00,LABORABLE
24,8,2019,17,0,558,558,2019-08-24 16:00:00,2019-08-24 00:00:00,LABORABLE
24,8,2019,18,0,649,649,2019-08-24 17:00:00,2019-08-24 00:00:00,LABORABLE
24,8,2019,19,0,665,665,2019-08-24 18:00:00,2019-08-24 00:00:00,LABORABLE
24,8,2019,20,0,752,752,2019-08-24 19:00:00,2019-08-24 00:00:00,LABORABLE
24,8,2019,21,0,699,699,2019-08-24 20:00:00,2019-08-24 00:00:00,LABORABLE
24,8,2019,22,0,680,680,2019-08-24 21:00:00,2019-08-24 00:00:00,LABORABLE
24,8,2019,23,0,429,429,2019-08-24 22:00:00,2019-08-24 00:00:00,LABORABLE
24,8,2019,24,0,359,359,2019-08-24 23:00:00,2019-08-24 00:00:00,LABORABLE
25,8,2019,1,0,309,309,2019-08-25 00:00:00,2019-08-25 00:00:00,LABORABLE
25,8,2019,2,0,198,198,2019-08-25 01:00:00,2019-08-25 00:00:00,LABORABLE
25,8,2019,3,0,156,156,2019-08-25 02:00:00,2019-08-25 00:00:00,LABORABLE
25,8,2019,4,0,115,115,2019-08-25 03:00:00,2019-08-25 00:00:00,LABORABLE
25,8,2019,5,0,102,102,2019-08-25 04:00:00,2019-08-25 00:00:00,LABORABLE
25,8,2019,6,0,129,129,2019-08-25 05:00:00,2019-08-25 00:00:00,LABORABLE
25,8,2019,7,0,294,294,2019-08-25 06:00:00,2019-08-25 00:00:00,LABORABLE
25,8,2019,8,0,454,454,2019-08-25 07:00:00,2019-08-25 00:00:00,LABORABLE
25,8,2019,9,0,511,511,2019-08-25 08:00:00,2019-08-25 00:00:00,LABORABLE
25,8,2019,10,0,581,581,2019-08-25 09:00:00,2019-08-25 00:00:00,LABORABLE
25,8,2019,11,0,572,572,2019-08-25 10:00:00,2019-08-25 00:00:00,LABORABLE
25,8,2019,12,0,616,616,2019-08-25 11:00:00,2019-08-25 00:00:00,LABORABLE
25,8,2019,13,0,671,671,2019-08-25 12:00:00,2019-08-25 00:00:00,LABORABLE
25,8,2019,14,0,700,700,2019-08-25 13:00:00,2019-08-25 00:00:00,LABORABLE
25,8,2019,15,0,737,737,2019-08-25 14:00:00,2019-08-25 00:00:00,LABORABLE
25,8,2019,16,0,608,608,2019-08-25 15:00:00,2019-08-25 00:00:00,LABORABLE
25,8,2019,17,0,620,620,2019-08-25 16:00:00,2019-08-25 00:00:00,LABORABLE
25,8,2019,18,0,642,642,2019-08-25 17:00:00,2019-08-25 00:00:00,LABORABLE
25,8,2019,19,0,715,715,2019-08-25 18:00:00,2019-08-25 00:00:00,LABORABLE
25,8,2019,20,0,771,771,2019-08-25 19:00:00,2019-08-25 00:00:00,LABORABLE
25,8,2019,21,0,701,701,2019-08-25 20:00:00,2019-08-25 00:00:00,LABORABLE
25,8,2019,22,0,706,706,2019-08-25 21:00:00,2019-08-25 00:00:00,LABORABLE
25,8,2019,23,0,567,567,2019-08-25 22:00:00,2019-08-25 00:00:00,LABORABLE
25,8,2019,24,0,456,456,2019-08-25 23:00:00,2019-08-25 00:00:00,LABORABLE
26,8,2019,1,218,302,520,2019-08-26 00:00:00,2019-08-26 00:00:00,LABORABLE
26,8,2019,2,126,224,350,2019-08-26 01:00:00,2019-08-26 00:00:00,LABORABLE
26,8,2019,3,110,194,304,2019-08-26 02:00:00,2019-08-26 00:00:00,LABORABLE
26,8,2019,4,77,133,210,2019-08-26 03:00:00,2019-08-26 00:00:00,LABORABLE
26,8,2019,5,67,118,185,2019-08-26 04:00:00,2019-08-26 00:00:00,LABORABLE
26,8,2019,6,130,153,283,2019-08-26 05:00:00,2019-08-26 00:00:00,LABORABLE
26,8,2019,7,367,334,701,2019-08-26 06:00:00,2019-08-26 00:00:00,LABORABLE
26,8,2019,8,527,492,1019,2019-08-26 07:00:00,2019-08-26 00:00:00,LABORABLE
26,8,2019,9,463,486,949,2019-08-26 08:00:00,2019-08-26 00:00:00,LABORABLE
26,8,2019,10,427,518,945,2019-08-26 09:00:00,2019-08-26 00:00:00,LABORABLE
26,8,2019,11,422,544,966,2019-08-26 10:00:00,2019-08-26 00:00:00,LABORABLE
26,8,2019,12,362,506,868,2019-08-26 11:00:00,2019-08-26 00:00:00,LABORABLE
26,8,2019,13,542,646,1188,2019-08-26 12:00:00,2019-08-26 00:00:00,LABORABLE
26,8,2019,14,562,683,1245,2019-08-26 13:00:00,2019-08-26 00:00:00,LABORABLE
26,8,2019,15,561,665,1226,2019-08-26 14:00:00,2019-08-26 00:00:00,LABORABLE
26,8,2019,16,526,588,1114,2019-08-26 15:00:00,2019-08-26 00:00:00,LABORABLE
26,8,2019,17,448,591,1039,2019-08-26 16:00:00,2019-08-26 00:00:00,LABORABLE
26,8,2019,18,539,693,1232,2019-08-26 17:00:00,2019-08-26 00:00:00,LABORABLE
26,8,2019,19,578,710,1288,2019-08-26 18:00:00,2019-08-26 00:00:00,LABORABLE
26,8,2019,20,509,745,1254,2019-08-26 19:00:00,2019-08-26 00:00:00,LABORABLE
26,8,2019,21,530,740,1270,2019-08-26 20:00:00,2019-08-26 00:00:00,LABORABLE
26,8,2019,22,474,632,1106,2019-08-26 21:00:00,2019-08-26 00:00:00,LABORABLE
26,8,2019,23,326,430,756,2019-08-26 22:00:00,2019-08-26 00:00:00,LABORABLE
26,8,2019,24,215,325,540,2019-08-26 23:00:00,2019-08-26 00:00:00,LABORABLE
27,8,2019,1,223,228,451,2019-08-27 00:00:00,2019-08-27 00:00:00,LABORABLE
27,8,2019,2,91,180,271,2019-08-27 01:00:00,2019-08-27 00:00:00,LABORABLE
27,8,2019,3,82,126,208,2019-08-27 02:00:00,2019-08-27 00:00:00,LABORABLE
27,8,2019,4,59,116,175,2019-08-27 03:00:00,2019-08-27 00:00:00,LABORABLE
27,8,2019,5,61,75,136,2019-08-27 04:00:00,2019-08-27 00:00:00,LABORABLE
27,8,2019,6,127,140,267,2019-08-27 05:00:00,2019-08-27 00:00:00,LABORABLE
27,8,2019,7,348,281,629,2019-08-27 06:00:00,2019-08-27 00:00:00,LABORABLE
27,8,2019,8,549,476,1025,2019-08-27 07:00:00,2019-08-27 00:00:00,LABORABLE
27,8,2019,9,452,508,960,2019-08-27 08:00:00,2019-08-27 00:00:00,LABORABLE
27,8,2019,10,439,533,972,2019-08-27 09:00:00,2019-08-27 00:00:00,LABORABLE
27,8,2019,11,506,560,1066,2019-08-27 10:00:00,2019-08-27 00:00:00,LABORABLE
27,8,2019,12,504,661,1165,2019-08-27 11:00:00,2019-08-27 00:00:00,LABORABLE
27,8,2019,13,477,616,1093,2019-08-27 12:00:00,2019-08-27 00:00:00,LABORABLE
27,8,2019,14,510,676,1186,2019-08-27 13:00:00,2019-08-27 00:00:00,LABORABLE
27,8,2019,15,617,677,1294,2019-08-27 14:00:00,2019-08-27 00:00:00,LABORABLE
27,8,2019,16,505,600,1105,2019-08-27 15:00:00,2019-08-27 00:00:00,LABORABLE
27,8,2019,17,474,590,1064,2019-08-27 16:00:00,2019-08-27 00:00:00,LABORABLE
27,8,2019,18,549,689,1238,2019-08-27 17:00:00,2019-08-27 00:00:00,LABORABLE
27,8,2019,19,600,713,1313,2019-08-27 18:00:00,2019-08-27 00:00:00,LABORABLE
27,8,2019,20,563,786,1349,2019-08-27 19:00:00,2019-08-27 00:00:00,LABORABLE
27,8,2019,21,557,739,1296,2019-08-27 20:00:00,2019-08-27 00:00:00,LABORABLE
27,8,2019,22,471,638,1109,2019-08-27 21:00:00,2019-08-27 00:00:00,LABORABLE
27,8,2019,23,370,442,812,2019-08-27 22:00:00,2019-08-27 00:00:00,LABORABLE
27,8,2019,24,239,332,571,2019-08-27 23:00:00,2019-08-27 00:00:00,LABORABLE
28,8,2019,1,210,294,504,2019-08-28 00:00:00,2019-08-28 00:00:00,LABORABLE
28,8,2019,2,127,209,336,2019-08-28 01:00:00,2019-08-28 00:00:00,LABORABLE
28,8,2019,3,92,116,208,2019-08-28 02:00:00,2019-08-28 00:00:00,LABORABLE
28,8,2019,4,75,109,184,2019-08-28 03:00:00,2019-08-28 00:00:00,LABORABLE
28,8,2019,5,82,93,175,2019-08-28 04:00:00,2019-08-28 00:00:00,LABORABLE
28,8,2019,6,130,133,263,2019-08-28 05:00:00,2019-08-28 00:00:00,LABORABLE
28,8,2019,7,243,321,564,2019-08-28 06:00:00,2019-08-28 00:00:00,LABORABLE
28,8,2019,8,552,504,1056,2019-08-28 07:00:00,2019-08-28 00:00:00,LABORABLE
28,8,2019,9,488,582,1070,2019-08-28 08:00:00,2019-08-28 00:00:00,LABORABLE
28,8,2019,10,479,560,1039,2019-08-28 09:00:00,2019-08-28 00:00:00,LABORABLE
28,8,2019,11,479,621,1100,2019-08-28 10:00:00,2019-08-28 00:00:00,LABORABLE
28,8,2019,12,509,672,1181,2019-08-28 11:00:00,2019-08-28 00:00:00,LABORABLE
28,8,2019,13,491,731,1222,2019-08-28 12:00:00,2019-08-28 00:00:00,LABORABLE
28,8,2019,14,570,691,1261,2019-08-28 13:00:00,2019-08-28 00:00:00,LABORABLE
28,8,2019,15,555,654,1209,2019-08-28 14:00:00,2019-08-28 00:00:00,LABORABLE
28,8,2019,16,489,655,1144,2019-08-28 15:00:00,2019-08-28 00:00:00,LABORABLE
28,8,2019,17,466,622,1088,2019-08-28 16:00:00,2019-08-28 00:00:00,LABORABLE
28,8,2019,18,555,615,1170,2019-08-28 17:00:00,2019-08-28 00:00:00,LABORABLE
28,8,2019,19,589,687,1276,2019-08-28 18:00:00,2019-08-28 00:00:00,LABORABLE
28,8,2019,20,598,743,1341,2019-08-28 19:00:00,2019-08-28 00:00:00,LABORABLE
28,8,2019,21,583,764,1347,2019-08-28 20:00:00,2019-08-28 00:00:00,LABORABLE
28,8,2019,22,491,562,1053,2019-08-28 21:00:00,2019-08-28 00:00:00,LABORABLE
28,8,2019,23,429,531,960,2019-08-28 22:00:00,2019-08-28 00:00:00,LABORABLE
28,8,2019,24,231,329,560,2019-08-28 23:00:00,2019-08-28 00:00:00,LABORABLE
29,8,2019,1,202,301,503,2019-08-29 00:00:00,2019-08-29 00:00:00,LABORABLE
29,8,2019,2,152,236,388,2019-08-29 01:00:00,2019-08-29 00:00:00,LABORABLE
29,8,2019,3,97,148,245,2019-08-29 02:00:00,2019-08-29 00:00:00,LABORABLE
29,8,2019,4,82,122,204,2019-08-29 03:00:00,2019-08-29 00:00:00,LABORABLE
29,8,2019,5,75,90,165,2019-08-29 04:00:00,2019-08-29 00:00:00,LABORABLE
29,8,2019,6,152,159,311,2019-08-29 05:00:00,2019-08-29 00:00:00,LABORABLE
29,8,2019,7,328,279,607,2019-08-29 06:00:00,2019-08-29 00:00:00,LABORABLE
29,8,2019,8,550,509,1059,2019-08-29 07:00:00,2019-08-29 00:00:00,LABORABLE
29,8,2019,9,507,527,1034,2019-08-29 08:00:00,2019-08-29 00:00:00,LABORABLE
29,8,2019,10,493,551,1044,2019-08-29 09:00:00,2019-08-29 00:00:00,LABORABLE
29,8,2019,11,450,617,1067,2019-08-29 10:00:00,2019-08-29 00:00:00,LABORABLE
29,8,2019,12,519,679,1198,2019-08-29 11:00:00,2019-08-29 00:00:00,LABORABLE
29,8,2019,13,521,570,1091,2019-08-29 12:00:00,2019-08-29 00:00:00,LABORABLE
29,8,2019,14,566,629,1195,2019-08-29 13:00:00,2019-08-29 00:00:00,LABORABLE
29,8,2019,15,575,673,1248,2019-08-29 14:00:00,2019-08-29 00:00:00,LABORABLE
29,8,2019,16,502,581,1083,2019-08-29 15:00:00,2019-08-29 00:00:00,LABORABLE
29,8,2019,17,482,598,1080,2019-08-29 16:00:00,2019-08-29 00:00:00,LABORABLE
29,8,2019,18,576,714,1290,2019-08-29 17:00:00,2019-08-29 00:00:00,LABORABLE
29,8,2019,19,615,698,1313,2019-08-29 18:00:00,2019-08-29 00:00:00,LABORABLE
29,8,2019,20,642,762,1404,2019-08-29 19:00:00,2019-08-29 00:00:00,LABORABLE
29,8,2019,21,583,725,1308,2019-08-29 20:00:00,2019-08-29 00:00:00,LABORABLE
29,8,2019,22,560,627,1187,2019-08-29 21:00:00,2019-08-29 00:00:00,LABORABLE
29,8,2019,23,486,420,906,2019-08-29 22:00:00,2019-08-29 00:00:00,LABORABLE
29,8,2019,24,325,413,738,2019-08-29 23:00:00,2019-08-29 00:00:00,LABORABLE
30,8,2019,1,253,353,606,2019-08-30 00:00:00,2019-08-30 00:00:00,LABORABLE
30,8,2019,2,128,226,354,2019-08-30 01:00:00,2019-08-30 00:00:00,LABORABLE
30,8,2019,3,102,186,288,2019-08-30 02:00:00,2019-08-30 00:00:00,LABORABLE
30,8,2019,4,82,134,216,2019-08-30 03:00:00,2019-08-30 00:00:00,LABORABLE
30,8,2019,5,78,124,202,2019-08-30 04:00:00,2019-08-30 00:00:00,LABORABLE
30,8,2019,6,149,147,296,2019-08-30 05:00:00,2019-08-30 00:00:00,LABORABLE
30,8,2019,7,343,320,663,2019-08-30 06:00:00,2019-08-30 00:00:00,LABORABLE
30,8,2019,8,573,463,1036,2019-08-30 07:00:00,2019-08-30 00:00:00,LABORABLE
30,8,2019,9,467,497,964,2019-08-30 08:00:00,2019-08-30 00:00:00,LABORABLE
30,8,2019,10,470,531,1001,2019-08-30 09:00:00,2019-08-30 00:00:00,LABORABLE
30,8,2019,11,530,589,1119,2019-08-30 10:00:00,2019-08-30 00:00:00,LABORABLE
30,8,2019,12,545,687,1232,2019-08-30 11:00:00,2019-08-30 00:00:00,LABORABLE
30,8,2019,13,619,727,1346,2019-08-30 12:00:00,2019-08-30 00:00:00,LABORABLE
30,8,2019,14,624,740,1364,2019-08-30 13:00:00,2019-08-30 00:00:00,LABORABLE
30,8,2019,15,613,691,1304,2019-08-30 14:00:00,2019-08-30 00:00:00,LABORABLE
30,8,2019,16,517,706,1223,2019-08-30 15:00:00,2019-08-30 00:00:00,LABORABLE
30,8,2019,17,545,695,1240,2019-08-30 16:00:00,2019-08-30 00:00:00,LABORABLE
30,8,2019,18,615,708,1323,2019-08-30 17:00:00,2019-08-30 00:00:00,LABORABLE
30,8,2019,19,652,766,1418,2019-08-30 18:00:00,2019-08-30 00:00:00,LABORABLE
30,8,2019,20,606,760,1366,2019-08-30 19:00:00,2019-08-30 00:00:00,LABORABLE
30,8,2019,21,635,812,1447,2019-08-30 20:00:00,2019-08-30 00:00:00,LABORABLE
30,8,2019,22,572,755,1327,2019-08-30 21:00:00,2019-08-30 00:00:00,LABORABLE
30,8,2019,23,510,559,1069,2019-08-30 22:00:00,2019-08-30 00:00:00,LABORABLE
30,8,2019,24,383,489,872,2019-08-30 23:00:00,2019-08-30 00:00:00,LABORABLE
31,8,2019,1,0,289,289,2019-08-31 00:00:00,2019-08-31 00:00:00,LABORABLE
31,8,2019,2,0,211,211,2019-08-31 01:00:00,2019-08-31 00:00:00,LABORABLE
31,8,2019,3,0,149,149,2019-08-31 02:00:00,2019-08-31 00:00:00,LABORABLE
31,8,2019,4,0,106,106,2019-08-31 03:00:00,2019-08-31 00:00:00,LABORABLE
31,8,2019,5,0,77,77,2019-08-31 04:00:00,2019-08-31 00:00:00,LABORABLE
31,8,2019,6,0,139,139,2019-08-31 05:00:00,2019-08-31 00:00:00,LABORABLE
31,8,2019,7,0,348,348,2019-08-31 06:00:00,2019-08-31 00:00:00,LABORABLE
31,8,2019,8,0,546,546,2019-08-31 07:00:00,2019-08-31 00:00:00,LABORABLE
31,8,2019,9,0,513,513,2019-08-31 08:00:00,2019-08-31 00:00:00,LABORABLE
31,8,2019,10,0,623,623,2019-08-31 09:00:00,2019-08-31 00:00:00,LABORABLE
31,8,2019,11,0,639,639,2019-08-31 10:00:00,2019-08-31 00:00:00,LABORABLE
31,8,2019,12,0,695,695,2019-08-31 11:00:00,2019-08-31 00:00:00,LABORABLE
31,8,2019,13,0,704,704,2019-08-31 12:00:00,2019-08-31 00:00:00,LABORABLE
31,8,2019,14,0,839,839,2019-08-31 13:00:00,2019-08-31 00:00:00,LABORABLE
31,8,2019,15,0,423,423,2019-08-31 14:00:00,2019-08-31 00:00:00,LABORABLE
31,8,2019,16,0,713,713,2019-08-31 15:00:00,2019-08-31 00:00:00,LABORABLE
31,8,2019,17,0,670,670,2019-08-31 16:00:00,2019-08-31 00:00:00,LABORABLE
31,8,2019,18,0,745,745,2019-08-31 17:00:00,2019-08-31 00:00:00,LABORABLE
31,8,2019,19,0,777,777,2019-08-31 18:00:00,2019-08-31 00:00:00,LABORABLE
31,8,2019,20,0,836,836,2019-08-31 19:00:00,2019-08-31 00:00:00,LABORABLE
31,8,2019,21,0,835,835,2019-08-31 20:00:00,2019-08-31 00:00:00,LABORABLE
31,8,2019,22,0,705,705,2019-08-31 21:00:00,2019-08-31 00:00:00,LABORABLE
31,8,2019,23,0,569,569,2019-08-31 22:00:00,2019-08-31 00:00:00,LABORABLE
31,8,2019,24,0,464,464,2019-08-31 23:00:00,2019-08-31 00:00:00,LABORABLE
1,9,2019,1,343,445,788,2019-09-01 00:00:00,2019-01-09 00:00:00,LABORABLE
1,9,2019,2,292,360,652,2019-09-01 01:00:00,2019-01-09 00:00:00,LABORABLE
1,9,2019,3,256,347,603,2019-09-01 02:00:00,2019-01-09 00:00:00,LABORABLE
1,9,2019,4,170,241,411,2019-09-01 03:00:00,2019-01-09 00:00:00,LABORABLE
1,9,2019,5,141,232,373,2019-09-01 04:00:00,2019-01-09 00:00:00,LABORABLE
1,9,2019,6,141,219,360,2019-09-01 05:00:00,2019-01-09 00:00:00,LABORABLE
1,9,2019,7,166,289,455,2019-09-01 06:00:00,2019-01-09 00:00:00,LABORABLE
1,9,2019,8,211,265,476,2019-09-01 07:00:00,2019-01-09 00:00:00,LABORABLE
1,9,2019,9,221,273,494,2019-09-01 08:00:00,2019-01-09 00:00:00,LABORABLE
1,9,2019,10,309,396,705,2019-09-01 09:00:00,2019-01-09 00:00:00,LABORABLE
1,9,2019,11,384,412,796,2019-09-01 10:00:00,2019-01-09 00:00:00,LABORABLE
1,9,2019,12,440,586,1026,2019-09-01 11:00:00,2019-01-09 00:00:00,LABORABLE
1,9,2019,13,492,656,1148,2019-09-01 12:00:00,2019-01-09 00:00:00,LABORABLE
1,9,2019,14,593,686,1279,2019-09-01 13:00:00,2019-01-09 00:00:00,LABORABLE
1,9,2019,15,561,653,1214,2019-09-01 14:00:00,2019-01-09 00:00:00,LABORABLE
1,9,2019,16,431,630,1061,2019-09-01 15:00:00,2019-01-09 00:00:00,LABORABLE
1,9,2019,17,422,646,1068,2019-09-01 16:00:00,2019-01-09 00:00:00,LABORABLE
1,9,2019,18,506,700,1206,2019-09-01 17:00:00,2019-01-09 00:00:00,LABORABLE
1,9,2019,19,511,714,1225,2019-09-01 18:00:00,2019-01-09 00:00:00,LABORABLE
1,9,2019,20,500,680,1180,2019-09-01 19:00:00,2019-01-09 00:00:00,LABORABLE
1,9,2019,21,466,683,1149,2019-09-01 20:00:00,2019-01-09 00:00:00,LABORABLE
1,9,2019,22,503,631,1134,2019-09-01 21:00:00,2019-01-09 00:00:00,LABORABLE
1,9,2019,23,464,598,1062,2019-09-01 22:00:00,2019-01-09 00:00:00,LABORABLE
1,9,2019,24,360,475,835,2019-09-01 23:00:00,2019-01-09 00:00:00,LABORABLE
2,9,2019,1,220,307,527,2019-09-02 00:00:00,2019-02-09 00:00:00,LABORABLE
2,9,2019,2,184,234,418,2019-09-02 01:00:00,2019-02-09 00:00:00,LABORABLE
2,9,2019,3,125,159,284,2019-09-02 02:00:00,2019-02-09 00:00:00,LABORABLE
2,9,2019,4,79,159,238,2019-09-02 03:00:00,2019-02-09 00:00:00,LABORABLE
2,9,2019,5,75,123,198,2019-09-02 04:00:00,2019-02-09 00:00:00,LABORABLE
2,9,2019,6,154,207,361,2019-09-02 05:00:00,2019-02-09 00:00:00,LABORABLE
2,9,2019,7,397,384,781,2019-09-02 06:00:00,2019-02-09 00:00:00,LABORABLE
2,9,2019,8,644,561,1205,2019-09-02 07:00:00,2019-02-09 00:00:00,LABORABLE
2,9,2019,9,613,584,1197,2019-09-02 08:00:00,2019-02-09 00:00:00,LABORABLE
2,9,2019,10,554,664,1218,2019-09-02 09:00:00,2019-02-09 00:00:00,LABORABLE
2,9,2019,11,515,604,1119,2019-09-02 10:00:00,2019-02-09 00:00:00,LABORABLE
2,9,2019,12,571,685,1256,2019-09-02 11:00:00,2019-02-09 00:00:00,LABORABLE
2,9,2019,13,636,736,1372,2019-09-02 12:00:00,2019-02-09 00:00:00,LABORABLE
2,9,2019,14,655,808,1463,2019-09-02 13:00:00,2019-02-09 00:00:00,LABORABLE
2,9,2019,15,661,696,1357,2019-09-02 14:00:00,2019-02-09 00:00:00,LABORABLE
2,9,2019,16,582,643,1225,2019-09-02 15:00:00,2019-02-09 00:00:00,LABORABLE
2,9,2019,17,582,713,1295,2019-09-02 16:00:00,2019-02-09 00:00:00,LABORABLE
2,9,2019,18,598,742,1340,2019-09-02 17:00:00,2019-02-09 00:00:00,LABORABLE
2,9,2019,19,675,818,1493,2019-09-02 18:00:00,2019-02-09 00:00:00,LABORABLE
2,9,2019,20,713,824,1537,2019-09-02 19:00:00,2019-02-09 00:00:00,LABORABLE
2,9,2019,21,656,797,1453,2019-09-02 20:00:00,2019-02-09 00:00:00,LABORABLE
2,9,2019,22,532,641,1173,2019-09-02 21:00:00,2019-02-09 00:00:00,LABORABLE
2,9,2019,23,434,520,954,2019-09-02 22:00:00,2019-02-09 00:00:00,LABORABLE
2,9,2019,24,257,369,626,2019-09-02 23:00:00,2019-02-09 00:00:00,LABORABLE
3,9,2019,1,199,260,459,2019-09-03 00:00:00,2019-03-09 00:00:00,LABORABLE
3,9,2019,2,107,224,331,2019-09-03 01:00:00,2019-03-09 00:00:00,LABORABLE
3,9,2019,3,100,147,247,2019-09-03 02:00:00,2019-03-09 00:00:00,LABORABLE
3,9,2019,4,80,115,195,2019-09-03 03:00:00,2019-03-09 00:00:00,LABORABLE
3,9,2019,5,78,98,176,2019-09-03 04:00:00,2019-03-09 00:00:00,LABORABLE
3,9,2019,6,150,182,332,2019-09-03 05:00:00,2019-03-09 00:00:00,LABORABLE
3,9,2019,7,411,403,814,2019-09-03 06:00:00,2019-03-09 00:00:00,LABORABLE
3,9,2019,8,638,539,1177,2019-09-03 07:00:00,2019-03-09 00:00:00,LABORABLE
3,9,2019,9,617,603,1220,2019-09-03 08:00:00,2019-03-09 00:00:00,LABORABLE
3,9,2019,10,561,697,1258,2019-09-03 09:00:00,2019-03-09 00:00:00,LABORABLE
3,9,2019,11,522,616,1138,2019-09-03 10:00:00,2019-03-09 00:00:00,LABORABLE
3,9,2019,12,536,649,1185,2019-09-03 11:00:00,2019-03-09 00:00:00,LABORABLE
3,9,2019,13,601,745,1346,2019-09-03 12:00:00,2019-03-09 00:00:00,LABORABLE
3,9,2019,14,645,787,1432,2019-09-03 13:00:00,2019-03-09 00:00:00,LABORABLE
3,9,2019,15,635,756,1391,2019-09-03 14:00:00,2019-03-09 00:00:00,LABORABLE
3,9,2019,16,534,648,1182,2019-09-03 15:00:00,2019-03-09 00:00:00,LABORABLE
3,9,2019,17,579,707,1286,2019-09-03 16:00:00,2019-03-09 00:00:00,LABORABLE
3,9,2019,18,683,802,1485,2019-09-03 17:00:00,2019-03-09 00:00:00,LABORABLE
3,9,2019,19,702,773,1475,2019-09-03 18:00:00,2019-03-09 00:00:00,LABORABLE
3,9,2019,20,722,788,1510,2019-09-03 19:00:00,2019-03-09 00:00:00,LABORABLE
3,9,2019,21,649,803,1452,2019-09-03 20:00:00,2019-03-09 00:00:00,LABORABLE
3,9,2019,22,555,644,1199,2019-09-03 21:00:00,2019-03-09 00:00:00,LABORABLE
3,9,2019,23,436,475,911,2019-09-03 22:00:00,2019-03-09 00:00:00,LABORABLE
3,9,2019,24,296,385,681,2019-09-03 23:00:00,2019-03-09 00:00:00,LABORABLE
4,9,2019,1,232,346,578,2019-09-04 00:00:00,2019-04-09 00:00:00,LABORABLE
4,9,2019,2,135,241,376,2019-09-04 01:00:00,2019-04-09 00:00:00,LABORABLE
4,9,2019,3,88,181,269,2019-09-04 02:00:00,2019-04-09 00:00:00,LABORABLE
4,9,2019,4,77,122,199,2019-09-04 03:00:00,2019-04-09 00:00:00,LABORABLE
4,9,2019,5,92,87,179,2019-09-04 04:00:00,2019-04-09 00:00:00,LABORABLE
4,9,2019,6,170,173,343,2019-09-04 05:00:00,2019-04-09 00:00:00,LABORABLE
4,9,2019,7,387,384,771,2019-09-04 06:00:00,2019-04-09 00:00:00,LABORABLE
4,9,2019,8,686,588,1274,2019-09-04 07:00:00,2019-04-09 00:00:00,LABORABLE
4,9,2019,9,591,617,1208,2019-09-04 08:00:00,2019-04-09 00:00:00,LABORABLE
4,9,2019,10,555,682,1237,2019-09-04 09:00:00,2019-04-09 00:00:00,LABORABLE
4,9,2019,11,550,656,1206,2019-09-04 10:00:00,2019-04-09 00:00:00,LABORABLE
4,9,2019,12,601,717,1318,2019-09-04 11:00:00,2019-04-09 00:00:00,LABORABLE
4,9,2019,13,620,721,1341,2019-09-04 12:00:00,2019-04-09 00:00:00,LABORABLE
4,9,2019,14,622,754,1376,2019-09-04 13:00:00,2019-04-09 00:00:00,LABORABLE
4,9,2019,15,610,750,1360,2019-09-04 14:00:00,2019-04-09 00:00:00,LABORABLE
4,9,2019,16,535,663,1198,2019-09-04 15:00:00,2019-04-09 00:00:00,LABORABLE
4,9,2019,17,589,691,1280,2019-09-04 16:00:00,2019-04-09 00:00:00,LABORABLE
4,9,2019,18,641,735,1376,2019-09-04 17:00:00,2019-04-09 00:00:00,LABORABLE
4,9,2019,19,700,789,1489,2019-09-04 18:00:00,2019-04-09 00:00:00,LABORABLE
4,9,2019,20,671,813,1484,2019-09-04 19:00:00,2019-04-09 00:00:00,LABORABLE
4,9,2019,21,683,780,1463,2019-09-04 20:00:00,2019-04-09 00:00:00,LABORABLE
4,9,2019,22,580,685,1265,2019-09-04 21:00:00,2019-04-09 00:00:00,LABORABLE
4,9,2019,23,499,526,1025,2019-09-04 22:00:00,2019-04-09 00:00:00,LABORABLE
4,9,2019,24,330,351,681,2019-09-04 23:00:00,2019-04-09 00:00:00,LABORABLE
5,9,2019,1,250,292,542,2019-09-05 00:00:00,2019-05-09 00:00:00,LABORABLE
5,9,2019,2,141,218,359,2019-09-05 01:00:00,2019-05-09 00:00:00,LABORABLE
5,9,2019,3,125,188,313,2019-09-05 02:00:00,2019-05-09 00:00:00,LABORABLE
5,9,2019,4,74,114,188,2019-09-05 03:00:00,2019-05-09 00:00:00,LABORABLE
5,9,2019,5,92,142,234,2019-09-05 04:00:00,2019-05-09 00:00:00,LABORABLE
5,9,2019,6,170,169,339,2019-09-05 05:00:00,2019-05-09 00:00:00,LABORABLE
5,9,2019,7,257,357,614,2019-09-05 06:00:00,2019-05-09 00:00:00,LABORABLE
5,9,2019,8,401,510,911,2019-09-05 07:00:00,2019-05-09 00:00:00,LABORABLE
5,9,2019,9,611,617,1228,2019-09-05 08:00:00,2019-05-09 00:00:00,LABORABLE
5,9,2019,10,615,709,1324,2019-09-05 09:00:00,2019-05-09 00:00:00,LABORABLE
5,9,2019,11,554,729,1283,2019-09-05 10:00:00,2019-05-09 00:00:00,LABORABLE
5,9,2019,12,556,779,1335,2019-09-05 11:00:00,2019-05-09 00:00:00,LABORABLE
5,9,2019,13,598,711,1309,2019-09-05 12:00:00,2019-05-09 00:00:00,LABORABLE
5,9,2019,14,646,764,1410,2019-09-05 13:00:00,2019-05-09 00:00:00,LABORABLE
5,9,2019,15,623,746,1369,2019-09-05 14:00:00,2019-05-09 00:00:00,LABORABLE
5,9,2019,16,614,648,1262,2019-09-05 15:00:00,2019-05-09 00:00:00,LABORABLE
5,9,2019,17,506,568,1074,2019-09-05 16:00:00,2019-05-09 00:00:00,LABORABLE
5,9,2019,18,659,753,1412,2019-09-05 17:00:00,2019-05-09 00:00:00,LABORABLE
5,9,2019,19,708,845,1553,2019-09-05 18:00:00,2019-05-09 00:00:00,LABORABLE
5,9,2019,20,689,829,1518,2019-09-05 19:00:00,2019-05-09 00:00:00,LABORABLE
5,9,2019,21,708,793,1501,2019-09-05 20:00:00,2019-05-09 00:00:00,LABORABLE
5,9,2019,22,587,693,1280,2019-09-05 21:00:00,2019-05-09 00:00:00,LABORABLE
5,9,2019,23,486,561,1047,2019-09-05 22:00:00,2019-05-09 00:00:00,LABORABLE
5,9,2019,24,377,428,805,2019-09-05 23:00:00,2019-05-09 00:00:00,LABORABLE
6,9,2019,1,238,319,557,2019-09-06 00:00:00,2019-06-09 00:00:00,LABORABLE
6,9,2019,2,146,265,411,2019-09-06 01:00:00,2019-06-09 00:00:00,LABORABLE
6,9,2019,3,121,186,307,2019-09-06 02:00:00,2019-06-09 00:00:00,LABORABLE
6,9,2019,4,89,145,234,2019-09-06 03:00:00,2019-06-09 00:00:00,LABORABLE
6,9,2019,5,99,132,231,2019-09-06 04:00:00,2019-06-09 00:00:00,LABORABLE
6,9,2019,6,162,200,362,2019-09-06 05:00:00,2019-06-09 00:00:00,LABORABLE
6,9,2019,7,243,412,655,2019-09-06 06:00:00,2019-06-09 00:00:00,LABORABLE
6,9,2019,8,639,581,1220,2019-09-06 07:00:00,2019-06-09 00:00:00,LABORABLE
6,9,2019,9,624,614,1238,2019-09-06 08:00:00,2019-06-09 00:00:00,LABORABLE
6,9,2019,10,554,603,1157,2019-09-06 09:00:00,2019-06-09 00:00:00,LABORABLE
6,9,2019,11,551,634,1185,2019-09-06 10:00:00,2019-06-09 00:00:00,LABORABLE
6,9,2019,12,594,766,1360,2019-09-06 11:00:00,2019-06-09 00:00:00,LABORABLE
6,9,2019,13,640,720,1360,2019-09-06 12:00:00,2019-06-09 00:00:00,LABORABLE
6,9,2019,14,531,658,1189,2019-09-06 13:00:00,2019-06-09 00:00:00,LABORABLE
6,9,2019,15,680,750,1430,2019-09-06 14:00:00,2019-06-09 00:00:00,LABORABLE
6,9,2019,16,622,653,1275,2019-09-06 15:00:00,2019-06-09 00:00:00,LABORABLE
6,9,2019,17,602,692,1294,2019-09-06 16:00:00,2019-06-09 00:00:00,LABORABLE
6,9,2019,18,702,778,1480,2019-09-06 17:00:00,2019-06-09 00:00:00,LABORABLE
6,9,2019,19,693,798,1491,2019-09-06 18:00:00,2019-06-09 00:00:00,LABORABLE
6,9,2019,20,636,792,1428,2019-09-06 19:00:00,2019-06-09 00:00:00,LABORABLE
6,9,2019,21,694,834,1528,2019-09-06 20:00:00,2019-06-09 00:00:00,LABORABLE
6,9,2019,22,586,796,1382,2019-09-06 21:00:00,2019-06-09 00:00:00,LABORABLE
6,9,2019,23,564,691,1255,2019-09-06 22:00:00,2019-06-09 00:00:00,LABORABLE
6,9,2019,24,433,553,986,2019-09-06 23:00:00,2019-06-09 00:00:00,LABORABLE
7,9,2019,1,351,445,796,2019-09-07 00:00:00,2019-07-09 00:00:00,LABORABLE
7,9,2019,2,260,386,646,2019-09-07 01:00:00,2019-07-09 00:00:00,LABORABLE
7,9,2019,3,204,350,554,2019-09-07 02:00:00,2019-07-09 00:00:00,LABORABLE
7,9,2019,4,174,233,407,2019-09-07 03:00:00,2019-07-09 00:00:00,LABORABLE
7,9,2019,5,139,215,354,2019-09-07 04:00:00,2019-07-09 00:00:00,LABORABLE
7,9,2019,6,131,213,344,2019-09-07 05:00:00,2019-07-09 00:00:00,LABORABLE
7,9,2019,7,229,261,490,2019-09-07 06:00:00,2019-07-09 00:00:00,LABORABLE
7,9,2019,8,262,269,531,2019-09-07 07:00:00,2019-07-09 00:00:00,LABORABLE
7,9,2019,9,335,340,675,2019-09-07 08:00:00,2019-07-09 00:00:00,LABORABLE
7,9,2019,10,445,553,998,2019-09-07 09:00:00,2019-07-09 00:00:00,LABORABLE
7,9,2019,11,532,624,1156,2019-09-07 10:00:00,2019-07-09 00:00:00,LABORABLE
7,9,2019,12,649,677,1326,2019-09-07 11:00:00,2019-07-09 00:00:00,LABORABLE
7,9,2019,13,643,704,1347,2019-09-07 12:00:00,2019-07-09 00:00:00,LABORABLE
7,9,2019,14,676,754,1430,2019-09-07 13:00:00,2019-07-09 00:00:00,LABORABLE
7,9,2019,15,613,796,1409,2019-09-07 14:00:00,2019-07-09 00:00:00,LABORABLE
7,9,2019,16,466,690,1156,2019-09-07 15:00:00,2019-07-09 00:00:00,LABORABLE
7,9,2019,17,500,663,1163,2019-09-07 16:00:00,2019-07-09 00:00:00,LABORABLE
7,9,2019,18,528,683,1211,2019-09-07 17:00:00,2019-07-09 00:00:00,LABORABLE
7,9,2019,19,604,731,1335,2019-09-07 18:00:00,2019-07-09 00:00:00,LABORABLE
7,9,2019,20,583,785,1368,2019-09-07 19:00:00,2019-07-09 00:00:00,LABORABLE
7,9,2019,21,593,757,1350,2019-09-07 20:00:00,2019-07-09 00:00:00,LABORABLE
7,9,2019,22,576,664,1240,2019-09-07 21:00:00,2019-07-09 00:00:00,LABORABLE
7,9,2019,23,537,634,1171,2019-09-07 22:00:00,2019-07-09 00:00:00,LABORABLE
7,9,2019,24,532,619,1151,2019-09-07 23:00:00,2019-07-09 00:00:00,LABORABLE
8,9,2019,1,442,511,953,2019-09-08 00:00:00,2019-08-09 00:00:00,LABORABLE
8,9,2019,2,339,458,797,2019-09-08 01:00:00,2019-08-09 00:00:00,LABORABLE
8,9,2019,3,261,400,661,2019-09-08 02:00:00,2019-08-09 00:00:00,LABORABLE
8,9,2019,4,197,345,542,2019-09-08 03:00:00,2019-08-09 00:00:00,LABORABLE
8,9,2019,5,178,268,446,2019-09-08 04:00:00,2019-08-09 00:00:00,LABORABLE
8,9,2019,6,157,276,433,2019-09-08 05:00:00,2019-08-09 00:00:00,LABORABLE
8,9,2019,7,213,316,529,2019-09-08 06:00:00,2019-08-09 00:00:00,LABORABLE
8,9,2019,8,218,253,471,2019-09-08 07:00:00,2019-08-09 00:00:00,LABORABLE
8,9,2019,9,220,256,476,2019-09-08 08:00:00,2019-08-09 00:00:00,LABORABLE
8,9,2019,10,325,358,683,2019-09-08 09:00:00,2019-08-09 00:00:00,LABORABLE
8,9,2019,11,395,477,872,2019-09-08 10:00:00,2019-08-09 00:00:00,LABORABLE
8,9,2019,12,447,576,1023,2019-09-08 11:00:00,2019-08-09 00:00:00,LABORABLE
8,9,2019,13,529,602,1131,2019-09-08 12:00:00,2019-08-09 00:00:00,LABORABLE
8,9,2019,14,533,712,1245,2019-09-08 13:00:00,2019-08-09 00:00:00,LABORABLE
8,9,2019,15,544,686,1230,2019-09-08 14:00:00,2019-08-09 00:00:00,LABORABLE
8,9,2019,16,410,589,999,2019-09-08 15:00:00,2019-08-09 00:00:00,LABORABLE
8,9,2019,17,413,636,1049,2019-09-08 16:00:00,2019-08-09 00:00:00,LABORABLE
8,9,2019,18,517,652,1169,2019-09-08 17:00:00,2019-08-09 00:00:00,LABORABLE
8,9,2019,19,572,681,1253,2019-09-08 18:00:00,2019-08-09 00:00:00,LABORABLE
8,9,2019,20,514,661,1175,2019-09-08 19:00:00,2019-08-09 00:00:00,LABORABLE
8,9,2019,21,483,669,1152,2019-09-08 20:00:00,2019-08-09 00:00:00,LABORABLE
8,9,2019,22,583,632,1215,2019-09-08 21:00:00,2019-08-09 00:00:00,LABORABLE
8,9,2019,23,465,545,1010,2019-09-08 22:00:00,2019-08-09 00:00:00,LABORABLE
8,9,2019,24,324,397,721,2019-09-08 23:00:00,2019-08-09 00:00:00,LABORABLE
9,9,2019,1,247,309,556,2019-09-09 00:00:00,2019-09-09 00:00:00,LABORABLE
9,9,2019,2,170,269,439,2019-09-09 01:00:00,2019-09-09 00:00:00,LABORABLE
9,9,2019,3,113,162,275,2019-09-09 02:00:00,2019-09-09 00:00:00,LABORABLE
9,9,2019,4,74,106,180,2019-09-09 03:00:00,2019-09-09 00:00:00,LABORABLE
9,9,2019,5,72,109,181,2019-09-09 04:00:00,2019-09-09 00:00:00,LABORABLE
9,9,2019,6,176,179,355,2019-09-09 05:00:00,2019-09-09 00:00:00,LABORABLE
9,9,2019,7,426,430,856,2019-09-09 06:00:00,2019-09-09 00:00:00,LABORABLE
9,9,2019,8,668,592,1260,2019-09-09 07:00:00,2019-09-09 00:00:00,LABORABLE
9,9,2019,9,647,681,1328,2019-09-09 08:00:00,2019-09-09 00:00:00,LABORABLE
9,9,2019,10,594,690,1284,2019-09-09 09:00:00,2019-09-09 00:00:00,LABORABLE
9,9,2019,11,602,703,1305,2019-09-09 10:00:00,2019-09-09 00:00:00,LABORABLE
9,9,2019,12,610,733,1343,2019-09-09 11:00:00,2019-09-09 00:00:00,LABORABLE
9,9,2019,13,626,725,1351,2019-09-09 12:00:00,2019-09-09 00:00:00,LABORABLE
9,9,2019,14,674,736,1410,2019-09-09 13:00:00,2019-09-09 00:00:00,LABORABLE
9,9,2019,15,706,754,1460,2019-09-09 14:00:00,2019-09-09 00:00:00,LABORABLE
9,9,2019,16,634,692,1326,2019-09-09 15:00:00,2019-09-09 00:00:00,LABORABLE
9,9,2019,17,652,738,1390,2019-09-09 16:00:00,2019-09-09 00:00:00,LABORABLE
9,9,2019,18,652,690,1342,2019-09-09 17:00:00,2019-09-09 00:00:00,LABORABLE
9,9,2019,19,716,780,1496,2019-09-09 18:00:00,2019-09-09 00:00:00,LABORABLE
9,9,2019,20,715,762,1477,2019-09-09 19:00:00,2019-09-09 00:00:00,LABORABLE
9,9,2019,21,664,812,1476,2019-09-09 20:00:00,2019-09-09 00:00:00,LABORABLE
9,9,2019,22,519,648,1167,2019-09-09 21:00:00,2019-09-09 00:00:00,LABORABLE
9,9,2019,23,395,497,892,2019-09-09 22:00:00,2019-09-09 00:00:00,LABORABLE
9,9,2019,24,255,355,610,2019-09-09 23:00:00,2019-09-09 00:00:00,LABORABLE
10,9,2019,1,164,268,432,2019-09-10 00:00:00,2019-10-09 00:00:00,LABORABLE
10,9,2019,2,124,176,300,2019-09-10 01:00:00,2019-10-09 00:00:00,LABORABLE
10,9,2019,3,77,145,222,2019-09-10 02:00:00,2019-10-09 00:00:00,LABORABLE
10,9,2019,4,75,113,188,2019-09-10 03:00:00,2019-10-09 00:00:00,LABORABLE
10,9,2019,5,81,97,178,2019-09-10 04:00:00,2019-10-09 00:00:00,LABORABLE
10,9,2019,6,164,171,335,2019-09-10 05:00:00,2019-10-09 00:00:00,LABORABLE
10,9,2019,7,419,409,828,2019-09-10 06:00:00,2019-10-09 00:00:00,LABORABLE
10,9,2019,8,654,613,1267,2019-09-10 07:00:00,2019-10-09 00:00:00,LABORABLE
10,9,2019,9,658,672,1330,2019-09-10 08:00:00,2019-10-09 00:00:00,LABORABLE
10,9,2019,10,605,704,1309,2019-09-10 09:00:00,2019-10-09 00:00:00,LABORABLE
10,9,2019,11,541,667,1208,2019-09-10 10:00:00,2019-10-09 00:00:00,LABORABLE
10,9,2019,12,527,631,1158,2019-09-10 11:00:00,2019-10-09 00:00:00,LABORABLE
10,9,2019,13,640,733,1373,2019-09-10 12:00:00,2019-10-09 00:00:00,LABORABLE
10,9,2019,14,632,780,1412,2019-09-10 13:00:00,2019-10-09 00:00:00,LABORABLE
10,9,2019,15,685,763,1448,2019-09-10 14:00:00,2019-10-09 00:00:00,LABORABLE
10,9,2019,16,659,688,1347,2019-09-10 15:00:00,2019-10-09 00:00:00,LABORABLE
10,9,2019,17,649,718,1367,2019-09-10 16:00:00,2019-10-09 00:00:00,LABORABLE
10,9,2019,18,692,796,1488,2019-09-10 17:00:00,2019-10-09 00:00:00,LABORABLE
10,9,2019,19,663,826,1489,2019-09-10 18:00:00,2019-10-09 00:00:00,LABORABLE
10,9,2019,20,658,797,1455,2019-09-10 19:00:00,2019-10-09 00:00:00,LABORABLE
10,9,2019,21,646,754,1400,2019-09-10 20:00:00,2019-10-09 00:00:00,LABORABLE
10,9,2019,22,551,627,1178,2019-09-10 21:00:00,2019-10-09 00:00:00,LABORABLE
10,9,2019,23,389,508,897,2019-09-10 22:00:00,2019-10-09 00:00:00,LABORABLE
10,9,2019,24,272,330,602,2019-09-10 23:00:00,2019-10-09 00:00:00,LABORABLE
11,9,2019,1,215,252,467,2019-09-11 00:00:00,2019-11-09 00:00:00,LABORABLE
11,9,2019,2,145,195,340,2019-09-11 01:00:00,2019-11-09 00:00:00,LABORABLE
11,9,2019,3,89,145,234,2019-09-11 02:00:00,2019-11-09 00:00:00,LABORABLE
11,9,2019,4,75,122,197,2019-09-11 03:00:00,2019-11-09 00:00:00,LABORABLE
11,9,2019,5,73,95,168,2019-09-11 04:00:00,2019-11-09 00:00:00,LABORABLE
11,9,2019,6,172,165,337,2019-09-11 05:00:00,2019-11-09 00:00:00,LABORABLE
11,9,2019,7,403,413,816,2019-09-11 06:00:00,2019-11-09 00:00:00,LABORABLE
11,9,2019,8,674,595,1269,2019-09-11 07:00:00,2019-11-09 00:00:00,LABORABLE
11,9,2019,9,655,688,1343,2019-09-11 08:00:00,2019-11-09 00:00:00,LABORABLE
11,9,2019,10,632,719,1351,2019-09-11 09:00:00,2019-11-09 00:00:00,LABORABLE
11,9,2019,11,562,693,1255,2019-09-11 10:00:00,2019-11-09 00:00:00,LABORABLE
11,9,2019,12,610,704,1314,2019-09-11 11:00:00,2019-11-09 00:00:00,LABORABLE
11,9,2019,13,597,717,1314,2019-09-11 12:00:00,2019-11-09 00:00:00,LABORABLE
11,9,2019,14,625,757,1382,2019-09-11 13:00:00,2019-11-09 00:00:00,LABORABLE
11,9,2019,15,648,715,1363,2019-09-11 14:00:00,2019-11-09 00:00:00,LABORABLE
11,9,2019,16,613,647,1260,2019-09-11 15:00:00,2019-11-09 00:00:00,LABORABLE
11,9,2019,17,634,696,1330,2019-09-11 16:00:00,2019-11-09 00:00:00,LABORABLE
11,9,2019,18,711,710,1421,2019-09-11 17:00:00,2019-11-09 00:00:00,LABORABLE
11,9,2019,19,684,819,1503,2019-09-11 18:00:00,2019-11-09 00:00:00,LABORABLE
11,9,2019,20,673,768,1441,2019-09-11 19:00:00,2019-11-09 00:00:00,LABORABLE
11,9,2019,21,662,730,1392,2019-09-11 20:00:00,2019-11-09 00:00:00,LABORABLE
11,9,2019,22,574,628,1202,2019-09-11 21:00:00,2019-11-09 00:00:00,LABORABLE
11,9,2019,23,434,550,984,2019-09-11 22:00:00,2019-11-09 00:00:00,LABORABLE
11,9,2019,24,277,405,682,2019-09-11 23:00:00,2019-11-09 00:00:00,LABORABLE
12,9,2019,1,210,326,536,2019-09-12 00:00:00,2019-12-09 00:00:00,LABORABLE
12,9,2019,2,160,220,380,2019-09-12 01:00:00,2019-12-09 00:00:00,LABORABLE
12,9,2019,3,119,169,288,2019-09-12 02:00:00,2019-12-09 00:00:00,LABORABLE
12,9,2019,4,77,113,190,2019-09-12 03:00:00,2019-12-09 00:00:00,LABORABLE
12,9,2019,5,84,126,210,2019-09-12 04:00:00,2019-12-09 00:00:00,LABORABLE
12,9,2019,6,174,172,346,2019-09-12 05:00:00,2019-12-09 00:00:00,LABORABLE
12,9,2019,7,257,395,652,2019-09-12 06:00:00,2019-12-09 00:00:00,LABORABLE
12,9,2019,8,401,591,992,2019-09-12 07:00:00,2019-12-09 00:00:00,LABORABLE
12,9,2019,9,681,725,1406,2019-09-12 08:00:00,2019-12-09 00:00:00,LABORABLE
12,9,2019,10,621,751,1372,2019-09-12 09:00:00,2019-12-09 00:00:00,LABORABLE
12,9,2019,11,602,701,1303,2019-09-12 10:00:00,2019-12-09 00:00:00,LABORABLE
12,9,2019,12,642,748,1390,2019-09-12 11:00:00,2019-12-09 00:00:00,LABORABLE
12,9,2019,13,638,747,1385,2019-09-12 12:00:00,2019-12-09 00:00:00,LABORABLE
12,9,2019,14,570,625,1195,2019-09-12 13:00:00,2019-12-09 00:00:00,LABORABLE
12,9,2019,15,686,693,1379,2019-09-12 14:00:00,2019-12-09 00:00:00,LABORABLE
12,9,2019,16,633,638,1271,2019-09-12 15:00:00,2019-12-09 00:00:00,LABORABLE
12,9,2019,17,657,679,1336,2019-09-12 16:00:00,2019-12-09 00:00:00,LABORABLE
12,9,2019,18,711,765,1476,2019-09-12 17:00:00,2019-12-09 00:00:00,LABORABLE
12,9,2019,19,697,746,1443,2019-09-12 18:00:00,2019-12-09 00:00:00,LABORABLE
12,9,2019,20,728,774,1502,2019-09-12 19:00:00,2019-12-09 00:00:00,LABORABLE
12,9,2019,21,706,771,1477,2019-09-12 20:00:00,2019-12-09 00:00:00,LABORABLE
12,9,2019,22,560,639,1199,2019-09-12 21:00:00,2019-12-09 00:00:00,LABORABLE
12,9,2019,23,492,506,998,2019-09-12 22:00:00,2019-12-09 00:00:00,LABORABLE
12,9,2019,24,330,421,751,2019-09-12 23:00:00,2019-12-09 00:00:00,LABORABLE
13,9,2019,1,224,313,537,2019-09-13 00:00:00,2019-09-13 00:00:00,LABORABLE
13,9,2019,2,156,245,401,2019-09-13 01:00:00,2019-09-13 00:00:00,LABORABLE
13,9,2019,3,122,181,303,2019-09-13 02:00:00,2019-09-13 00:00:00,LABORABLE
13,9,2019,4,102,128,230,2019-09-13 03:00:00,2019-09-13 00:00:00,LABORABLE
13,9,2019,5,90,118,208,2019-09-13 04:00:00,2019-09-13 00:00:00,LABORABLE
13,9,2019,6,171,187,358,2019-09-13 05:00:00,2019-09-13 00:00:00,LABORABLE
13,9,2019,7,243,414,657,2019-09-13 06:00:00,2019-09-13 00:00:00,LABORABLE
13,9,2019,8,361,629,990,2019-09-13 07:00:00,2019-09-13 00:00:00,LABORABLE
13,9,2019,9,622,694,1316,2019-09-13 08:00:00,2019-09-13 00:00:00,LABORABLE
13,9,2019,10,618,704,1322,2019-09-13 09:00:00,2019-09-13 00:00:00,LABORABLE
13,9,2019,11,557,665,1222,2019-09-13 10:00:00,2019-09-13 00:00:00,LABORABLE
13,9,2019,12,613,691,1304,2019-09-13 11:00:00,2019-09-13 00:00:00,LABORABLE
13,9,2019,13,642,716,1358,2019-09-13 12:00:00,2019-09-13 00:00:00,LABORABLE
13,9,2019,14,670,756,1426,2019-09-13 13:00:00,2019-09-13 00:00:00,LABORABLE
13,9,2019,15,708,751,1459,2019-09-13 14:00:00,2019-09-13 00:00:00,LABORABLE
13,9,2019,16,613,711,1324,2019-09-13 15:00:00,2019-09-13 00:00:00,LABORABLE
13,9,2019,17,625,720,1345,2019-09-13 16:00:00,2019-09-13 00:00:00,LABORABLE
13,9,2019,18,659,794,1453,2019-09-13 17:00:00,2019-09-13 00:00:00,LABORABLE
13,9,2019,19,711,810,1521,2019-09-13 18:00:00,2019-09-13 00:00:00,LABORABLE
13,9,2019,20,683,818,1501,2019-09-13 19:00:00,2019-09-13 00:00:00,LABORABLE
13,9,2019,21,675,903,1578,2019-09-13 20:00:00,2019-09-13 00:00:00,LABORABLE
13,9,2019,22,630,759,1389,2019-09-13 21:00:00,2019-09-13 00:00:00,LABORABLE
13,9,2019,23,521,667,1188,2019-09-13 22:00:00,2019-09-13 00:00:00,LABORABLE
13,9,2019,24,429,516,945,2019-09-13 23:00:00,2019-09-13 00:00:00,LABORABLE
14,9,2019,1,339,486,825,2019-09-14 00:00:00,2019-09-14 00:00:00,LABORABLE
14,9,2019,2,275,395,670,2019-09-14 01:00:00,2019-09-14 00:00:00,LABORABLE
14,9,2019,3,197,332,529,2019-09-14 02:00:00,2019-09-14 00:00:00,LABORABLE
14,9,2019,4,161,252,413,2019-09-14 03:00:00,2019-09-14 00:00:00,LABORABLE
14,9,2019,5,126,233,359,2019-09-14 04:00:00,2019-09-14 00:00:00,LABORABLE
14,9,2019,6,142,230,372,2019-09-14 05:00:00,2019-09-14 00:00:00,LABORABLE
14,9,2019,7,213,289,502,2019-09-14 06:00:00,2019-09-14 00:00:00,LABORABLE
14,9,2019,8,249,258,507,2019-09-14 07:00:00,2019-09-14 00:00:00,LABORABLE
14,9,2019,9,352,354,706,2019-09-14 08:00:00,2019-09-14 00:00:00,LABORABLE
14,9,2019,10,463,475,938,2019-09-14 09:00:00,2019-09-14 00:00:00,LABORABLE
14,9,2019,11,560,629,1189,2019-09-14 10:00:00,2019-09-14 00:00:00,LABORABLE
14,9,2019,12,607,697,1304,2019-09-14 11:00:00,2019-09-14 00:00:00,LABORABLE
14,9,2019,13,659,750,1409,2019-09-14 12:00:00,2019-09-14 00:00:00,LABORABLE
14,9,2019,14,654,747,1401,2019-09-14 13:00:00,2019-09-14 00:00:00,LABORABLE
14,9,2019,15,629,758,1387,2019-09-14 14:00:00,2019-09-14 00:00:00,LABORABLE
14,9,2019,16,519,656,1175,2019-09-14 15:00:00,2019-09-14 00:00:00,LABORABLE
14,9,2019,17,482,764,1246,2019-09-14 16:00:00,2019-09-14 00:00:00,LABORABLE
14,9,2019,18,584,703,1287,2019-09-14 17:00:00,2019-09-14 00:00:00,LABORABLE
14,9,2019,19,593,781,1374,2019-09-14 18:00:00,2019-09-14 00:00:00,LABORABLE
14,9,2019,20,596,752,1348,2019-09-14 19:00:00,2019-09-14 00:00:00,LABORABLE
14,9,2019,21,631,717,1348,2019-09-14 20:00:00,2019-09-14 00:00:00,LABORABLE
14,9,2019,22,616,630,1246,2019-09-14 21:00:00,2019-09-14 00:00:00,LABORABLE
14,9,2019,23,508,579,1087,2019-09-14 22:00:00,2019-09-14 00:00:00,LABORABLE
14,9,2019,24,447,473,920,2019-09-14 23:00:00,2019-09-14 00:00:00,LABORABLE
15,9,2019,1,349,500,849,2019-09-15 00:00:00,2019-09-15 00:00:00,LABORABLE
15,9,2019,2,356,485,841,2019-09-15 01:00:00,2019-09-15 00:00:00,LABORABLE
15,9,2019,3,255,377,632,2019-09-15 02:00:00,2019-09-15 00:00:00,LABORABLE
15,9,2019,4,187,320,507,2019-09-15 03:00:00,2019-09-15 00:00:00,LABORABLE
15,9,2019,5,167,248,415,2019-09-15 04:00:00,2019-09-15 00:00:00,LABORABLE
15,9,2019,6,140,241,381,2019-09-15 05:00:00,2019-09-15 00:00:00,LABORABLE
15,9,2019,7,200,288,488,2019-09-15 06:00:00,2019-09-15 00:00:00,LABORABLE
15,9,2019,8,184,257,441,2019-09-15 07:00:00,2019-09-15 00:00:00,LABORABLE
15,9,2019,9,214,279,493,2019-09-15 08:00:00,2019-09-15 00:00:00,LABORABLE
15,9,2019,10,301,377,678,2019-09-15 09:00:00,2019-09-15 00:00:00,LABORABLE
15,9,2019,11,392,457,849,2019-09-15 10:00:00,2019-09-15 00:00:00,LABORABLE
15,9,2019,12,471,512,983,2019-09-15 11:00:00,2019-09-15 00:00:00,LABORABLE
15,9,2019,13,541,585,1126,2019-09-15 12:00:00,2019-09-15 00:00:00,LABORABLE
15,9,2019,14,627,699,1326,2019-09-15 13:00:00,2019-09-15 00:00:00,LABORABLE
15,9,2019,15,520,619,1139,2019-09-15 14:00:00,2019-09-15 00:00:00,LABORABLE
15,9,2019,16,444,581,1025,2019-09-15 15:00:00,2019-09-15 00:00:00,LABORABLE
15,9,2019,17,497,659,1156,2019-09-15 16:00:00,2019-09-15 00:00:00,LABORABLE
15,9,2019,18,536,689,1225,2019-09-15 17:00:00,2019-09-15 00:00:00,LABORABLE
15,9,2019,19,585,662,1247,2019-09-15 18:00:00,2019-09-15 00:00:00,LABORABLE
15,9,2019,20,551,724,1275,2019-09-15 19:00:00,2019-09-15 00:00:00,LABORABLE
15,9,2019,21,526,701,1227,2019-09-15 20:00:00,2019-09-15 00:00:00,LABORABLE
15,9,2019,22,518,627,1145,2019-09-15 21:00:00,2019-09-15 00:00:00,LABORABLE
15,9,2019,23,439,539,978,2019-09-15 22:00:00,2019-09-15 00:00:00,LABORABLE
15,9,2019,24,292,401,693,2019-09-15 23:00:00,2019-09-15 00:00:00,LABORABLE
16,9,2019,1,202,285,487,2019-09-16 00:00:00,2019-09-16 00:00:00,LABORABLE
16,9,2019,2,164,205,369,2019-09-16 01:00:00,2019-09-16 00:00:00,LABORABLE
16,9,2019,3,105,184,289,2019-09-16 02:00:00,2019-09-16 00:00:00,LABORABLE
16,9,2019,4,75,137,212,2019-09-16 03:00:00,2019-09-16 00:00:00,LABORABLE
16,9,2019,5,92,110,202,2019-09-16 04:00:00,2019-09-16 00:00:00,LABORABLE
16,9,2019,6,165,173,338,2019-09-16 05:00:00,2019-09-16 00:00:00,LABORABLE
16,9,2019,7,439,438,877,2019-09-16 06:00:00,2019-09-16 00:00:00,LABORABLE
16,9,2019,8,688,633,1321,2019-09-16 07:00:00,2019-09-16 00:00:00,LABORABLE
16,9,2019,9,664,679,1343,2019-09-16 08:00:00,2019-09-16 00:00:00,LABORABLE
16,9,2019,10,629,702,1331,2019-09-16 09:00:00,2019-09-16 00:00:00,LABORABLE
16,9,2019,11,478,638,1116,2019-09-16 10:00:00,2019-09-16 00:00:00,LABORABLE
16,9,2019,12,597,706,1303,2019-09-16 11:00:00,2019-09-16 00:00:00,LABORABLE
16,9,2019,13,640,763,1403,2019-09-16 12:00:00,2019-09-16 00:00:00,LABORABLE
16,9,2019,14,695,745,1440,2019-09-16 13:00:00,2019-09-16 00:00:00,LABORABLE
16,9,2019,15,726,681,1407,2019-09-16 14:00:00,2019-09-16 00:00:00,LABORABLE
16,9,2019,16,655,635,1290,2019-09-16 15:00:00,2019-09-16 00:00:00,LABORABLE
16,9,2019,17,615,726,1341,2019-09-16 16:00:00,2019-09-16 00:00:00,LABORABLE
16,9,2019,18,680,746,1426,2019-09-16 17:00:00,2019-09-16 00:00:00,LABORABLE
16,9,2019,19,695,787,1482,2019-09-16 18:00:00,2019-09-16 00:00:00,LABORABLE
16,9,2019,20,695,837,1532,2019-09-16 19:00:00,2019-09-16 00:00:00,LABORABLE
16,9,2019,21,647,784,1431,2019-09-16 20:00:00,2019-09-16 00:00:00,LABORABLE
16,9,2019,22,516,628,1144,2019-09-16 21:00:00,2019-09-16 00:00:00,LABORABLE
16,9,2019,23,356,464,820,2019-09-16 22:00:00,2019-09-16 00:00:00,LABORABLE
16,9,2019,24,246,311,557,2019-09-16 23:00:00,2019-09-16 00:00:00,LABORABLE
17,9,2019,1,180,274,454,2019-09-17 00:00:00,2019-09-17 00:00:00,LABORABLE
17,9,2019,2,110,194,304,2019-09-17 01:00:00,2019-09-17 00:00:00,LABORABLE
17,9,2019,3,72,144,216,2019-09-17 02:00:00,2019-09-17 00:00:00,LABORABLE
17,9,2019,4,71,108,179,2019-09-17 03:00:00,2019-09-17 00:00:00,LABORABLE
17,9,2019,5,65,111,176,2019-09-17 04:00:00,2019-09-17 00:00:00,LABORABLE
17,9,2019,6,170,144,314,2019-09-17 05:00:00,2019-09-17 00:00:00,LABORABLE
17,9,2019,7,400,431,831,2019-09-17 06:00:00,2019-09-17 00:00:00,LABORABLE
17,9,2019,8,679,667,1346,2019-09-17 07:00:00,2019-09-17 00:00:00,LABORABLE
17,9,2019,9,666,755,1421,2019-09-17 08:00:00,2019-09-17 00:00:00,LABORABLE
17,9,2019,10,621,718,1339,2019-09-17 09:00:00,2019-09-17 00:00:00,LABORABLE
17,9,2019,11,605,668,1273,2019-09-17 10:00:00,2019-09-17 00:00:00,LABORABLE
17,9,2019,12,611,726,1337,2019-09-17 11:00:00,2019-09-17 00:00:00,LABORABLE
17,9,2019,13,628,733,1361,2019-09-17 12:00:00,2019-09-17 00:00:00,LABORABLE
17,9,2019,14,662,739,1401,2019-09-17 13:00:00,2019-09-17 00:00:00,LABORABLE
17,9,2019,15,718,692,1410,2019-09-17 14:00:00,2019-09-17 00:00:00,LABORABLE
17,9,2019,16,601,683,1284,2019-09-17 15:00:00,2019-09-17 00:00:00,LABORABLE
17,9,2019,17,668,696,1364,2019-09-17 16:00:00,2019-09-17 00:00:00,LABORABLE
17,9,2019,18,625,780,1405,2019-09-17 17:00:00,2019-09-17 00:00:00,LABORABLE
17,9,2019,19,685,791,1476,2019-09-17 18:00:00,2019-09-17 00:00:00,LABORABLE
17,9,2019,20,708,751,1459,2019-09-17 19:00:00,2019-09-17 00:00:00,LABORABLE
17,9,2019,21,668,722,1390,2019-09-17 20:00:00,2019-09-17 00:00:00,LABORABLE
17,9,2019,22,547,557,1104,2019-09-17 21:00:00,2019-09-17 00:00:00,LABORABLE
17,9,2019,23,400,441,841,2019-09-17 22:00:00,2019-09-17 00:00:00,LABORABLE
17,9,2019,24,293,357,650,2019-09-17 23:00:00,2019-09-17 00:00:00,LABORABLE
18,9,2019,1,195,247,442,2019-09-18 00:00:00,2019-09-18 00:00:00,LABORABLE
18,9,2019,2,130,178,308,2019-09-18 01:00:00,2019-09-18 00:00:00,LABORABLE
18,9,2019,3,93,140,233,2019-09-18 02:00:00,2019-09-18 00:00:00,LABORABLE
18,9,2019,4,64,123,187,2019-09-18 03:00:00,2019-09-18 00:00:00,LABORABLE
18,9,2019,5,72,94,166,2019-09-18 04:00:00,2019-09-18 00:00:00,LABORABLE
18,9,2019,6,168,171,339,2019-09-18 05:00:00,2019-09-18 00:00:00,LABORABLE
18,9,2019,7,414,419,833,2019-09-18 06:00:00,2019-09-18 00:00:00,LABORABLE
18,9,2019,8,699,617,1316,2019-09-18 07:00:00,2019-09-18 00:00:00,LABORABLE
18,9,2019,9,672,770,1442,2019-09-18 08:00:00,2019-09-18 00:00:00,LABORABLE
18,9,2019,10,612,702,1314,2019-09-18 09:00:00,2019-09-18 00:00:00,LABORABLE
18,9,2019,11,583,625,1208,2019-09-18 10:00:00,2019-09-18 00:00:00,LABORABLE
18,9,2019,12,497,567,1064,2019-09-18 11:00:00,2019-09-18 00:00:00,LABORABLE
18,9,2019,13,641,714,1355,2019-09-18 12:00:00,2019-09-18 00:00:00,LABORABLE
18,9,2019,14,638,735,1373,2019-09-18 13:00:00,2019-09-18 00:00:00,LABORABLE
18,9,2019,15,694,711,1405,2019-09-18 14:00:00,2019-09-18 00:00:00,LABORABLE
18,9,2019,16,633,706,1339,2019-09-18 15:00:00,2019-09-18 00:00:00,LABORABLE
18,9,2019,17,622,702,1324,2019-09-18 16:00:00,2019-09-18 00:00:00,LABORABLE
18,9,2019,18,687,704,1391,2019-09-18 17:00:00,2019-09-18 00:00:00,LABORABLE
18,9,2019,19,697,735,1432,2019-09-18 18:00:00,2019-09-18 00:00:00,LABORABLE
18,9,2019,20,695,737,1432,2019-09-18 19:00:00,2019-09-18 00:00:00,LABORABLE
18,9,2019,21,682,780,1462,2019-09-18 20:00:00,2019-09-18 00:00:00,LABORABLE
18,9,2019,22,569,711,1280,2019-09-18 21:00:00,2019-09-18 00:00:00,LABORABLE
18,9,2019,23,425,475,900,2019-09-18 22:00:00,2019-09-18 00:00:00,LABORABLE
18,9,2019,24,311,361,672,2019-09-18 23:00:00,2019-09-18 00:00:00,LABORABLE
19,9,2019,1,216,285,501,2019-09-19 00:00:00,2019-09-19 00:00:00,LABORABLE
19,9,2019,2,126,185,311,2019-09-19 01:00:00,2019-09-19 00:00:00,LABORABLE
19,9,2019,3,105,160,265,2019-09-19 02:00:00,2019-09-19 00:00:00,LABORABLE
19,9,2019,4,87,122,209,2019-09-19 03:00:00,2019-09-19 00:00:00,LABORABLE
19,9,2019,5,96,96,192,2019-09-19 04:00:00,2019-09-19 00:00:00,LABORABLE
19,9,2019,6,175,180,355,2019-09-19 05:00:00,2019-09-19 00:00:00,LABORABLE
19,9,2019,7,257,450,707,2019-09-19 06:00:00,2019-09-19 00:00:00,LABORABLE
19,9,2019,8,401,637,1038,2019-09-19 07:00:00,2019-09-19 00:00:00,LABORABLE
19,9,2019,9,681,738,1419,2019-09-19 08:00:00,2019-09-19 00:00:00,LABORABLE
19,9,2019,10,612,690,1302,2019-09-19 09:00:00,2019-09-19 00:00:00,LABORABLE
19,9,2019,11,446,594,1040,2019-09-19 10:00:00,2019-09-19 00:00:00,LABORABLE
19,9,2019,12,579,654,1233,2019-09-19 11:00:00,2019-09-19 00:00:00,LABORABLE
19,9,2019,13,629,653,1282,2019-09-19 12:00:00,2019-09-19 00:00:00,LABORABLE
19,9,2019,14,633,746,1379,2019-09-19 13:00:00,2019-09-19 00:00:00,LABORABLE
19,9,2019,15,696,705,1401,2019-09-19 14:00:00,2019-09-19 00:00:00,LABORABLE
19,9,2019,16,644,664,1308,2019-09-19 15:00:00,2019-09-19 00:00:00,LABORABLE
19,9,2019,17,619,702,1321,2019-09-19 16:00:00,2019-09-19 00:00:00,LABORABLE
19,9,2019,18,716,701,1417,2019-09-19 17:00:00,2019-09-19 00:00:00,LABORABLE
19,9,2019,19,782,766,1548,2019-09-19 18:00:00,2019-09-19 00:00:00,LABORABLE
19,9,2019,20,682,816,1498,2019-09-19 19:00:00,2019-09-19 00:00:00,LABORABLE
19,9,2019,21,714,720,1434,2019-09-19 20:00:00,2019-09-19 00:00:00,LABORABLE
19,9,2019,22,654,638,1292,2019-09-19 21:00:00,2019-09-19 00:00:00,LABORABLE
19,9,2019,23,501,496,997,2019-09-19 22:00:00,2019-09-19 00:00:00,LABORABLE
19,9,2019,24,364,355,719,2019-09-19 23:00:00,2019-09-19 00:00:00,LABORABLE
20,9,2019,1,229,281,510,2019-09-20 00:00:00,2019-09-20 00:00:00,LABORABLE
20,9,2019,2,168,240,408,2019-09-20 01:00:00,2019-09-20 00:00:00,LABORABLE
20,9,2019,3,116,181,297,2019-09-20 02:00:00,2019-09-20 00:00:00,LABORABLE
20,9,2019,4,97,155,252,2019-09-20 03:00:00,2019-09-20 00:00:00,LABORABLE
20,9,2019,5,110,130,240,2019-09-20 04:00:00,2019-09-20 00:00:00,LABORABLE
20,9,2019,6,189,169,358,2019-09-20 05:00:00,2019-09-20 00:00:00,LABORABLE
20,9,2019,7,243,428,671,2019-09-20 06:00:00,2019-09-20 00:00:00,LABORABLE
20,9,2019,8,361,661,1022,2019-09-20 07:00:00,2019-09-20 00:00:00,LABORABLE
20,9,2019,9,702,670,1372,2019-09-20 08:00:00,2019-09-20 00:00:00,LABORABLE
20,9,2019,10,599,703,1302,2019-09-20 09:00:00,2019-09-20 00:00:00,LABORABLE
20,9,2019,11,590,714,1304,2019-09-20 10:00:00,2019-09-20 00:00:00,LABORABLE
20,9,2019,12,529,678,1207,2019-09-20 11:00:00,2019-09-20 00:00:00,LABORABLE
20,9,2019,13,624,714,1338,2019-09-20 12:00:00,2019-09-20 00:00:00,LABORABLE
20,9,2019,14,664,752,1416,2019-09-20 13:00:00,2019-09-20 00:00:00,LABORABLE
20,9,2019,15,693,720,1413,2019-09-20 14:00:00,2019-09-20 00:00:00,LABORABLE
20,9,2019,16,675,701,1376,2019-09-20 15:00:00,2019-09-20 00:00:00,LABORABLE
20,9,2019,17,652,729,1381,2019-09-20 16:00:00,2019-09-20 00:00:00,LABORABLE
20,9,2019,18,708,763,1471,2019-09-20 17:00:00,2019-09-20 00:00:00,LABORABLE
20,9,2019,19,672,765,1437,2019-09-20 18:00:00,2019-09-20 00:00:00,LABORABLE
20,9,2019,20,699,849,1548,2019-09-20 19:00:00,2019-09-20 00:00:00,LABORABLE
20,9,2019,21,736,788,1524,2019-09-20 20:00:00,2019-09-20 00:00:00,LABORABLE
20,9,2019,22,618,753,1371,2019-09-20 21:00:00,2019-09-20 00:00:00,LABORABLE
20,9,2019,23,569,638,1207,2019-09-20 22:00:00,2019-09-20 00:00:00,LABORABLE
20,9,2019,24,454,545,999,2019-09-20 23:00:00,2019-09-20 00:00:00,LABORABLE
21,9,2019,1,720,526,1246,2019-09-21 00:00:00,2019-09-21 00:00:00,LABORABLE
21,9,2019,2,319,547,866,2019-09-21 01:00:00,2019-09-21 00:00:00,LABORABLE
21,9,2019,3,250,365,615,2019-09-21 02:00:00,2019-09-21 00:00:00,LABORABLE
21,9,2019,4,161,240,401,2019-09-21 03:00:00,2019-09-21 00:00:00,LABORABLE
21,9,2019,5,154,211,365,2019-09-21 04:00:00,2019-09-21 00:00:00,LABORABLE
21,9,2019,6,148,186,334,2019-09-21 05:00:00,2019-09-21 00:00:00,LABORABLE
21,9,2019,7,206,298,504,2019-09-21 06:00:00,2019-09-21 00:00:00,LABORABLE
21,9,2019,8,296,291,587,2019-09-21 07:00:00,2019-09-21 00:00:00,LABORABLE
21,9,2019,9,376,412,788,2019-09-21 08:00:00,2019-09-21 00:00:00,LABORABLE
21,9,2019,10,463,493,956,2019-09-21 09:00:00,2019-09-21 00:00:00,LABORABLE
21,9,2019,11,531,614,1145,2019-09-21 10:00:00,2019-09-21 00:00:00,LABORABLE
21,9,2019,12,683,765,1448,2019-09-21 11:00:00,2019-09-21 00:00:00,LABORABLE
21,9,2019,13,659,676,1335,2019-09-21 12:00:00,2019-09-21 00:00:00,LABORABLE
21,9,2019,14,689,857,1546,2019-09-21 13:00:00,2019-09-21 00:00:00,LABORABLE
21,9,2019,15,668,842,1510,2019-09-21 14:00:00,2019-09-21 00:00:00,LABORABLE
21,9,2019,16,567,745,1312,2019-09-21 15:00:00,2019-09-21 00:00:00,LABORABLE
21,9,2019,17,518,706,1224,2019-09-21 16:00:00,2019-09-21 00:00:00,LABORABLE
21,9,2019,18,628,735,1363,2019-09-21 17:00:00,2019-09-21 00:00:00,LABORABLE
21,9,2019,19,642,791,1433,2019-09-21 18:00:00,2019-09-21 00:00:00,LABORABLE
21,9,2019,20,615,781,1396,2019-09-21 19:00:00,2019-09-21 00:00:00,LABORABLE
21,9,2019,21,566,725,1291,2019-09-21 20:00:00,2019-09-21 00:00:00,LABORABLE
21,9,2019,22,560,730,1290,2019-09-21 21:00:00,2019-09-21 00:00:00,LABORABLE
21,9,2019,23,510,622,1132,2019-09-21 22:00:00,2019-09-21 00:00:00,LABORABLE
21,9,2019,24,430,540,970,2019-09-21 23:00:00,2019-09-21 00:00:00,LABORABLE
22,9,2019,1,401,482,883,2019-09-22 00:00:00,2019-09-22 00:00:00,LABORABLE
22,9,2019,2,348,429,777,2019-09-22 01:00:00,2019-09-22 00:00:00,LABORABLE
22,9,2019,3,241,371,612,2019-09-22 02:00:00,2019-09-22 00:00:00,LABORABLE
22,9,2019,4,176,307,483,2019-09-22 03:00:00,2019-09-22 00:00:00,LABORABLE
22,9,2019,5,156,269,425,2019-09-22 04:00:00,2019-09-22 00:00:00,LABORABLE
22,9,2019,6,174,242,416,2019-09-22 05:00:00,2019-09-22 00:00:00,LABORABLE
22,9,2019,7,188,289,477,2019-09-22 06:00:00,2019-09-22 00:00:00,LABORABLE
22,9,2019,8,197,261,458,2019-09-22 07:00:00,2019-09-22 00:00:00,LABORABLE
22,9,2019,9,251,286,537,2019-09-22 08:00:00,2019-09-22 00:00:00,LABORABLE
22,9,2019,10,339,368,707,2019-09-22 09:00:00,2019-09-22 00:00:00,LABORABLE
22,9,2019,11,429,497,926,2019-09-22 10:00:00,2019-09-22 00:00:00,LABORABLE
22,9,2019,12,515,582,1097,2019-09-22 11:00:00,2019-09-22 00:00:00,LABORABLE
22,9,2019,13,603,649,1252,2019-09-22 12:00:00,2019-09-22 00:00:00,LABORABLE
22,9,2019,14,616,735,1351,2019-09-22 13:00:00,2019-09-22 00:00:00,LABORABLE
22,9,2019,15,513,673,1186,2019-09-22 14:00:00,2019-09-22 00:00:00,LABORABLE
22,9,2019,16,466,609,1075,2019-09-22 15:00:00,2019-09-22 00:00:00,LABORABLE
22,9,2019,17,504,642,1146,2019-09-22 16:00:00,2019-09-22 00:00:00,LABORABLE
22,9,2019,18,555,691,1246,2019-09-22 17:00:00,2019-09-22 00:00:00,LABORABLE
22,9,2019,19,566,726,1292,2019-09-22 18:00:00,2019-09-22 00:00:00,LABORABLE
22,9,2019,20,557,683,1240,2019-09-22 19:00:00,2019-09-22 00:00:00,LABORABLE
22,9,2019,21,607,679,1286,2019-09-22 20:00:00,2019-09-22 00:00:00,LABORABLE
22,9,2019,22,512,620,1132,2019-09-22 21:00:00,2019-09-22 00:00:00,LABORABLE
22,9,2019,23,409,507,916,2019-09-22 22:00:00,2019-09-22 00:00:00,LABORABLE
22,9,2019,24,293,376,669,2019-09-22 23:00:00,2019-09-22 00:00:00,LABORABLE
23,9,2019,1,194,262,456,2019-09-23 00:00:00,2019-09-23 00:00:00,LABORABLE
23,9,2019,2,146,207,353,2019-09-23 01:00:00,2019-09-23 00:00:00,LABORABLE
23,9,2019,3,84,170,254,2019-09-23 02:00:00,2019-09-23 00:00:00,LABORABLE
23,9,2019,4,90,99,189,2019-09-23 03:00:00,2019-09-23 00:00:00,LABORABLE
23,9,2019,5,83,112,195,2019-09-23 04:00:00,2019-09-23 00:00:00,LABORABLE
23,9,2019,6,118,184,302,2019-09-23 05:00:00,2019-09-23 00:00:00,LABORABLE
23,9,2019,7,435,447,882,2019-09-23 06:00:00,2019-09-23 00:00:00,LABORABLE
23,9,2019,8,692,662,1354,2019-09-23 07:00:00,2019-09-23 00:00:00,LABORABLE
23,9,2019,9,702,729,1431,2019-09-23 08:00:00,2019-09-23 00:00:00,LABORABLE
23,9,2019,10,594,754,1348,2019-09-23 09:00:00,2019-09-23 00:00:00,LABORABLE
23,9,2019,11,561,662,1223,2019-09-23 10:00:00,2019-09-23 00:00:00,LABORABLE
23,9,2019,12,567,691,1258,2019-09-23 11:00:00,2019-09-23 00:00:00,LABORABLE
23,9,2019,13,595,715,1310,2019-09-23 12:00:00,2019-09-23 00:00:00,LABORABLE
23,9,2019,14,691,758,1449,2019-09-23 13:00:00,2019-09-23 00:00:00,LABORABLE
23,9,2019,15,663,703,1366,2019-09-23 14:00:00,2019-09-23 00:00:00,LABORABLE
23,9,2019,16,633,672,1305,2019-09-23 15:00:00,2019-09-23 00:00:00,LABORABLE
23,9,2019,17,643,669,1312,2019-09-23 16:00:00,2019-09-23 00:00:00,LABORABLE
23,9,2019,18,678,736,1414,2019-09-23 17:00:00,2019-09-23 00:00:00,LABORABLE
23,9,2019,19,710,803,1513,2019-09-23 18:00:00,2019-09-23 00:00:00,LABORABLE
23,9,2019,20,640,783,1423,2019-09-23 19:00:00,2019-09-23 00:00:00,LABORABLE
23,9,2019,21,685,768,1453,2019-09-23 20:00:00,2019-09-23 00:00:00,LABORABLE
23,9,2019,22,509,640,1149,2019-09-23 21:00:00,2019-09-23 00:00:00,LABORABLE
23,9,2019,23,348,448,796,2019-09-23 22:00:00,2019-09-23 00:00:00,LABORABLE
23,9,2019,24,227,323,550,2019-09-23 23:00:00,2019-09-23 00:00:00,LABORABLE
24,9,2019,1,176,224,400,2019-09-24 00:00:00,2019-09-24 00:00:00,LABORABLE
24,9,2019,2,112,174,286,2019-09-24 01:00:00,2019-09-24 00:00:00,LABORABLE
24,9,2019,3,74,153,227,2019-09-24 02:00:00,2019-09-24 00:00:00,LABORABLE
24,9,2019,4,62,108,170,2019-09-24 03:00:00,2019-09-24 00:00:00,LABORABLE
24,9,2019,5,92,85,177,2019-09-24 04:00:00,2019-09-24 00:00:00,LABORABLE
24,9,2019,6,118,164,282,2019-09-24 05:00:00,2019-09-24 00:00:00,LABORABLE
24,9,2019,7,417,453,870,2019-09-24 06:00:00,2019-09-24 00:00:00,LABORABLE
24,9,2019,8,712,712,1424,2019-09-24 07:00:00,2019-09-24 00:00:00,LABORABLE
24,9,2019,9,679,725,1404,2019-09-24 08:00:00,2019-09-24 00:00:00,LABORABLE
24,9,2019,10,598,739,1337,2019-09-24 09:00:00,2019-09-24 00:00:00,LABORABLE
24,9,2019,11,547,622,1169,2019-09-24 10:00:00,2019-09-24 00:00:00,LABORABLE
24,9,2019,12,589,709,1298,2019-09-24 11:00:00,2019-09-24 00:00:00,LABORABLE
24,9,2019,13,628,790,1418,2019-09-24 12:00:00,2019-09-24 00:00:00,LABORABLE
24,9,2019,14,622,785,1407,2019-09-24 13:00:00,2019-09-24 00:00:00,LABORABLE
24,9,2019,15,683,686,1369,2019-09-24 14:00:00,2019-09-24 00:00:00,LABORABLE
24,9,2019,16,637,674,1311,2019-09-24 15:00:00,2019-09-24 00:00:00,LABORABLE
24,9,2019,17,634,634,1268,2019-09-24 16:00:00,2019-09-24 00:00:00,LABORABLE
24,9,2019,18,644,750,1394,2019-09-24 17:00:00,2019-09-24 00:00:00,LABORABLE
24,9,2019,19,642,789,1431,2019-09-24 18:00:00,2019-09-24 00:00:00,LABORABLE
24,9,2019,20,659,766,1425,2019-09-24 19:00:00,2019-09-24 00:00:00,LABORABLE
24,9,2019,21,646,748,1394,2019-09-24 20:00:00,2019-09-24 00:00:00,LABORABLE
24,9,2019,22,535,642,1177,2019-09-24 21:00:00,2019-09-24 00:00:00,LABORABLE
24,9,2019,23,379,461,840,2019-09-24 22:00:00,2019-09-24 00:00:00,LABORABLE
24,9,2019,24,261,342,603,2019-09-24 23:00:00,2019-09-24 00:00:00,LABORABLE
25,9,2019,1,244,295,539,2019-09-25 00:00:00,2019-09-25 00:00:00,LABORABLE
25,9,2019,2,131,179,310,2019-09-25 01:00:00,2019-09-25 00:00:00,LABORABLE
25,9,2019,3,86,160,246,2019-09-25 02:00:00,2019-09-25 00:00:00,LABORABLE
25,9,2019,4,75,113,188,2019-09-25 03:00:00,2019-09-25 00:00:00,LABORABLE
25,9,2019,5,91,107,198,2019-09-25 04:00:00,2019-09-25 00:00:00,LABORABLE
25,9,2019,6,164,181,345,2019-09-25 05:00:00,2019-09-25 00:00:00,LABORABLE
25,9,2019,7,448,419,867,2019-09-25 06:00:00,2019-09-25 00:00:00,LABORABLE
25,9,2019,8,668,695,1363,2019-09-25 07:00:00,2019-09-25 00:00:00,LABORABLE
25,9,2019,9,681,711,1392,2019-09-25 08:00:00,2019-09-25 00:00:00,LABORABLE
25,9,2019,10,623,740,1363,2019-09-25 09:00:00,2019-09-25 00:00:00,LABORABLE
25,9,2019,11,612,828,1440,2019-09-25 10:00:00,2019-09-25 00:00:00,LABORABLE
25,9,2019,12,520,675,1195,2019-09-25 11:00:00,2019-09-25 00:00:00,LABORABLE
25,9,2019,13,652,731,1383,2019-09-25 12:00:00,2019-09-25 00:00:00,LABORABLE
25,9,2019,14,693,709,1402,2019-09-25 13:00:00,2019-09-25 00:00:00,LABORABLE
25,9,2019,15,711,690,1401,2019-09-25 14:00:00,2019-09-25 00:00:00,LABORABLE
25,9,2019,16,622,699,1321,2019-09-25 15:00:00,2019-09-25 00:00:00,LABORABLE
25,9,2019,17,641,678,1319,2019-09-25 16:00:00,2019-09-25 00:00:00,LABORABLE
25,9,2019,18,679,732,1411,2019-09-25 17:00:00,2019-09-25 00:00:00,LABORABLE
25,9,2019,19,709,762,1471,2019-09-25 18:00:00,2019-09-25 00:00:00,LABORABLE
25,9,2019,20,694,795,1489,2019-09-25 19:00:00,2019-09-25 00:00:00,LABORABLE
25,9,2019,21,690,748,1438,2019-09-25 20:00:00,2019-09-25 00:00:00,LABORABLE
25,9,2019,22,659,621,1280,2019-09-25 21:00:00,2019-09-25 00:00:00,LABORABLE
25,9,2019,23,534,474,1008,2019-09-25 22:00:00,2019-09-25 00:00:00,LABORABLE
25,9,2019,24,402,339,741,2019-09-25 23:00:00,2019-09-25 00:00:00,LABORABLE
26,9,2019,1,283,283,566,2019-09-26 00:00:00,2019-09-26 00:00:00,LABORABLE
26,9,2019,2,223,198,421,2019-09-26 01:00:00,2019-09-26 00:00:00,LABORABLE
26,9,2019,3,156,163,319,2019-09-26 02:00:00,2019-09-26 00:00:00,LABORABLE
26,9,2019,4,113,129,242,2019-09-26 03:00:00,2019-09-26 00:00:00,LABORABLE
26,9,2019,5,107,90,197,2019-09-26 04:00:00,2019-09-26 00:00:00,LABORABLE
26,9,2019,6,121,171,292,2019-09-26 05:00:00,2019-09-26 00:00:00,LABORABLE
26,9,2019,7,257,408,665,2019-09-26 06:00:00,2019-09-26 00:00:00,LABORABLE
26,9,2019,8,401,661,1062,2019-09-26 07:00:00,2019-09-26 00:00:00,LABORABLE
26,9,2019,9,473,700,1173,2019-09-26 08:00:00,2019-09-26 00:00:00,LABORABLE
26,9,2019,10,526,675,1201,2019-09-26 09:00:00,2019-09-26 00:00:00,LABORABLE
26,9,2019,11,572,710,1282,2019-09-26 10:00:00,2019-09-26 00:00:00,LABORABLE
26,9,2019,12,627,737,1364,2019-09-26 11:00:00,2019-09-26 00:00:00,LABORABLE
26,9,2019,13,640,711,1351,2019-09-26 12:00:00,2019-09-26 00:00:00,LABORABLE
26,9,2019,14,685,767,1452,2019-09-26 13:00:00,2019-09-26 00:00:00,LABORABLE
26,9,2019,15,694,687,1381,2019-09-26 14:00:00,2019-09-26 00:00:00,LABORABLE
26,9,2019,16,575,670,1245,2019-09-26 15:00:00,2019-09-26 00:00:00,LABORABLE
26,9,2019,17,552,711,1263,2019-09-26 16:00:00,2019-09-26 00:00:00,LABORABLE
26,9,2019,18,627,742,1369,2019-09-26 17:00:00,2019-09-26 00:00:00,LABORABLE
26,9,2019,19,671,715,1386,2019-09-26 18:00:00,2019-09-26 00:00:00,LABORABLE
26,9,2019,20,668,752,1420,2019-09-26 19:00:00,2019-09-26 00:00:00,LABORABLE
26,9,2019,21,677,757,1434,2019-09-26 20:00:00,2019-09-26 00:00:00,LABORABLE
26,9,2019,22,493,659,1152,2019-09-26 21:00:00,2019-09-26 00:00:00,LABORABLE
26,9,2019,23,575,482,1057,2019-09-26 22:00:00,2019-09-26 00:00:00,LABORABLE
26,9,2019,24,428,375,803,2019-09-26 23:00:00,2019-09-26 00:00:00,LABORABLE
27,9,2019,1,335,335,670,2019-09-27 00:00:00,2019-09-27 00:00:00,LABORABLE
27,9,2019,2,245,219,464,2019-09-27 01:00:00,2019-09-27 00:00:00,LABORABLE
27,9,2019,3,191,171,362,2019-09-27 02:00:00,2019-09-27 00:00:00,LABORABLE
27,9,2019,4,129,138,267,2019-09-27 03:00:00,2019-09-27 00:00:00,LABORABLE
27,9,2019,5,121,140,261,2019-09-27 04:00:00,2019-09-27 00:00:00,LABORABLE
27,9,2019,6,139,192,331,2019-09-27 05:00:00,2019-09-27 00:00:00,LABORABLE
27,9,2019,7,243,442,685,2019-09-27 06:00:00,2019-09-27 00:00:00,LABORABLE
27,9,2019,8,191,673,864,2019-09-27 07:00:00,2019-09-27 00:00:00,LABORABLE
27,9,2019,9,143,649,792,2019-09-27 08:00:00,2019-09-27 00:00:00,LABORABLE
27,9,2019,10,457,724,1181,2019-09-27 09:00:00,2019-09-27 00:00:00,LABORABLE
27,9,2019,11,485,693,1178,2019-09-27 10:00:00,2019-09-27 00:00:00,LABORABLE
27,9,2019,12,563,761,1324,2019-09-27 11:00:00,2019-09-27 00:00:00,LABORABLE
27,9,2019,13,601,695,1296,2019-09-27 12:00:00,2019-09-27 00:00:00,LABORABLE
27,9,2019,14,646,771,1417,2019-09-27 13:00:00,2019-09-27 00:00:00,LABORABLE
27,9,2019,15,650,702,1352,2019-09-27 14:00:00,2019-09-27 00:00:00,LABORABLE
27,9,2019,16,554,692,1246,2019-09-27 15:00:00,2019-09-27 00:00:00,LABORABLE
27,9,2019,17,553,713,1266,2019-09-27 16:00:00,2019-09-27 00:00:00,LABORABLE
27,9,2019,18,605,818,1423,2019-09-27 17:00:00,2019-09-27 00:00:00,LABORABLE
27,9,2019,19,664,758,1422,2019-09-27 18:00:00,2019-09-27 00:00:00,LABORABLE
27,9,2019,20,660,771,1431,2019-09-27 19:00:00,2019-09-27 00:00:00,LABORABLE
27,9,2019,21,680,818,1498,2019-09-27 20:00:00,2019-09-27 00:00:00,LABORABLE
27,9,2019,22,635,735,1370,2019-09-27 21:00:00,2019-09-27 00:00:00,LABORABLE
27,9,2019,23,538,632,1170,2019-09-27 22:00:00,2019-09-27 00:00:00,LABORABLE
27,9,2019,24,420,517,937,2019-09-27 23:00:00,2019-09-27 00:00:00,LABORABLE
28,9,2019,1,106,510,616,2019-09-28 00:00:00,2019-09-28 00:00:00,LABORABLE
28,9,2019,2,92,363,455,2019-09-28 01:00:00,2019-09-28 00:00:00,LABORABLE
28,9,2019,3,69,275,344,2019-09-28 02:00:00,2019-09-28 00:00:00,LABORABLE
28,9,2019,4,52,267,319,2019-09-28 03:00:00,2019-09-28 00:00:00,LABORABLE
28,9,2019,5,51,247,298,2019-09-28 04:00:00,2019-09-28 00:00:00,LABORABLE
28,9,2019,6,46,244,290,2019-09-28 05:00:00,2019-09-28 00:00:00,LABORABLE
28,9,2019,7,78,295,373,2019-09-28 06:00:00,2019-09-28 00:00:00,LABORABLE
28,9,2019,8,83,318,401,2019-09-28 07:00:00,2019-09-28 00:00:00,LABORABLE
28,9,2019,9,100,414,514,2019-09-28 08:00:00,2019-09-28 00:00:00,LABORABLE
28,9,2019,10,119,503,622,2019-09-28 09:00:00,2019-09-28 00:00:00,LABORABLE
28,9,2019,11,124,640,764,2019-09-28 10:00:00,2019-09-28 00:00:00,LABORABLE
28,9,2019,12,144,678,822,2019-09-28 11:00:00,2019-09-28 00:00:00,LABORABLE
28,9,2019,13,154,760,914,2019-09-28 12:00:00,2019-09-28 00:00:00,LABORABLE
28,9,2019,14,149,792,941,2019-09-28 13:00:00,2019-09-28 00:00:00,LABORABLE
28,9,2019,15,136,830,966,2019-09-28 14:00:00,2019-09-28 00:00:00,LABORABLE
28,9,2019,16,139,733,872,2019-09-28 15:00:00,2019-09-28 00:00:00,LABORABLE
28,9,2019,17,136,696,832,2019-09-28 16:00:00,2019-09-28 00:00:00,LABORABLE
28,9,2019,18,106,748,854,2019-09-28 17:00:00,2019-09-28 00:00:00,LABORABLE
28,9,2019,19,128,730,858,2019-09-28 18:00:00,2019-09-28 00:00:00,LABORABLE
28,9,2019,20,122,807,929,2019-09-28 19:00:00,2019-09-28 00:00:00,LABORABLE
28,9,2019,21,106,761,867,2019-09-28 20:00:00,2019-09-28 00:00:00,LABORABLE
28,9,2019,22,125,665,790,2019-09-28 21:00:00,2019-09-28 00:00:00,LABORABLE
28,9,2019,23,115,548,663,2019-09-28 22:00:00,2019-09-28 00:00:00,LABORABLE
28,9,2019,24,122,578,700,2019-09-28 23:00:00,2019-09-28 00:00:00,LABORABLE
29,9,2019,1,126,477,603,2019-09-29 00:00:00,2019-09-29 00:00:00,LABORABLE
29,9,2019,2,97,487,584,2019-09-29 01:00:00,2019-09-29 00:00:00,LABORABLE
29,9,2019,3,79,395,474,2019-09-29 02:00:00,2019-09-29 00:00:00,LABORABLE
29,9,2019,4,61,322,383,2019-09-29 03:00:00,2019-09-29 00:00:00,LABORABLE
29,9,2019,5,56,282,338,2019-09-29 04:00:00,2019-09-29 00:00:00,LABORABLE
29,9,2019,6,58,333,391,2019-09-29 05:00:00,2019-09-29 00:00:00,LABORABLE
29,9,2019,7,71,310,381,2019-09-29 06:00:00,2019-09-29 00:00:00,LABORABLE
29,9,2019,8,65,253,318,2019-09-29 07:00:00,2019-09-29 00:00:00,LABORABLE
29,9,2019,9,71,285,356,2019-09-29 08:00:00,2019-09-29 00:00:00,LABORABLE
29,9,2019,10,80,436,516,2019-09-29 09:00:00,2019-09-29 00:00:00,LABORABLE
29,9,2019,11,94,517,611,2019-09-29 10:00:00,2019-09-29 00:00:00,LABORABLE
29,9,2019,12,109,581,690,2019-09-29 11:00:00,2019-09-29 00:00:00,LABORABLE
29,9,2019,13,127,672,799,2019-09-29 12:00:00,2019-09-29 00:00:00,LABORABLE
29,9,2019,14,536,746,1282,2019-09-29 13:00:00,2019-09-29 00:00:00,LABORABLE
29,9,2019,15,589,741,1330,2019-09-29 14:00:00,2019-09-29 00:00:00,LABORABLE
29,9,2019,16,517,647,1164,2019-09-29 15:00:00,2019-09-29 00:00:00,LABORABLE
29,9,2019,17,497,701,1198,2019-09-29 16:00:00,2019-09-29 00:00:00,LABORABLE
29,9,2019,18,556,735,1291,2019-09-29 17:00:00,2019-09-29 00:00:00,LABORABLE
29,9,2019,19,537,702,1239,2019-09-29 18:00:00,2019-09-29 00:00:00,LABORABLE
29,9,2019,20,585,697,1282,2019-09-29 19:00:00,2019-09-29 00:00:00,LABORABLE
29,9,2019,21,583,707,1290,2019-09-29 20:00:00,2019-09-29 00:00:00,LABORABLE
29,9,2019,22,597,706,1303,2019-09-29 21:00:00,2019-09-29 00:00:00,LABORABLE
29,9,2019,23,459,537,996,2019-09-29 22:00:00,2019-09-29 00:00:00,LABORABLE
29,9,2019,24,314,395,709,2019-09-29 23:00:00,2019-09-29 00:00:00,LABORABLE
30,9,2019,1,224,316,540,2019-09-30 00:00:00,2019-09-30 00:00:00,LABORABLE
30,9,2019,2,145,222,367,2019-09-30 01:00:00,2019-09-30 00:00:00,LABORABLE
30,9,2019,3,84,185,269,2019-09-30 02:00:00,2019-09-30 00:00:00,LABORABLE
30,9,2019,4,90,147,237,2019-09-30 03:00:00,2019-09-30 00:00:00,LABORABLE
30,9,2019,5,91,108,199,2019-09-30 04:00:00,2019-09-30 00:00:00,LABORABLE
30,9,2019,6,175,166,341,2019-09-30 05:00:00,2019-09-30 00:00:00,LABORABLE
30,9,2019,7,294,449,743,2019-09-30 06:00:00,2019-09-30 00:00:00,LABORABLE
30,9,2019,8,670,654,1324,2019-09-30 07:00:00,2019-09-30 00:00:00,LABORABLE
30,9,2019,9,673,659,1332,2019-09-30 08:00:00,2019-09-30 00:00:00,LABORABLE
30,9,2019,10,639,710,1349,2019-09-30 09:00:00,2019-09-30 00:00:00,LABORABLE
30,9,2019,11,550,628,1178,2019-09-30 10:00:00,2019-09-30 00:00:00,LABORABLE
30,9,2019,12,578,666,1244,2019-09-30 11:00:00,2019-09-30 00:00:00,LABORABLE
30,9,2019,13,461,538,999,2019-09-30 12:00:00,2019-09-30 00:00:00,LABORABLE
30,9,2019,14,692,699,1391,2019-09-30 13:00:00,2019-09-30 00:00:00,LABORABLE
30,9,2019,15,691,733,1424,2019-09-30 14:00:00,2019-09-30 00:00:00,LABORABLE
30,9,2019,16,663,717,1380,2019-09-30 15:00:00,2019-09-30 00:00:00,LABORABLE
30,9,2019,17,623,703,1326,2019-09-30 16:00:00,2019-09-30 00:00:00,LABORABLE
30,9,2019,18,659,732,1391,2019-09-30 17:00:00,2019-09-30 00:00:00,LABORABLE
30,9,2019,19,741,763,1504,2019-09-30 18:00:00,2019-09-30 00:00:00,LABORABLE
30,9,2019,20,675,800,1475,2019-09-30 19:00:00,2019-09-30 00:00:00,LABORABLE
30,9,2019,21,690,783,1473,2019-09-30 20:00:00,2019-09-30 00:00:00,LABORABLE
30,9,2019,22,570,650,1220,2019-09-30 21:00:00,2019-09-30 00:00:00,LABORABLE
30,9,2019,23,428,483,911,2019-09-30 22:00:00,2019-09-30 00:00:00,LABORABLE
30,9,2019,24,266,349,615,2019-09-30 23:00:00,2019-09-30 00:00:00,LABORABLE
1,10,2019,1,159,255,414,2019-10-01 00:00:00,2019-01-10 00:00:00,LABORABLE
1,10,2019,2,132,188,320,2019-10-01 01:00:00,2019-01-10 00:00:00,LABORABLE
1,10,2019,3,57,131,188,2019-10-01 02:00:00,2019-01-10 00:00:00,LABORABLE
1,10,2019,4,83,124,207,2019-10-01 03:00:00,2019-01-10 00:00:00,LABORABLE
1,10,2019,5,83,106,189,2019-10-01 04:00:00,2019-01-10 00:00:00,LABORABLE
1,10,2019,6,117,163,280,2019-10-01 05:00:00,2019-01-10 00:00:00,LABORABLE
1,10,2019,7,486,451,937,2019-10-01 06:00:00,2019-01-10 00:00:00,LABORABLE
1,10,2019,8,407,632,1039,2019-10-01 07:00:00,2019-01-10 00:00:00,LABORABLE
1,10,2019,9,671,766,1437,2019-10-01 08:00:00,2019-01-10 00:00:00,LABORABLE
1,10,2019,10,653,800,1453,2019-10-01 09:00:00,2019-01-10 00:00:00,LABORABLE
1,10,2019,11,581,729,1310,2019-10-01 10:00:00,2019-01-10 00:00:00,LABORABLE
1,10,2019,12,593,676,1269,2019-10-01 11:00:00,2019-01-10 00:00:00,LABORABLE
1,10,2019,13,656,762,1418,2019-10-01 12:00:00,2019-01-10 00:00:00,LABORABLE
1,10,2019,14,611,754,1365,2019-10-01 13:00:00,2019-01-10 00:00:00,LABORABLE
1,10,2019,15,652,706,1358,2019-10-01 14:00:00,2019-01-10 00:00:00,LABORABLE
1,10,2019,16,667,687,1354,2019-10-01 15:00:00,2019-01-10 00:00:00,LABORABLE
1,10,2019,17,665,690,1355,2019-10-01 16:00:00,2019-01-10 00:00:00,LABORABLE
1,10,2019,18,716,773,1489,2019-10-01 17:00:00,2019-01-10 00:00:00,LABORABLE
1,10,2019,19,722,750,1472,2019-10-01 18:00:00,2019-01-10 00:00:00,LABORABLE
1,10,2019,20,640,715,1355,2019-10-01 19:00:00,2019-01-10 00:00:00,LABORABLE
1,10,2019,21,622,774,1396,2019-10-01 20:00:00,2019-01-10 00:00:00,LABORABLE
1,10,2019,22,605,718,1323,2019-10-01 21:00:00,2019-01-10 00:00:00,LABORABLE
1,10,2019,23,435,483,918,2019-10-01 22:00:00,2019-01-10 00:00:00,LABORABLE
1,10,2019,24,261,350,611,2019-10-01 23:00:00,2019-01-10 00:00:00,LABORABLE
2,10,2019,1,191,297,488,2019-10-02 00:00:00,2019-02-10 00:00:00,LABORABLE
2,10,2019,2,116,181,297,2019-10-02 01:00:00,2019-02-10 00:00:00,LABORABLE
2,10,2019,3,85,137,222,2019-10-02 02:00:00,2019-02-10 00:00:00,LABORABLE
2,10,2019,4,61,112,173,2019-10-02 03:00:00,2019-02-10 00:00:00,LABORABLE
2,10,2019,5,79,96,175,2019-10-02 04:00:00,2019-02-10 00:00:00,LABORABLE
2,10,2019,6,173,178,351,2019-10-02 05:00:00,2019-02-10 00:00:00,LABORABLE
2,10,2019,7,444,413,857,2019-10-02 06:00:00,2019-02-10 00:00:00,LABORABLE
2,10,2019,8,706,673,1379,2019-10-02 07:00:00,2019-02-10 00:00:00,LABORABLE
2,10,2019,9,671,739,1410,2019-10-02 08:00:00,2019-02-10 00:00:00,LABORABLE
2,10,2019,10,648,702,1350,2019-10-02 09:00:00,2019-02-10 00:00:00,LABORABLE
2,10,2019,11,556,689,1245,2019-10-02 10:00:00,2019-02-10 00:00:00,LABORABLE
2,10,2019,12,508,684,1192,2019-10-02 11:00:00,2019-02-10 00:00:00,LABORABLE
2,10,2019,13,664,700,1364,2019-10-02 12:00:00,2019-02-10 00:00:00,LABORABLE
2,10,2019,14,614,702,1316,2019-10-02 13:00:00,2019-02-10 00:00:00,LABORABLE
2,10,2019,15,669,693,1362,2019-10-02 14:00:00,2019-02-10 00:00:00,LABORABLE
2,10,2019,16,626,677,1303,2019-10-02 15:00:00,2019-02-10 00:00:00,LABORABLE
2,10,2019,17,670,686,1356,2019-10-02 16:00:00,2019-02-10 00:00:00,LABORABLE
2,10,2019,18,662,697,1359,2019-10-02 17:00:00,2019-02-10 00:00:00,LABORABLE
2,10,2019,19,699,742,1441,2019-10-02 18:00:00,2019-02-10 00:00:00,LABORABLE
2,10,2019,20,702,820,1522,2019-10-02 19:00:00,2019-02-10 00:00:00,LABORABLE
2,10,2019,21,676,754,1430,2019-10-02 20:00:00,2019-02-10 00:00:00,LABORABLE
2,10,2019,22,582,615,1197,2019-10-02 21:00:00,2019-02-10 00:00:00,LABORABLE
2,10,2019,23,432,418,850,2019-10-02 22:00:00,2019-02-10 00:00:00,LABORABLE
2,10,2019,24,331,346,677,2019-10-02 23:00:00,2019-02-10 00:00:00,LABORABLE
3,10,2019,1,206,286,492,2019-10-03 00:00:00,2019-03-10 00:00:00,LABORABLE
3,10,2019,2,142,192,334,2019-10-03 01:00:00,2019-03-10 00:00:00,LABORABLE
3,10,2019,3,108,150,258,2019-10-03 02:00:00,2019-03-10 00:00:00,LABORABLE
3,10,2019,4,81,108,189,2019-10-03 03:00:00,2019-03-10 00:00:00,LABORABLE
3,10,2019,5,89,104,193,2019-10-03 04:00:00,2019-03-10 00:00:00,LABORABLE
3,10,2019,6,153,152,305,2019-10-03 05:00:00,2019-03-10 00:00:00,LABORABLE
3,10,2019,7,460,425,885,2019-10-03 06:00:00,2019-03-10 00:00:00,LABORABLE
3,10,2019,8,660,659,1319,2019-10-03 07:00:00,2019-03-10 00:00:00,LABORABLE
3,10,2019,9,612,638,1250,2019-10-03 08:00:00,2019-03-10 00:00:00,LABORABLE
3,10,2019,10,600,726,1326,2019-10-03 09:00:00,2019-03-10 00:00:00,LABORABLE
3,10,2019,11,619,622,1241,2019-10-03 10:00:00,2019-03-10 00:00:00,LABORABLE
3,10,2019,12,661,747,1408,2019-10-03 11:00:00,2019-03-10 00:00:00,LABORABLE
3,10,2019,13,640,723,1363,2019-10-03 12:00:00,2019-03-10 00:00:00,LABORABLE
3,10,2019,14,654,725,1379,2019-10-03 13:00:00,2019-03-10 00:00:00,LABORABLE
3,10,2019,15,651,693,1344,2019-10-03 14:00:00,2019-03-10 00:00:00,LABORABLE
3,10,2019,16,658,726,1384,2019-10-03 15:00:00,2019-03-10 00:00:00,LABORABLE
3,10,2019,17,677,743,1420,2019-10-03 16:00:00,2019-03-10 00:00:00,LABORABLE
3,10,2019,18,734,758,1492,2019-10-03 17:00:00,2019-03-10 00:00:00,LABORABLE
3,10,2019,19,736,783,1519,2019-10-03 18:00:00,2019-03-10 00:00:00,LABORABLE
3,10,2019,20,712,778,1490,2019-10-03 19:00:00,2019-03-10 00:00:00,LABORABLE
3,10,2019,21,709,792,1501,2019-10-03 20:00:00,2019-03-10 00:00:00,LABORABLE
3,10,2019,22,567,656,1223,2019-10-03 21:00:00,2019-03-10 00:00:00,LABORABLE
3,10,2019,23,482,560,1042,2019-10-03 22:00:00,2019-03-10 00:00:00,LABORABLE
3,10,2019,24,309,399,708,2019-10-03 23:00:00,2019-03-10 00:00:00,LABORABLE
4,10,2019,1,227,337,564,2019-10-04 00:00:00,2019-04-10 00:00:00,LABORABLE
4,10,2019,2,163,239,402,2019-10-04 01:00:00,2019-04-10 00:00:00,LABORABLE
4,10,2019,3,102,196,298,2019-10-04 02:00:00,2019-04-10 00:00:00,LABORABLE
4,10,2019,4,94,121,215,2019-10-04 03:00:00,2019-04-10 00:00:00,LABORABLE
4,10,2019,5,91,145,236,2019-10-04 04:00:00,2019-04-10 00:00:00,LABORABLE
4,10,2019,6,157,176,333,2019-10-04 05:00:00,2019-04-10 00:00:00,LABORABLE
4,10,2019,7,461,487,948,2019-10-04 06:00:00,2019-04-10 00:00:00,LABORABLE
4,10,2019,8,743,601,1344,2019-10-04 07:00:00,2019-04-10 00:00:00,LABORABLE
4,10,2019,9,704,721,1425,2019-10-04 08:00:00,2019-04-10 00:00:00,LABORABLE
4,10,2019,10,633,682,1315,2019-10-04 09:00:00,2019-04-10 00:00:00,LABORABLE
4,10,2019,11,564,655,1219,2019-10-04 10:00:00,2019-04-10 00:00:00,LABORABLE
4,10,2019,12,626,727,1353,2019-10-04 11:00:00,2019-04-10 00:00:00,LABORABLE
4,10,2019,13,689,742,1431,2019-10-04 12:00:00,2019-04-10 00:00:00,LABORABLE
4,10,2019,14,689,792,1481,2019-10-04 13:00:00,2019-04-10 00:00:00,LABORABLE
4,10,2019,15,689,887,1576,2019-10-04 14:00:00,2019-04-10 00:00:00,LABORABLE
4,10,2019,16,677,686,1363,2019-10-04 15:00:00,2019-04-10 00:00:00,LABORABLE
4,10,2019,17,668,743,1411,2019-10-04 16:00:00,2019-04-10 00:00:00,LABORABLE
4,10,2019,18,716,753,1469,2019-10-04 17:00:00,2019-04-10 00:00:00,LABORABLE
4,10,2019,19,689,832,1521,2019-10-04 18:00:00,2019-04-10 00:00:00,LABORABLE
4,10,2019,20,706,799,1505,2019-10-04 19:00:00,2019-04-10 00:00:00,LABORABLE
4,10,2019,21,718,860,1578,2019-10-04 20:00:00,2019-04-10 00:00:00,LABORABLE
4,10,2019,22,656,724,1380,2019-10-04 21:00:00,2019-04-10 00:00:00,LABORABLE
4,10,2019,23,556,602,1158,2019-10-04 22:00:00,2019-04-10 00:00:00,LABORABLE
4,10,2019,24,438,567,1005,2019-10-04 23:00:00,2019-04-10 00:00:00,LABORABLE
5,10,2019,1,72,301,373,2019-10-05 00:00:00,2019-05-10 00:00:00,LABORABLE
5,10,2019,2,36,273,309,2019-10-05 01:00:00,2019-05-10 00:00:00,LABORABLE
5,10,2019,3,22,178,200,2019-10-05 02:00:00,2019-05-10 00:00:00,LABORABLE
5,10,2019,4,14,115,129,2019-10-05 03:00:00,2019-05-10 00:00:00,LABORABLE
5,10,2019,5,16,110,126,2019-10-05 04:00:00,2019-05-10 00:00:00,LABORABLE
5,10,2019,6,41,187,228,2019-10-05 05:00:00,2019-05-10 00:00:00,LABORABLE
5,10,2019,7,107,438,545,2019-10-05 06:00:00,2019-05-10 00:00:00,LABORABLE
5,10,2019,8,163,690,853,2019-10-05 07:00:00,2019-05-10 00:00:00,LABORABLE
5,10,2019,9,181,782,963,2019-10-05 08:00:00,2019-05-10 00:00:00,LABORABLE
5,10,2019,10,150,753,903,2019-10-05 09:00:00,2019-05-10 00:00:00,LABORABLE
5,10,2019,11,156,684,840,2019-10-05 10:00:00,2019-05-10 00:00:00,LABORABLE
5,10,2019,12,173,732,905,2019-10-05 11:00:00,2019-05-10 00:00:00,LABORABLE
5,10,2019,13,379,824,1203,2019-10-05 12:00:00,2019-05-10 00:00:00,LABORABLE
5,10,2019,14,635,780,1415,2019-10-05 13:00:00,2019-05-10 00:00:00,LABORABLE
5,10,2019,15,699,796,1495,2019-10-05 14:00:00,2019-05-10 00:00:00,LABORABLE
5,10,2019,16,601,696,1297,2019-10-05 15:00:00,2019-05-10 00:00:00,LABORABLE
5,10,2019,17,604,742,1346,2019-10-05 16:00:00,2019-05-10 00:00:00,LABORABLE
5,10,2019,18,645,850,1495,2019-10-05 17:00:00,2019-05-10 00:00:00,LABORABLE
5,10,2019,19,743,863,1606,2019-10-05 18:00:00,2019-05-10 00:00:00,LABORABLE
5,10,2019,20,624,808,1432,2019-10-05 19:00:00,2019-05-10 00:00:00,LABORABLE
5,10,2019,21,651,814,1465,2019-10-05 20:00:00,2019-05-10 00:00:00,LABORABLE
5,10,2019,22,564,672,1236,2019-10-05 21:00:00,2019-05-10 00:00:00,LABORABLE
5,10,2019,23,388,490,878,2019-10-05 22:00:00,2019-05-10 00:00:00,LABORABLE
5,10,2019,24,294,403,697,2019-10-05 23:00:00,2019-05-10 00:00:00,LABORABLE
6,10,2019,1,189,311,500,2019-10-06 00:00:00,2019-06-10 00:00:00,LABORABLE
6,10,2019,2,136,267,403,2019-10-06 01:00:00,2019-06-10 00:00:00,LABORABLE
6,10,2019,3,97,203,300,2019-10-06 02:00:00,2019-06-10 00:00:00,LABORABLE
6,10,2019,4,81,146,227,2019-10-06 03:00:00,2019-06-10 00:00:00,LABORABLE
6,10,2019,5,73,121,194,2019-10-06 04:00:00,2019-06-10 00:00:00,LABORABLE
6,10,2019,6,137,179,316,2019-10-06 05:00:00,2019-06-10 00:00:00,LABORABLE
6,10,2019,7,369,441,810,2019-10-06 06:00:00,2019-06-10 00:00:00,LABORABLE
6,10,2019,8,583,662,1245,2019-10-06 07:00:00,2019-06-10 00:00:00,LABORABLE
6,10,2019,9,595,744,1339,2019-10-06 08:00:00,2019-06-10 00:00:00,LABORABLE
6,10,2019,10,543,738,1281,2019-10-06 09:00:00,2019-06-10 00:00:00,LABORABLE
6,10,2019,11,538,710,1248,2019-10-06 10:00:00,2019-06-10 00:00:00,LABORABLE
6,10,2019,12,551,740,1291,2019-10-06 11:00:00,2019-06-10 00:00:00,LABORABLE
6,10,2019,13,479,631,1110,2019-10-06 12:00:00,2019-06-10 00:00:00,LABORABLE
6,10,2019,14,584,792,1376,2019-10-06 13:00:00,2019-06-10 00:00:00,LABORABLE
6,10,2019,15,661,729,1390,2019-10-06 14:00:00,2019-06-10 00:00:00,LABORABLE
6,10,2019,16,568,718,1286,2019-10-06 15:00:00,2019-06-10 00:00:00,LABORABLE
6,10,2019,17,630,801,1431,2019-10-06 16:00:00,2019-06-10 00:00:00,LABORABLE
6,10,2019,18,684,810,1494,2019-10-06 17:00:00,2019-06-10 00:00:00,LABORABLE
6,10,2019,19,690,832,1522,2019-10-06 18:00:00,2019-06-10 00:00:00,LABORABLE
6,10,2019,20,738,829,1567,2019-10-06 19:00:00,2019-06-10 00:00:00,LABORABLE
6,10,2019,21,694,858,1552,2019-10-06 20:00:00,2019-06-10 00:00:00,LABORABLE
6,10,2019,22,609,748,1357,2019-10-06 21:00:00,2019-06-10 00:00:00,LABORABLE
6,10,2019,23,484,653,1137,2019-10-06 22:00:00,2019-06-10 00:00:00,LABORABLE
6,10,2019,24,341,525,866,2019-10-06 23:00:00,2019-06-10 00:00:00,LABORABLE
7,10,2019,1,201,311,512,2019-10-07 00:00:00,2019-07-10 00:00:00,LABORABLE
7,10,2019,2,124,228,352,2019-10-07 01:00:00,2019-07-10 00:00:00,LABORABLE
7,10,2019,3,104,178,282,2019-10-07 02:00:00,2019-07-10 00:00:00,LABORABLE
7,10,2019,4,77,124,201,2019-10-07 03:00:00,2019-07-10 00:00:00,LABORABLE
7,10,2019,5,87,132,219,2019-10-07 04:00:00,2019-07-10 00:00:00,LABORABLE
7,10,2019,6,168,172,340,2019-10-07 05:00:00,2019-07-10 00:00:00,LABORABLE
7,10,2019,7,440,465,905,2019-10-07 06:00:00,2019-07-10 00:00:00,LABORABLE
7,10,2019,8,690,694,1384,2019-10-07 07:00:00,2019-07-10 00:00:00,LABORABLE
7,10,2019,9,701,647,1348,2019-10-07 08:00:00,2019-07-10 00:00:00,LABORABLE
7,10,2019,10,654,700,1354,2019-10-07 09:00:00,2019-07-10 00:00:00,LABORABLE
7,10,2019,11,581,624,1205,2019-10-07 10:00:00,2019-07-10 00:00:00,LABORABLE
7,10,2019,12,628,726,1354,2019-10-07 11:00:00,2019-07-10 00:00:00,LABORABLE
7,10,2019,13,602,760,1362,2019-10-07 12:00:00,2019-07-10 00:00:00,LABORABLE
7,10,2019,14,626,730,1356,2019-10-07 13:00:00,2019-07-10 00:00:00,LABORABLE
7,10,2019,15,638,718,1356,2019-10-07 14:00:00,2019-07-10 00:00:00,LABORABLE
7,10,2019,16,650,639,1289,2019-10-07 15:00:00,2019-07-10 00:00:00,LABORABLE
7,10,2019,17,634,738,1372,2019-10-07 16:00:00,2019-07-10 00:00:00,LABORABLE
7,10,2019,18,682,788,1470,2019-10-07 17:00:00,2019-07-10 00:00:00,LABORABLE
7,10,2019,19,676,733,1409,2019-10-07 18:00:00,2019-07-10 00:00:00,LABORABLE
7,10,2019,20,694,799,1493,2019-10-07 19:00:00,2019-07-10 00:00:00,LABORABLE
7,10,2019,21,684,794,1478,2019-10-07 20:00:00,2019-07-10 00:00:00,LABORABLE
7,10,2019,22,545,614,1159,2019-10-07 21:00:00,2019-07-10 00:00:00,LABORABLE
7,10,2019,23,397,502,899,2019-10-07 22:00:00,2019-07-10 00:00:00,LABORABLE
7,10,2019,24,252,306,558,2019-10-07 23:00:00,2019-07-10 00:00:00,LABORABLE
8,10,2019,1,177,249,426,2019-10-08 00:00:00,2019-08-10 00:00:00,LABORABLE
8,10,2019,2,95,163,258,2019-10-08 01:00:00,2019-08-10 00:00:00,LABORABLE
8,10,2019,3,77,141,218,2019-10-08 02:00:00,2019-08-10 00:00:00,LABORABLE
8,10,2019,4,72,101,173,2019-10-08 03:00:00,2019-08-10 00:00:00,LABORABLE
8,10,2019,5,87,79,166,2019-10-08 04:00:00,2019-08-10 00:00:00,LABORABLE
8,10,2019,6,117,160,277,2019-10-08 05:00:00,2019-08-10 00:00:00,LABORABLE
8,10,2019,7,418,486,904,2019-10-08 06:00:00,2019-08-10 00:00:00,LABORABLE
8,10,2019,8,668,672,1340,2019-10-08 07:00:00,2019-08-10 00:00:00,LABORABLE
8,10,2019,9,686,651,1337,2019-10-08 08:00:00,2019-08-10 00:00:00,LABORABLE
8,10,2019,10,616,723,1339,2019-10-08 09:00:00,2019-08-10 00:00:00,LABORABLE
8,10,2019,11,490,648,1138,2019-10-08 10:00:00,2019-08-10 00:00:00,LABORABLE
8,10,2019,12,550,762,1312,2019-10-08 11:00:00,2019-08-10 00:00:00,LABORABLE
8,10,2019,13,600,776,1376,2019-10-08 12:00:00,2019-08-10 00:00:00,LABORABLE
8,10,2019,14,651,811,1462,2019-10-08 13:00:00,2019-08-10 00:00:00,LABORABLE
8,10,2019,15,642,690,1332,2019-10-08 14:00:00,2019-08-10 00:00:00,LABORABLE
8,10,2019,16,670,676,1346,2019-10-08 15:00:00,2019-08-10 00:00:00,LABORABLE
8,10,2019,17,668,786,1454,2019-10-08 16:00:00,2019-08-10 00:00:00,LABORABLE
8,10,2019,18,692,698,1390,2019-10-08 17:00:00,2019-08-10 00:00:00,LABORABLE
8,10,2019,19,672,756,1428,2019-10-08 18:00:00,2019-08-10 00:00:00,LABORABLE
8,10,2019,20,658,782,1440,2019-10-08 19:00:00,2019-08-10 00:00:00,LABORABLE
8,10,2019,21,699,729,1428,2019-10-08 20:00:00,2019-08-10 00:00:00,LABORABLE
8,10,2019,22,538,652,1190,2019-10-08 21:00:00,2019-08-10 00:00:00,LABORABLE
8,10,2019,23,424,468,892,2019-10-08 22:00:00,2019-08-10 00:00:00,LABORABLE
8,10,2019,24,260,342,602,2019-10-08 23:00:00,2019-08-10 00:00:00,LABORABLE
9,10,2019,1,187,288,475,2019-10-09 00:00:00,2019-09-10 00:00:00,LABORABLE
9,10,2019,2,126,209,335,2019-10-09 01:00:00,2019-09-10 00:00:00,LABORABLE
9,10,2019,3,95,132,227,2019-10-09 02:00:00,2019-09-10 00:00:00,LABORABLE
9,10,2019,4,63,109,172,2019-10-09 03:00:00,2019-09-10 00:00:00,LABORABLE
9,10,2019,5,81,97,178,2019-10-09 04:00:00,2019-09-10 00:00:00,LABORABLE
9,10,2019,6,175,162,337,2019-10-09 05:00:00,2019-09-10 00:00:00,LABORABLE
9,10,2019,7,400,447,847,2019-10-09 06:00:00,2019-09-10 00:00:00,LABORABLE
9,10,2019,8,703,673,1376,2019-10-09 07:00:00,2019-09-10 00:00:00,LABORABLE
9,10,2019,9,676,724,1400,2019-10-09 08:00:00,2019-09-10 00:00:00,LABORABLE
9,10,2019,10,668,665,1333,2019-10-09 09:00:00,2019-09-10 00:00:00,LABORABLE
9,10,2019,11,568,675,1243,2019-10-09 10:00:00,2019-09-10 00:00:00,LABORABLE
9,10,2019,12,573,703,1276,2019-10-09 11:00:00,2019-09-10 00:00:00,LABORABLE
9,10,2019,13,634,704,1338,2019-10-09 12:00:00,2019-09-10 00:00:00,LABORABLE
9,10,2019,14,607,688,1295,2019-10-09 13:00:00,2019-09-10 00:00:00,LABORABLE
9,10,2019,15,678,683,1361,2019-10-09 14:00:00,2019-09-10 00:00:00,LABORABLE
9,10,2019,16,592,690,1282,2019-10-09 15:00:00,2019-09-10 00:00:00,LABORABLE
9,10,2019,17,648,700,1348,2019-10-09 16:00:00,2019-09-10 00:00:00,LABORABLE
9,10,2019,18,686,709,1395,2019-10-09 17:00:00,2019-09-10 00:00:00,LABORABLE
9,10,2019,19,707,855,1562,2019-10-09 18:00:00,2019-09-10 00:00:00,LABORABLE
9,10,2019,20,680,750,1430,2019-10-09 19:00:00,2019-09-10 00:00:00,LABORABLE
9,10,2019,21,673,725,1398,2019-10-09 20:00:00,2019-09-10 00:00:00,LABORABLE
9,10,2019,22,547,677,1224,2019-10-09 21:00:00,2019-09-10 00:00:00,LABORABLE
9,10,2019,23,429,458,887,2019-10-09 22:00:00,2019-09-10 00:00:00,LABORABLE
9,10,2019,24,286,382,668,2019-10-09 23:00:00,2019-09-10 00:00:00,LABORABLE
10,10,2019,1,209,257,466,2019-10-10 00:00:00,2019-10-10 00:00:00,LABORABLE
10,10,2019,2,132,209,341,2019-10-10 01:00:00,2019-10-10 00:00:00,LABORABLE
10,10,2019,3,83,163,246,2019-10-10 02:00:00,2019-10-10 00:00:00,LABORABLE
10,10,2019,4,86,110,196,2019-10-10 03:00:00,2019-10-10 00:00:00,LABORABLE
10,10,2019,5,84,131,215,2019-10-10 04:00:00,2019-10-10 00:00:00,LABORABLE
10,10,2019,6,173,155,328,2019-10-10 05:00:00,2019-10-10 00:00:00,LABORABLE
10,10,2019,7,407,468,875,2019-10-10 06:00:00,2019-10-10 00:00:00,LABORABLE
10,10,2019,8,674,654,1328,2019-10-10 07:00:00,2019-10-10 00:00:00,LABORABLE
10,10,2019,9,718,683,1401,2019-10-10 08:00:00,2019-10-10 00:00:00,LABORABLE
10,10,2019,10,642,691,1333,2019-10-10 09:00:00,2019-10-10 00:00:00,LABORABLE
10,10,2019,11,581,666,1247,2019-10-10 10:00:00,2019-10-10 00:00:00,LABORABLE
10,10,2019,12,620,718,1338,2019-10-10 11:00:00,2019-10-10 00:00:00,LABORABLE
10,10,2019,13,675,736,1411,2019-10-10 12:00:00,2019-10-10 00:00:00,LABORABLE
10,10,2019,14,649,737,1386,2019-10-10 13:00:00,2019-10-10 00:00:00,LABORABLE
10,10,2019,15,688,719,1407,2019-10-10 14:00:00,2019-10-10 00:00:00,LABORABLE
10,10,2019,16,658,634,1292,2019-10-10 15:00:00,2019-10-10 00:00:00,LABORABLE
10,10,2019,17,665,777,1442,2019-10-10 16:00:00,2019-10-10 00:00:00,LABORABLE
10,10,2019,18,752,807,1559,2019-10-10 17:00:00,2019-10-10 00:00:00,LABORABLE
10,10,2019,19,741,796,1537,2019-10-10 18:00:00,2019-10-10 00:00:00,LABORABLE
10,10,2019,20,693,783,1476,2019-10-10 19:00:00,2019-10-10 00:00:00,LABORABLE
10,10,2019,21,689,754,1443,2019-10-10 20:00:00,2019-10-10 00:00:00,LABORABLE
10,10,2019,22,587,604,1191,2019-10-10 21:00:00,2019-10-10 00:00:00,LABORABLE
10,10,2019,23,482,486,968,2019-10-10 22:00:00,2019-10-10 00:00:00,LABORABLE
10,10,2019,24,307,386,693,2019-10-10 23:00:00,2019-10-10 00:00:00,LABORABLE
11,10,2019,1,252,340,592,2019-10-11 00:00:00,2019-11-10 00:00:00,LABORABLE
11,10,2019,2,155,220,375,2019-10-11 01:00:00,2019-11-10 00:00:00,LABORABLE
11,10,2019,3,100,169,269,2019-10-11 02:00:00,2019-11-10 00:00:00,LABORABLE
11,10,2019,4,107,116,223,2019-10-11 03:00:00,2019-11-10 00:00:00,LABORABLE
11,10,2019,5,93,109,202,2019-10-11 04:00:00,2019-11-10 00:00:00,LABORABLE
11,10,2019,6,171,175,346,2019-10-11 05:00:00,2019-11-10 00:00:00,LABORABLE
11,10,2019,7,447,459,906,2019-10-11 06:00:00,2019-11-10 00:00:00,LABORABLE
11,10,2019,8,683,681,1364,2019-10-11 07:00:00,2019-11-10 00:00:00,LABORABLE
11,10,2019,9,700,682,1382,2019-10-11 08:00:00,2019-11-10 00:00:00,LABORABLE
11,10,2019,10,669,702,1371,2019-10-11 09:00:00,2019-11-10 00:00:00,LABORABLE
11,10,2019,11,585,689,1274,2019-10-11 10:00:00,2019-11-10 00:00:00,LABORABLE
11,10,2019,12,639,739,1378,2019-10-11 11:00:00,2019-11-10 00:00:00,LABORABLE
11,10,2019,13,628,769,1397,2019-10-11 12:00:00,2019-11-10 00:00:00,LABORABLE
11,10,2019,14,527,611,1138,2019-10-11 13:00:00,2019-11-10 00:00:00,LABORABLE
11,10,2019,15,703,705,1408,2019-10-11 14:00:00,2019-11-10 00:00:00,LABORABLE
11,10,2019,16,684,774,1458,2019-10-11 15:00:00,2019-11-10 00:00:00,LABORABLE
11,10,2019,17,696,738,1434,2019-10-11 16:00:00,2019-11-10 00:00:00,LABORABLE
11,10,2019,18,706,768,1474,2019-10-11 17:00:00,2019-11-10 00:00:00,LABORABLE
11,10,2019,19,730,842,1572,2019-10-11 18:00:00,2019-11-10 00:00:00,LABORABLE
11,10,2019,20,718,838,1556,2019-10-11 19:00:00,2019-11-10 00:00:00,LABORABLE
11,10,2019,21,806,845,1651,2019-10-11 20:00:00,2019-11-10 00:00:00,LABORABLE
11,10,2019,22,653,724,1377,2019-10-11 21:00:00,2019-11-10 00:00:00,LABORABLE
11,10,2019,23,512,620,1132,2019-10-11 22:00:00,2019-11-10 00:00:00,LABORABLE
11,10,2019,24,424,555,979,2019-10-11 23:00:00,2019-11-10 00:00:00,LABORABLE
12,10,2019,1,267,372,639,2019-10-12 00:00:00,2019-12-10 00:00:00,FESTIVO
12,10,2019,2,173,351,524,2019-10-12 01:00:00,2019-12-10 00:00:00,FESTIVO
12,10,2019,3,141,251,392,2019-10-12 02:00:00,2019-12-10 00:00:00,FESTIVO
12,10,2019,4,90,178,268,2019-10-12 03:00:00,2019-12-10 00:00:00,FESTIVO
12,10,2019,5,73,150,223,2019-10-12 04:00:00,2019-12-10 00:00:00,FESTIVO
12,10,2019,6,78,154,232,2019-10-12 05:00:00,2019-12-10 00:00:00,FESTIVO
12,10,2019,7,152,234,386,2019-10-12 06:00:00,2019-12-10 00:00:00,FESTIVO
12,10,2019,8,214,268,482,2019-10-12 07:00:00,2019-12-10 00:00:00,FESTIVO
12,10,2019,9,233,312,545,2019-10-12 08:00:00,2019-12-10 00:00:00,FESTIVO
12,10,2019,10,316,406,722,2019-10-12 09:00:00,2019-12-10 00:00:00,FESTIVO
12,10,2019,11,406,456,862,2019-10-12 10:00:00,2019-12-10 00:00:00,FESTIVO
12,10,2019,12,496,519,1015,2019-10-12 11:00:00,2019-12-10 00:00:00,FESTIVO
12,10,2019,13,484,596,1080,2019-10-12 12:00:00,2019-12-10 00:00:00,FESTIVO
12,10,2019,14,519,660,1179,2019-10-12 13:00:00,2019-12-10 00:00:00,FESTIVO
12,10,2019,15,503,661,1164,2019-10-12 14:00:00,2019-12-10 00:00:00,FESTIVO
12,10,2019,16,343,600,943,2019-10-12 15:00:00,2019-12-10 00:00:00,FESTIVO
12,10,2019,17,366,630,996,2019-10-12 16:00:00,2019-12-10 00:00:00,FESTIVO
12,10,2019,18,471,602,1073,2019-10-12 17:00:00,2019-12-10 00:00:00,FESTIVO
12,10,2019,19,469,670,1139,2019-10-12 18:00:00,2019-12-10 00:00:00,FESTIVO
12,10,2019,20,458,690,1148,2019-10-12 19:00:00,2019-12-10 00:00:00,FESTIVO
12,10,2019,21,458,703,1161,2019-10-12 20:00:00,2019-12-10 00:00:00,FESTIVO
12,10,2019,22,500,623,1123,2019-10-12 21:00:00,2019-12-10 00:00:00,FESTIVO
12,10,2019,23,470,516,986,2019-10-12 22:00:00,2019-12-10 00:00:00,FESTIVO
12,10,2019,24,282,439,721,2019-10-12 23:00:00,2019-12-10 00:00:00,FESTIVO
13,10,2019,1,216,310,526,2019-10-13 00:00:00,2019-10-13 00:00:00,LABORABLE
13,10,2019,2,125,278,403,2019-10-13 01:00:00,2019-10-13 00:00:00,LABORABLE
13,10,2019,3,95,197,292,2019-10-13 02:00:00,2019-10-13 00:00:00,LABORABLE
13,10,2019,4,61,120,181,2019-10-13 03:00:00,2019-10-13 00:00:00,LABORABLE
13,10,2019,5,56,110,166,2019-10-13 04:00:00,2019-10-13 00:00:00,LABORABLE
13,10,2019,6,159,174,333,2019-10-13 05:00:00,2019-10-13 00:00:00,LABORABLE
13,10,2019,7,299,387,686,2019-10-13 06:00:00,2019-10-13 00:00:00,LABORABLE
13,10,2019,8,419,523,942,2019-10-13 07:00:00,2019-10-13 00:00:00,LABORABLE
13,10,2019,9,435,562,997,2019-10-13 08:00:00,2019-10-13 00:00:00,LABORABLE
13,10,2019,10,492,674,1166,2019-10-13 09:00:00,2019-10-13 00:00:00,LABORABLE
13,10,2019,11,499,687,1186,2019-10-13 10:00:00,2019-10-13 00:00:00,LABORABLE
13,10,2019,12,584,795,1379,2019-10-13 11:00:00,2019-10-13 00:00:00,LABORABLE
13,10,2019,13,579,817,1396,2019-10-13 12:00:00,2019-10-13 00:00:00,LABORABLE
13,10,2019,14,607,786,1393,2019-10-13 13:00:00,2019-10-13 00:00:00,LABORABLE
13,10,2019,15,571,732,1303,2019-10-13 14:00:00,2019-10-13 00:00:00,LABORABLE
13,10,2019,16,482,721,1203,2019-10-13 15:00:00,2019-10-13 00:00:00,LABORABLE
13,10,2019,17,532,717,1249,2019-10-13 16:00:00,2019-10-13 00:00:00,LABORABLE
13,10,2019,18,616,756,1372,2019-10-13 17:00:00,2019-10-13 00:00:00,LABORABLE
13,10,2019,19,649,830,1479,2019-10-13 18:00:00,2019-10-13 00:00:00,LABORABLE
13,10,2019,20,648,839,1487,2019-10-13 19:00:00,2019-10-13 00:00:00,LABORABLE
13,10,2019,21,624,825,1449,2019-10-13 20:00:00,2019-10-13 00:00:00,LABORABLE
13,10,2019,22,536,752,1288,2019-10-13 21:00:00,2019-10-13 00:00:00,LABORABLE
13,10,2019,23,417,556,973,2019-10-13 22:00:00,2019-10-13 00:00:00,LABORABLE
13,10,2019,24,345,489,834,2019-10-13 23:00:00,2019-10-13 00:00:00,LABORABLE
14,10,2019,1,211,277,488,2019-10-14 00:00:00,2019-10-14 00:00:00,LABORABLE
14,10,2019,2,122,201,323,2019-10-14 01:00:00,2019-10-14 00:00:00,LABORABLE
14,10,2019,3,118,169,287,2019-10-14 02:00:00,2019-10-14 00:00:00,LABORABLE
14,10,2019,4,78,126,204,2019-10-14 03:00:00,2019-10-14 00:00:00,LABORABLE
14,10,2019,5,62,132,194,2019-10-14 04:00:00,2019-10-14 00:00:00,LABORABLE
14,10,2019,6,123,165,288,2019-10-14 05:00:00,2019-10-14 00:00:00,LABORABLE
14,10,2019,7,460,463,923,2019-10-14 06:00:00,2019-10-14 00:00:00,LABORABLE
14,10,2019,8,680,653,1333,2019-10-14 07:00:00,2019-10-14 00:00:00,LABORABLE
14,10,2019,9,680,723,1403,2019-10-14 08:00:00,2019-10-14 00:00:00,LABORABLE
14,10,2019,10,680,711,1391,2019-10-14 09:00:00,2019-10-14 00:00:00,LABORABLE
14,10,2019,11,551,658,1209,2019-10-14 10:00:00,2019-10-14 00:00:00,LABORABLE
14,10,2019,12,532,685,1217,2019-10-14 11:00:00,2019-10-14 00:00:00,LABORABLE
14,10,2019,13,527,631,1158,2019-10-14 12:00:00,2019-10-14 00:00:00,LABORABLE
14,10,2019,14,902,744,1646,2019-10-14 13:00:00,2019-10-14 00:00:00,LABORABLE
14,10,2019,15,656,729,1385,2019-10-14 14:00:00,2019-10-14 00:00:00,LABORABLE
14,10,2019,16,680,669,1349,2019-10-14 15:00:00,2019-10-14 00:00:00,LABORABLE
14,10,2019,17,630,697,1327,2019-10-14 16:00:00,2019-10-14 00:00:00,LABORABLE
14,10,2019,18,719,766,1485,2019-10-14 17:00:00,2019-10-14 00:00:00,LABORABLE
14,10,2019,19,637,812,1449,2019-10-14 18:00:00,2019-10-14 00:00:00,LABORABLE
14,10,2019,20,636,804,1440,2019-10-14 19:00:00,2019-10-14 00:00:00,LABORABLE
14,10,2019,21,600,786,1386,2019-10-14 20:00:00,2019-10-14 00:00:00,LABORABLE
14,10,2019,22,489,611,1100,2019-10-14 21:00:00,2019-10-14 00:00:00,LABORABLE
14,10,2019,23,413,434,847,2019-10-14 22:00:00,2019-10-14 00:00:00,LABORABLE
14,10,2019,24,236,319,555,2019-10-14 23:00:00,2019-10-14 00:00:00,LABORABLE
15,10,2019,1,161,282,443,2019-10-15 00:00:00,2019-10-15 00:00:00,LABORABLE
15,10,2019,2,93,185,278,2019-10-15 01:00:00,2019-10-15 00:00:00,LABORABLE
15,10,2019,3,64,123,187,2019-10-15 02:00:00,2019-10-15 00:00:00,LABORABLE
15,10,2019,4,66,94,160,2019-10-15 03:00:00,2019-10-15 00:00:00,LABORABLE
15,10,2019,5,92,100,192,2019-10-15 04:00:00,2019-10-15 00:00:00,LABORABLE
15,10,2019,6,117,163,280,2019-10-15 05:00:00,2019-10-15 00:00:00,LABORABLE
15,10,2019,7,421,458,879,2019-10-15 06:00:00,2019-10-15 00:00:00,LABORABLE
15,10,2019,8,689,642,1331,2019-10-15 07:00:00,2019-10-15 00:00:00,LABORABLE
15,10,2019,9,687,690,1377,2019-10-15 08:00:00,2019-10-15 00:00:00,LABORABLE
15,10,2019,10,670,707,1377,2019-10-15 09:00:00,2019-10-15 00:00:00,LABORABLE
15,10,2019,11,568,594,1162,2019-10-15 10:00:00,2019-10-15 00:00:00,LABORABLE
15,10,2019,12,582,728,1310,2019-10-15 11:00:00,2019-10-15 00:00:00,LABORABLE
15,10,2019,13,661,736,1397,2019-10-15 12:00:00,2019-10-15 00:00:00,LABORABLE
15,10,2019,14,588,734,1322,2019-10-15 13:00:00,2019-10-15 00:00:00,LABORABLE
15,10,2019,15,641,671,1312,2019-10-15 14:00:00,2019-10-15 00:00:00,LABORABLE
15,10,2019,16,629,611,1240,2019-10-15 15:00:00,2019-10-15 00:00:00,LABORABLE
15,10,2019,17,697,632,1329,2019-10-15 16:00:00,2019-10-15 00:00:00,LABORABLE
15,10,2019,18,731,737,1468,2019-10-15 17:00:00,2019-10-15 00:00:00,LABORABLE
15,10,2019,19,670,764,1434,2019-10-15 18:00:00,2019-10-15 00:00:00,LABORABLE
15,10,2019,20,655,844,1499,2019-10-15 19:00:00,2019-10-15 00:00:00,LABORABLE
15,10,2019,21,680,713,1393,2019-10-15 20:00:00,2019-10-15 00:00:00,LABORABLE
15,10,2019,22,525,616,1141,2019-10-15 21:00:00,2019-10-15 00:00:00,LABORABLE
15,10,2019,23,441,476,917,2019-10-15 22:00:00,2019-10-15 00:00:00,LABORABLE
15,10,2019,24,274,336,610,2019-10-15 23:00:00,2019-10-15 00:00:00,LABORABLE
16,10,2019,1,176,284,460,2019-10-16 00:00:00,2019-10-16 00:00:00,LABORABLE
16,10,2019,2,122,200,322,2019-10-16 01:00:00,2019-10-16 00:00:00,LABORABLE
16,10,2019,3,68,146,214,2019-10-16 02:00:00,2019-10-16 00:00:00,LABORABLE
16,10,2019,4,72,112,184,2019-10-16 03:00:00,2019-10-16 00:00:00,LABORABLE
16,10,2019,5,84,99,183,2019-10-16 04:00:00,2019-10-16 00:00:00,LABORABLE
16,10,2019,6,179,181,360,2019-10-16 05:00:00,2019-10-16 00:00:00,LABORABLE
16,10,2019,7,442,415,857,2019-10-16 06:00:00,2019-10-16 00:00:00,LABORABLE
16,10,2019,8,703,660,1363,2019-10-16 07:00:00,2019-10-16 00:00:00,LABORABLE
16,10,2019,9,679,714,1393,2019-10-16 08:00:00,2019-10-16 00:00:00,LABORABLE
16,10,2019,10,603,680,1283,2019-10-16 09:00:00,2019-10-16 00:00:00,LABORABLE
16,10,2019,11,565,650,1215,2019-10-16 10:00:00,2019-10-16 00:00:00,LABORABLE
16,10,2019,12,600,712,1312,2019-10-16 11:00:00,2019-10-16 00:00:00,LABORABLE
16,10,2019,13,499,623,1122,2019-10-16 12:00:00,2019-10-16 00:00:00,LABORABLE
16,10,2019,14,626,741,1367,2019-10-16 13:00:00,2019-10-16 00:00:00,LABORABLE
16,10,2019,15,692,676,1368,2019-10-16 14:00:00,2019-10-16 00:00:00,LABORABLE
16,10,2019,16,625,676,1301,2019-10-16 15:00:00,2019-10-16 00:00:00,LABORABLE
16,10,2019,17,659,781,1440,2019-10-16 16:00:00,2019-10-16 00:00:00,LABORABLE
16,10,2019,18,662,675,1337,2019-10-16 17:00:00,2019-10-16 00:00:00,LABORABLE
16,10,2019,19,713,777,1490,2019-10-16 18:00:00,2019-10-16 00:00:00,LABORABLE
16,10,2019,20,700,827,1527,2019-10-16 19:00:00,2019-10-16 00:00:00,LABORABLE
16,10,2019,21,727,751,1478,2019-10-16 20:00:00,2019-10-16 00:00:00,LABORABLE
16,10,2019,22,522,622,1144,2019-10-16 21:00:00,2019-10-16 00:00:00,LABORABLE
16,10,2019,23,438,481,919,2019-10-16 22:00:00,2019-10-16 00:00:00,LABORABLE
16,10,2019,24,282,342,624,2019-10-16 23:00:00,2019-10-16 00:00:00,LABORABLE
17,10,2019,1,185,248,433,2019-10-17 00:00:00,2019-10-17 00:00:00,LABORABLE
17,10,2019,2,126,190,316,2019-10-17 01:00:00,2019-10-17 00:00:00,LABORABLE
17,10,2019,3,81,138,219,2019-10-17 02:00:00,2019-10-17 00:00:00,LABORABLE
17,10,2019,4,94,120,214,2019-10-17 03:00:00,2019-10-17 00:00:00,LABORABLE
17,10,2019,5,74,99,173,2019-10-17 04:00:00,2019-10-17 00:00:00,LABORABLE
17,10,2019,6,167,186,353,2019-10-17 05:00:00,2019-10-17 00:00:00,LABORABLE
17,10,2019,7,457,455,912,2019-10-17 06:00:00,2019-10-17 00:00:00,LABORABLE
17,10,2019,8,698,649,1347,2019-10-17 07:00:00,2019-10-17 00:00:00,LABORABLE
17,10,2019,9,717,716,1433,2019-10-17 08:00:00,2019-10-17 00:00:00,LABORABLE
17,10,2019,10,595,712,1307,2019-10-17 09:00:00,2019-10-17 00:00:00,LABORABLE
17,10,2019,11,553,649,1202,2019-10-17 10:00:00,2019-10-17 00:00:00,LABORABLE
17,10,2019,12,636,718,1354,2019-10-17 11:00:00,2019-10-17 00:00:00,LABORABLE
17,10,2019,13,615,684,1299,2019-10-17 12:00:00,2019-10-17 00:00:00,LABORABLE
17,10,2019,14,674,736,1410,2019-10-17 13:00:00,2019-10-17 00:00:00,LABORABLE
17,10,2019,15,675,707,1382,2019-10-17 14:00:00,2019-10-17 00:00:00,LABORABLE
17,10,2019,16,639,668,1307,2019-10-17 15:00:00,2019-10-17 00:00:00,LABORABLE
17,10,2019,17,698,724,1422,2019-10-17 16:00:00,2019-10-17 00:00:00,LABORABLE
17,10,2019,18,665,743,1408,2019-10-17 17:00:00,2019-10-17 00:00:00,LABORABLE
17,10,2019,19,786,800,1586,2019-10-17 18:00:00,2019-10-17 00:00:00,LABORABLE
17,10,2019,20,661,838,1499,2019-10-17 19:00:00,2019-10-17 00:00:00,LABORABLE
17,10,2019,21,719,739,1458,2019-10-17 20:00:00,2019-10-17 00:00:00,LABORABLE
17,10,2019,22,578,652,1230,2019-10-17 21:00:00,2019-10-17 00:00:00,LABORABLE
17,10,2019,23,474,501,975,2019-10-17 22:00:00,2019-10-17 00:00:00,LABORABLE
17,10,2019,24,320,360,680,2019-10-17 23:00:00,2019-10-17 00:00:00,LABORABLE
18,10,2019,1,199,334,533,2019-10-18 00:00:00,2019-10-18 00:00:00,LABORABLE
18,10,2019,2,146,248,394,2019-10-18 01:00:00,2019-10-18 00:00:00,LABORABLE
18,10,2019,3,98,192,290,2019-10-18 02:00:00,2019-10-18 00:00:00,LABORABLE
18,10,2019,4,90,156,246,2019-10-18 03:00:00,2019-10-18 00:00:00,LABORABLE
18,10,2019,5,109,117,226,2019-10-18 04:00:00,2019-10-18 00:00:00,LABORABLE
18,10,2019,6,198,169,367,2019-10-18 05:00:00,2019-10-18 00:00:00,LABORABLE
18,10,2019,7,451,445,896,2019-10-18 06:00:00,2019-10-18 00:00:00,LABORABLE
18,10,2019,8,686,634,1320,2019-10-18 07:00:00,2019-10-18 00:00:00,LABORABLE
18,10,2019,9,650,713,1363,2019-10-18 08:00:00,2019-10-18 00:00:00,LABORABLE
18,10,2019,10,620,712,1332,2019-10-18 09:00:00,2019-10-18 00:00:00,LABORABLE
18,10,2019,11,584,633,1217,2019-10-18 10:00:00,2019-10-18 00:00:00,LABORABLE
18,10,2019,12,450,625,1075,2019-10-18 11:00:00,2019-10-18 00:00:00,LABORABLE
18,10,2019,13,597,693,1290,2019-10-18 12:00:00,2019-10-18 00:00:00,LABORABLE
18,10,2019,14,691,739,1430,2019-10-18 13:00:00,2019-10-18 00:00:00,LABORABLE
18,10,2019,15,708,685,1393,2019-10-18 14:00:00,2019-10-18 00:00:00,LABORABLE
18,10,2019,16,691,721,1412,2019-10-18 15:00:00,2019-10-18 00:00:00,LABORABLE
18,10,2019,17,751,749,1500,2019-10-18 16:00:00,2019-10-18 00:00:00,LABORABLE
18,10,2019,18,726,745,1471,2019-10-18 17:00:00,2019-10-18 00:00:00,LABORABLE
18,10,2019,19,761,838,1599,2019-10-18 18:00:00,2019-10-18 00:00:00,LABORABLE
18,10,2019,20,712,769,1481,2019-10-18 19:00:00,2019-10-18 00:00:00,LABORABLE
18,10,2019,21,737,802,1539,2019-10-18 20:00:00,2019-10-18 00:00:00,LABORABLE
18,10,2019,22,626,743,1369,2019-10-18 21:00:00,2019-10-18 00:00:00,LABORABLE
18,10,2019,23,513,575,1088,2019-10-18 22:00:00,2019-10-18 00:00:00,LABORABLE
18,10,2019,24,379,524,903,2019-10-18 23:00:00,2019-10-18 00:00:00,LABORABLE
19,10,2019,1,165,241,406,2019-10-19 00:00:00,2019-10-19 00:00:00,LABORABLE
19,10,2019,2,109,195,304,2019-10-19 01:00:00,2019-10-19 00:00:00,LABORABLE
19,10,2019,3,74,130,204,2019-10-19 02:00:00,2019-10-19 00:00:00,LABORABLE
19,10,2019,4,67,89,156,2019-10-19 03:00:00,2019-10-19 00:00:00,LABORABLE
19,10,2019,5,44,68,112,2019-10-19 04:00:00,2019-10-19 00:00:00,LABORABLE
19,10,2019,6,139,153,292,2019-10-19 05:00:00,2019-10-19 00:00:00,LABORABLE
19,10,2019,7,379,448,827,2019-10-19 06:00:00,2019-10-19 00:00:00,LABORABLE
19,10,2019,8,576,758,1334,2019-10-19 07:00:00,2019-10-19 00:00:00,LABORABLE
19,10,2019,9,549,759,1308,2019-10-19 08:00:00,2019-10-19 00:00:00,LABORABLE
19,10,2019,10,601,732,1333,2019-10-19 09:00:00,2019-10-19 00:00:00,LABORABLE
19,10,2019,11,269,351,620,2019-10-19 10:00:00,2019-10-19 00:00:00,LABORABLE
19,10,2019,12,533,694,1227,2019-10-19 11:00:00,2019-10-19 00:00:00,LABORABLE
19,10,2019,13,609,763,1372,2019-10-19 12:00:00,2019-10-19 00:00:00,LABORABLE
19,10,2019,14,465,612,1077,2019-10-19 13:00:00,2019-10-19 00:00:00,LABORABLE
19,10,2019,15,422,522,944,2019-10-19 14:00:00,2019-10-19 00:00:00,LABORABLE
19,10,2019,16,613,697,1310,2019-10-19 15:00:00,2019-10-19 00:00:00,LABORABLE
19,10,2019,17,614,820,1434,2019-10-19 16:00:00,2019-10-19 00:00:00,LABORABLE
19,10,2019,18,647,819,1466,2019-10-19 17:00:00,2019-10-19 00:00:00,LABORABLE
19,10,2019,19,679,819,1498,2019-10-19 18:00:00,2019-10-19 00:00:00,LABORABLE
19,10,2019,20,634,834,1468,2019-10-19 19:00:00,2019-10-19 00:00:00,LABORABLE
19,10,2019,21,661,781,1442,2019-10-19 20:00:00,2019-10-19 00:00:00,LABORABLE
19,10,2019,22,556,754,1310,2019-10-19 21:00:00,2019-10-19 00:00:00,LABORABLE
19,10,2019,23,436,483,919,2019-10-19 22:00:00,2019-10-19 00:00:00,LABORABLE
19,10,2019,24,276,381,657,2019-10-19 23:00:00,2019-10-19 00:00:00,LABORABLE
20,10,2019,1,194,288,482,2019-10-20 00:00:00,2019-10-20 00:00:00,LABORABLE
20,10,2019,2,117,189,306,2019-10-20 01:00:00,2019-10-20 00:00:00,LABORABLE
20,10,2019,3,84,156,240,2019-10-20 02:00:00,2019-10-20 00:00:00,LABORABLE
20,10,2019,4,66,141,207,2019-10-20 03:00:00,2019-10-20 00:00:00,LABORABLE
20,10,2019,5,62,116,178,2019-10-20 04:00:00,2019-10-20 00:00:00,LABORABLE
20,10,2019,6,140,171,311,2019-10-20 05:00:00,2019-10-20 00:00:00,LABORABLE
20,10,2019,7,376,397,773,2019-10-20 06:00:00,2019-10-20 00:00:00,LABORABLE
20,10,2019,8,585,696,1281,2019-10-20 07:00:00,2019-10-20 00:00:00,LABORABLE
20,10,2019,9,576,727,1303,2019-10-20 08:00:00,2019-10-20 00:00:00,LABORABLE
20,10,2019,10,597,750,1347,2019-10-20 09:00:00,2019-10-20 00:00:00,LABORABLE
20,10,2019,11,542,784,1326,2019-10-20 10:00:00,2019-10-20 00:00:00,LABORABLE
20,10,2019,12,601,761,1362,2019-10-20 11:00:00,2019-10-20 00:00:00,LABORABLE
20,10,2019,13,613,812,1425,2019-10-20 12:00:00,2019-10-20 00:00:00,LABORABLE
20,10,2019,14,62,669,731,2019-10-20 13:00:00,2019-10-20 00:00:00,LABORABLE
20,10,2019,15,650,790,1440,2019-10-20 14:00:00,2019-10-20 00:00:00,LABORABLE
20,10,2019,16,600,743,1343,2019-10-20 15:00:00,2019-10-20 00:00:00,LABORABLE
20,10,2019,17,618,742,1360,2019-10-20 16:00:00,2019-10-20 00:00:00,LABORABLE
20,10,2019,18,704,815,1519,2019-10-20 17:00:00,2019-10-20 00:00:00,LABORABLE
20,10,2019,19,778,847,1625,2019-10-20 18:00:00,2019-10-20 00:00:00,LABORABLE
20,10,2019,20,689,850,1539,2019-10-20 19:00:00,2019-10-20 00:00:00,LABORABLE
20,10,2019,21,629,894,1523,2019-10-20 20:00:00,2019-10-20 00:00:00,LABORABLE
20,10,2019,22,633,895,1528,2019-10-20 21:00:00,2019-10-20 00:00:00,LABORABLE
20,10,2019,23,520,640,1160,2019-10-20 22:00:00,2019-10-20 00:00:00,LABORABLE
20,10,2019,24,389,500,889,2019-10-20 23:00:00,2019-10-20 00:00:00,LABORABLE
21,10,2019,1,212,267,479,2019-10-21 00:00:00,2019-10-21 00:00:00,LABORABLE
21,10,2019,2,124,189,313,2019-10-21 01:00:00,2019-10-21 00:00:00,LABORABLE
21,10,2019,3,94,156,250,2019-10-21 02:00:00,2019-10-21 00:00:00,LABORABLE
21,10,2019,4,88,108,196,2019-10-21 03:00:00,2019-10-21 00:00:00,LABORABLE
21,10,2019,5,83,115,198,2019-10-21 04:00:00,2019-10-21 00:00:00,LABORABLE
21,10,2019,6,173,171,344,2019-10-21 05:00:00,2019-10-21 00:00:00,LABORABLE
21,10,2019,7,467,478,945,2019-10-21 06:00:00,2019-10-21 00:00:00,LABORABLE
21,10,2019,8,659,663,1322,2019-10-21 07:00:00,2019-10-21 00:00:00,LABORABLE
21,10,2019,9,760,723,1483,2019-10-21 08:00:00,2019-10-21 00:00:00,LABORABLE
21,10,2019,10,615,665,1280,2019-10-21 09:00:00,2019-10-21 00:00:00,LABORABLE
21,10,2019,11,567,667,1234,2019-10-21 10:00:00,2019-10-21 00:00:00,LABORABLE
21,10,2019,12,477,573,1050,2019-10-21 11:00:00,2019-10-21 00:00:00,LABORABLE
21,10,2019,13,614,691,1305,2019-10-21 12:00:00,2019-10-21 00:00:00,LABORABLE
21,10,2019,14,601,724,1325,2019-10-21 13:00:00,2019-10-21 00:00:00,LABORABLE
21,10,2019,15,657,692,1349,2019-10-21 14:00:00,2019-10-21 00:00:00,LABORABLE
21,10,2019,16,661,675,1336,2019-10-21 15:00:00,2019-10-21 00:00:00,LABORABLE
21,10,2019,17,681,736,1417,2019-10-21 16:00:00,2019-10-21 00:00:00,LABORABLE
21,10,2019,18,686,698,1384,2019-10-21 17:00:00,2019-10-21 00:00:00,LABORABLE
21,10,2019,19,763,773,1536,2019-10-21 18:00:00,2019-10-21 00:00:00,LABORABLE
21,10,2019,20,650,745,1395,2019-10-21 19:00:00,2019-10-21 00:00:00,LABORABLE
21,10,2019,21,641,695,1336,2019-10-21 20:00:00,2019-10-21 00:00:00,LABORABLE
21,10,2019,22,526,627,1153,2019-10-21 21:00:00,2019-10-21 00:00:00,LABORABLE
21,10,2019,23,361,408,769,2019-10-21 22:00:00,2019-10-21 00:00:00,LABORABLE
21,10,2019,24,250,298,548,2019-10-21 23:00:00,2019-10-21 00:00:00,LABORABLE
22,10,2019,1,165,222,387,2019-10-22 00:00:00,2019-10-22 00:00:00,LABORABLE
22,10,2019,2,100,195,295,2019-10-22 01:00:00,2019-10-22 00:00:00,LABORABLE
22,10,2019,3,81,126,207,2019-10-22 02:00:00,2019-10-22 00:00:00,LABORABLE
22,10,2019,4,66,98,164,2019-10-22 03:00:00,2019-10-22 00:00:00,LABORABLE
22,10,2019,5,96,87,183,2019-10-22 04:00:00,2019-10-22 00:00:00,LABORABLE
22,10,2019,6,173,176,349,2019-10-22 05:00:00,2019-10-22 00:00:00,LABORABLE
22,10,2019,7,431,432,863,2019-10-22 06:00:00,2019-10-22 00:00:00,LABORABLE
22,10,2019,8,670,677,1347,2019-10-22 07:00:00,2019-10-22 00:00:00,LABORABLE
22,10,2019,9,698,727,1425,2019-10-22 08:00:00,2019-10-22 00:00:00,LABORABLE
22,10,2019,10,619,744,1363,2019-10-22 09:00:00,2019-10-22 00:00:00,LABORABLE
22,10,2019,11,572,564,1136,2019-10-22 10:00:00,2019-10-22 00:00:00,LABORABLE
22,10,2019,12,611,678,1289,2019-10-22 11:00:00,2019-10-22 00:00:00,LABORABLE
22,10,2019,13,654,727,1381,2019-10-22 12:00:00,2019-10-22 00:00:00,LABORABLE
22,10,2019,14,651,811,1462,2019-10-22 13:00:00,2019-10-22 00:00:00,LABORABLE
22,10,2019,15,669,656,1325,2019-10-22 14:00:00,2019-10-22 00:00:00,LABORABLE
22,10,2019,16,589,598,1187,2019-10-22 15:00:00,2019-10-22 00:00:00,LABORABLE
22,10,2019,17,677,739,1416,2019-10-22 16:00:00,2019-10-22 00:00:00,LABORABLE
22,10,2019,18,693,771,1464,2019-10-22 17:00:00,2019-10-22 00:00:00,LABORABLE
22,10,2019,19,650,801,1451,2019-10-22 18:00:00,2019-10-22 00:00:00,LABORABLE
22,10,2019,20,662,793,1455,2019-10-22 19:00:00,2019-10-22 00:00:00,LABORABLE
22,10,2019,21,627,682,1309,2019-10-22 20:00:00,2019-10-22 00:00:00,LABORABLE
22,10,2019,22,494,577,1071,2019-10-22 21:00:00,2019-10-22 00:00:00,LABORABLE
22,10,2019,23,389,431,820,2019-10-22 22:00:00,2019-10-22 00:00:00,LABORABLE
22,10,2019,24,280,342,622,2019-10-22 23:00:00,2019-10-22 00:00:00,LABORABLE
23,10,2019,1,177,255,432,2019-10-23 00:00:00,2019-10-23 00:00:00,LABORABLE
23,10,2019,2,126,186,312,2019-10-23 01:00:00,2019-10-23 00:00:00,LABORABLE
23,10,2019,3,61,114,175,2019-10-23 02:00:00,2019-10-23 00:00:00,LABORABLE
23,10,2019,4,68,100,168,2019-10-23 03:00:00,2019-10-23 00:00:00,LABORABLE
23,10,2019,5,81,116,197,2019-10-23 04:00:00,2019-10-23 00:00:00,LABORABLE
23,10,2019,6,177,150,327,2019-10-23 05:00:00,2019-10-23 00:00:00,LABORABLE
23,10,2019,7,441,442,883,2019-10-23 06:00:00,2019-10-23 00:00:00,LABORABLE
23,10,2019,8,581,539,1120,2019-10-23 07:00:00,2019-10-23 00:00:00,LABORABLE
23,10,2019,9,741,709,1450,2019-10-23 08:00:00,2019-10-23 00:00:00,LABORABLE
23,10,2019,10,666,764,1430,2019-10-23 09:00:00,2019-10-23 00:00:00,LABORABLE
23,10,2019,11,499,692,1191,2019-10-23 10:00:00,2019-10-23 00:00:00,LABORABLE
23,10,2019,12,551,641,1192,2019-10-23 11:00:00,2019-10-23 00:00:00,LABORABLE
23,10,2019,13,596,679,1275,2019-10-23 12:00:00,2019-10-23 00:00:00,LABORABLE
23,10,2019,14,609,693,1302,2019-10-23 13:00:00,2019-10-23 00:00:00,LABORABLE
23,10,2019,15,723,700,1423,2019-10-23 14:00:00,2019-10-23 00:00:00,LABORABLE
23,10,2019,16,653,639,1292,2019-10-23 15:00:00,2019-10-23 00:00:00,LABORABLE
23,10,2019,17,658,797,1455,2019-10-23 16:00:00,2019-10-23 00:00:00,LABORABLE
23,10,2019,18,713,785,1498,2019-10-23 17:00:00,2019-10-23 00:00:00,LABORABLE
23,10,2019,19,695,777,1472,2019-10-23 18:00:00,2019-10-23 00:00:00,LABORABLE
23,10,2019,20,684,759,1443,2019-10-23 19:00:00,2019-10-23 00:00:00,LABORABLE
23,10,2019,21,691,731,1422,2019-10-23 20:00:00,2019-10-23 00:00:00,LABORABLE
23,10,2019,22,536,594,1130,2019-10-23 21:00:00,2019-10-23 00:00:00,LABORABLE
23,10,2019,23,443,467,910,2019-10-23 22:00:00,2019-10-23 00:00:00,LABORABLE
23,10,2019,24,282,324,606,2019-10-23 23:00:00,2019-10-23 00:00:00,LABORABLE
24,10,2019,1,209,264,473,2019-10-24 00:00:00,2019-10-24 00:00:00,LABORABLE
24,10,2019,2,132,201,333,2019-10-24 01:00:00,2019-10-24 00:00:00,LABORABLE
24,10,2019,3,93,144,237,2019-10-24 02:00:00,2019-10-24 00:00:00,LABORABLE
24,10,2019,4,90,99,189,2019-10-24 03:00:00,2019-10-24 00:00:00,LABORABLE
24,10,2019,5,63,84,147,2019-10-24 04:00:00,2019-10-24 00:00:00,LABORABLE
24,10,2019,6,165,155,320,2019-10-24 05:00:00,2019-10-24 00:00:00,LABORABLE
24,10,2019,7,434,480,914,2019-10-24 06:00:00,2019-10-24 00:00:00,LABORABLE
24,10,2019,8,672,622,1294,2019-10-24 07:00:00,2019-10-24 00:00:00,LABORABLE
24,10,2019,9,704,687,1391,2019-10-24 08:00:00,2019-10-24 00:00:00,LABORABLE
24,10,2019,10,626,690,1316,2019-10-24 09:00:00,2019-10-24 00:00:00,LABORABLE
24,10,2019,11,593,608,1201,2019-10-24 10:00:00,2019-10-24 00:00:00,LABORABLE
24,10,2019,12,606,682,1288,2019-10-24 11:00:00,2019-10-24 00:00:00,LABORABLE
24,10,2019,13,660,746,1406,2019-10-24 12:00:00,2019-10-24 00:00:00,LABORABLE
24,10,2019,14,654,722,1376,2019-10-24 13:00:00,2019-10-24 00:00:00,LABORABLE
24,10,2019,15,679,683,1362,2019-10-24 14:00:00,2019-10-24 00:00:00,LABORABLE
24,10,2019,16,642,675,1317,2019-10-24 15:00:00,2019-10-24 00:00:00,LABORABLE
24,10,2019,17,669,724,1393,2019-10-24 16:00:00,2019-10-24 00:00:00,LABORABLE
24,10,2019,18,751,788,1539,2019-10-24 17:00:00,2019-10-24 00:00:00,LABORABLE
24,10,2019,19,769,756,1525,2019-10-24 18:00:00,2019-10-24 00:00:00,LABORABLE
24,10,2019,20,696,796,1492,2019-10-24 19:00:00,2019-10-24 00:00:00,LABORABLE
24,10,2019,21,703,753,1456,2019-10-24 20:00:00,2019-10-24 00:00:00,LABORABLE
24,10,2019,22,612,641,1253,2019-10-24 21:00:00,2019-10-24 00:00:00,LABORABLE
24,10,2019,23,482,526,1008,2019-10-24 22:00:00,2019-10-24 00:00:00,LABORABLE
24,10,2019,24,305,387,692,2019-10-24 23:00:00,2019-10-24 00:00:00,LABORABLE
25,10,2019,1,206,317,523,2019-10-25 00:00:00,2019-10-25 00:00:00,LABORABLE
25,10,2019,2,128,228,356,2019-10-25 01:00:00,2019-10-25 00:00:00,LABORABLE
25,10,2019,3,119,181,300,2019-10-25 02:00:00,2019-10-25 00:00:00,LABORABLE
25,10,2019,4,83,160,243,2019-10-25 03:00:00,2019-10-25 00:00:00,LABORABLE
25,10,2019,5,110,120,230,2019-10-25 04:00:00,2019-10-25 00:00:00,LABORABLE
25,10,2019,6,159,175,334,2019-10-25 05:00:00,2019-10-25 00:00:00,LABORABLE
25,10,2019,7,477,465,942,2019-10-25 06:00:00,2019-10-25 00:00:00,LABORABLE
25,10,2019,8,654,660,1314,2019-10-25 07:00:00,2019-10-25 00:00:00,LABORABLE
25,10,2019,9,702,662,1364,2019-10-25 08:00:00,2019-10-25 00:00:00,LABORABLE
25,10,2019,10,646,650,1296,2019-10-25 09:00:00,2019-10-25 00:00:00,LABORABLE
25,10,2019,11,603,614,1217,2019-10-25 10:00:00,2019-10-25 00:00:00,LABORABLE
25,10,2019,12,592,735,1327,2019-10-25 11:00:00,2019-10-25 00:00:00,LABORABLE
25,10,2019,13,644,744,1388,2019-10-25 12:00:00,2019-10-25 00:00:00,LABORABLE
25,10,2019,14,673,777,1450,2019-10-25 13:00:00,2019-10-25 00:00:00,LABORABLE
25,10,2019,15,724,743,1467,2019-10-25 14:00:00,2019-10-25 00:00:00,LABORABLE
25,10,2019,16,728,734,1462,2019-10-25 15:00:00,2019-10-25 00:00:00,LABORABLE
25,10,2019,17,724,742,1466,2019-10-25 16:00:00,2019-10-25 00:00:00,LABORABLE
25,10,2019,18,661,808,1469,2019-10-25 17:00:00,2019-10-25 00:00:00,LABORABLE
25,10,2019,19,697,776,1473,2019-10-25 18:00:00,2019-10-25 00:00:00,LABORABLE
25,10,2019,20,705,807,1512,2019-10-25 19:00:00,2019-10-25 00:00:00,LABORABLE
25,10,2019,21,728,872,1600,2019-10-25 20:00:00,2019-10-25 00:00:00,LABORABLE
25,10,2019,22,713,736,1449,2019-10-25 21:00:00,2019-10-25 00:00:00,LABORABLE
25,10,2019,23,533,609,1142,2019-10-25 22:00:00,2019-10-25 00:00:00,LABORABLE
25,10,2019,24,449,506,955,2019-10-25 23:00:00,2019-10-25 00:00:00,LABORABLE
26,10,2019,1,160,245,405,2019-10-26 00:00:00,2019-10-26 00:00:00,LABORABLE
26,10,2019,2,109,203,312,2019-10-26 01:00:00,2019-10-26 00:00:00,LABORABLE
26,10,2019,3,69,126,195,2019-10-26 02:00:00,2019-10-26 00:00:00,LABORABLE
26,10,2019,4,44,99,143,2019-10-26 03:00:00,2019-10-26 00:00:00,LABORABLE
26,10,2019,5,68,107,175,2019-10-26 04:00:00,2019-10-26 00:00:00,LABORABLE
26,10,2019,6,133,156,289,2019-10-26 05:00:00,2019-10-26 00:00:00,LABORABLE
26,10,2019,7,377,446,823,2019-10-26 06:00:00,2019-10-26 00:00:00,LABORABLE
26,10,2019,8,591,681,1272,2019-10-26 07:00:00,2019-10-26 00:00:00,LABORABLE
26,10,2019,9,602,708,1310,2019-10-26 08:00:00,2019-10-26 00:00:00,LABORABLE
26,10,2019,10,607,757,1364,2019-10-26 09:00:00,2019-10-26 00:00:00,LABORABLE
26,10,2019,11,392,687,1079,2019-10-26 10:00:00,2019-10-26 00:00:00,LABORABLE
26,10,2019,12,560,717,1277,2019-10-26 11:00:00,2019-10-26 00:00:00,LABORABLE
26,10,2019,13,604,763,1367,2019-10-26 12:00:00,2019-10-26 00:00:00,LABORABLE
26,10,2019,14,582,754,1336,2019-10-26 13:00:00,2019-10-26 00:00:00,LABORABLE
26,10,2019,15,613,743,1356,2019-10-26 14:00:00,2019-10-26 00:00:00,LABORABLE
26,10,2019,16,595,742,1337,2019-10-26 15:00:00,2019-10-26 00:00:00,LABORABLE
26,10,2019,17,599,707,1306,2019-10-26 16:00:00,2019-10-26 00:00:00,LABORABLE
26,10,2019,18,654,837,1491,2019-10-26 17:00:00,2019-10-26 00:00:00,LABORABLE
26,10,2019,19,690,827,1517,2019-10-26 18:00:00,2019-10-26 00:00:00,LABORABLE
26,10,2019,20,669,837,1506,2019-10-26 19:00:00,2019-10-26 00:00:00,LABORABLE
26,10,2019,21,659,791,1450,2019-10-26 20:00:00,2019-10-26 00:00:00,LABORABLE
26,10,2019,22,559,685,1244,2019-10-26 21:00:00,2019-10-26 00:00:00,LABORABLE
26,10,2019,23,363,502,865,2019-10-26 22:00:00,2019-10-26 00:00:00,LABORABLE
26,10,2019,24,244,347,591,2019-10-26 23:00:00,2019-10-26 00:00:00,LABORABLE
27,10,2019,1,200,273,473,2019-10-27 00:00:00,2019-10-27 00:00:00,LABORABLE
27,10,2019,2,118,217,335,2019-10-27 01:00:00,2019-10-27 00:00:00,LABORABLE
27,10,2019,3,69,141,210,2019-10-27 02:00:00,2019-10-27 00:00:00,LABORABLE
27,10,2019,4,64,110,174,2019-10-27 03:00:00,2019-10-27 00:00:00,LABORABLE
27,10,2019,5,67,134,201,2019-10-27 04:00:00,2019-10-27 00:00:00,LABORABLE
27,10,2019,6,155,187,342,2019-10-27 05:00:00,2019-10-27 00:00:00,LABORABLE
27,10,2019,7,357,470,827,2019-10-27 06:00:00,2019-10-27 00:00:00,LABORABLE
27,10,2019,8,609,638,1247,2019-10-27 07:00:00,2019-10-27 00:00:00,LABORABLE
27,10,2019,9,597,693,1290,2019-10-27 08:00:00,2019-10-27 00:00:00,LABORABLE
27,10,2019,10,473,769,1242,2019-10-27 09:00:00,2019-10-27 00:00:00,LABORABLE
27,10,2019,11,508,698,1206,2019-10-27 10:00:00,2019-10-27 00:00:00,LABORABLE
27,10,2019,12,413,534,947,2019-10-27 11:00:00,2019-10-27 00:00:00,LABORABLE
27,10,2019,13,649,733,1382,2019-10-27 12:00:00,2019-10-27 00:00:00,LABORABLE
27,10,2019,14,635,766,1401,2019-10-27 13:00:00,2019-10-27 00:00:00,LABORABLE
27,10,2019,15,636,763,1399,2019-10-27 14:00:00,2019-10-27 00:00:00,LABORABLE
27,10,2019,16,578,746,1324,2019-10-27 15:00:00,2019-10-27 00:00:00,LABORABLE
27,10,2019,17,587,834,1421,2019-10-27 16:00:00,2019-10-27 00:00:00,LABORABLE
27,10,2019,18,708,855,1563,2019-10-27 17:00:00,2019-10-27 00:00:00,LABORABLE
27,10,2019,19,678,859,1537,2019-10-27 18:00:00,2019-10-27 00:00:00,LABORABLE
27,10,2019,20,687,867,1554,2019-10-27 19:00:00,2019-10-27 00:00:00,LABORABLE
27,10,2019,21,660,916,1576,2019-10-27 20:00:00,2019-10-27 00:00:00,LABORABLE
27,10,2019,22,608,803,1411,2019-10-27 21:00:00,2019-10-27 00:00:00,LABORABLE
27,10,2019,23,519,635,1154,2019-10-27 22:00:00,2019-10-27 00:00:00,LABORABLE
27,10,2019,24,348,503,851,2019-10-27 23:00:00,2019-10-27 00:00:00,LABORABLE
28,10,2019,1,198,259,457,2019-10-28 00:00:00,2019-10-28 00:00:00,LABORABLE
28,10,2019,2,127,186,313,2019-10-28 01:00:00,2019-10-28 00:00:00,LABORABLE
28,10,2019,3,89,149,238,2019-10-28 02:00:00,2019-10-28 00:00:00,LABORABLE
28,10,2019,4,81,121,202,2019-10-28 03:00:00,2019-10-28 00:00:00,LABORABLE
28,10,2019,5,62,103,165,2019-10-28 04:00:00,2019-10-28 00:00:00,LABORABLE
28,10,2019,6,175,153,328,2019-10-28 05:00:00,2019-10-28 00:00:00,LABORABLE
28,10,2019,7,473,479,952,2019-10-28 06:00:00,2019-10-28 00:00:00,LABORABLE
28,10,2019,8,688,663,1351,2019-10-28 07:00:00,2019-10-28 00:00:00,LABORABLE
28,10,2019,9,690,759,1449,2019-10-28 08:00:00,2019-10-28 00:00:00,LABORABLE
28,10,2019,10,684,700,1384,2019-10-28 09:00:00,2019-10-28 00:00:00,LABORABLE
28,10,2019,11,515,685,1200,2019-10-28 10:00:00,2019-10-28 00:00:00,LABORABLE
28,10,2019,12,458,518,976,2019-10-28 11:00:00,2019-10-28 00:00:00,LABORABLE
28,10,2019,13,631,694,1325,2019-10-28 12:00:00,2019-10-28 00:00:00,LABORABLE
28,10,2019,14,674,709,1383,2019-10-28 13:00:00,2019-10-28 00:00:00,LABORABLE
28,10,2019,15,675,671,1346,2019-10-28 14:00:00,2019-10-28 00:00:00,LABORABLE
28,10,2019,16,692,705,1397,2019-10-28 15:00:00,2019-10-28 00:00:00,LABORABLE
28,10,2019,17,659,730,1389,2019-10-28 16:00:00,2019-10-28 00:00:00,LABORABLE
28,10,2019,18,730,775,1505,2019-10-28 17:00:00,2019-10-28 00:00:00,LABORABLE
28,10,2019,19,675,787,1462,2019-10-28 18:00:00,2019-10-28 00:00:00,LABORABLE
28,10,2019,20,608,759,1367,2019-10-28 19:00:00,2019-10-28 00:00:00,LABORABLE
28,10,2019,21,590,676,1266,2019-10-28 20:00:00,2019-10-28 00:00:00,LABORABLE
28,10,2019,22,492,579,1071,2019-10-28 21:00:00,2019-10-28 00:00:00,LABORABLE
28,10,2019,23,416,457,873,2019-10-28 22:00:00,2019-10-28 00:00:00,LABORABLE
28,10,2019,24,256,311,567,2019-10-28 23:00:00,2019-10-28 00:00:00,LABORABLE
29,10,2019,1,164,211,375,2019-10-29 00:00:00,2019-10-29 00:00:00,LABORABLE
29,10,2019,2,92,150,242,2019-10-29 01:00:00,2019-10-29 00:00:00,LABORABLE
29,10,2019,3,92,125,217,2019-10-29 02:00:00,2019-10-29 00:00:00,LABORABLE
29,10,2019,4,87,110,197,2019-10-29 03:00:00,2019-10-29 00:00:00,LABORABLE
29,10,2019,5,99,87,186,2019-10-29 04:00:00,2019-10-29 00:00:00,LABORABLE
29,10,2019,6,117,177,294,2019-10-29 05:00:00,2019-10-29 00:00:00,LABORABLE
29,10,2019,7,461,463,924,2019-10-29 06:00:00,2019-10-29 00:00:00,LABORABLE
29,10,2019,8,665,622,1287,2019-10-29 07:00:00,2019-10-29 00:00:00,LABORABLE
29,10,2019,9,720,714,1434,2019-10-29 08:00:00,2019-10-29 00:00:00,LABORABLE
29,10,2019,10,538,577,1115,2019-10-29 09:00:00,2019-10-29 00:00:00,LABORABLE
29,10,2019,11,571,623,1194,2019-10-29 10:00:00,2019-10-29 00:00:00,LABORABLE
29,10,2019,12,673,735,1408,2019-10-29 11:00:00,2019-10-29 00:00:00,LABORABLE
29,10,2019,13,579,724,1303,2019-10-29 12:00:00,2019-10-29 00:00:00,LABORABLE
29,10,2019,14,678,772,1450,2019-10-29 13:00:00,2019-10-29 00:00:00,LABORABLE
29,10,2019,15,673,696,1369,2019-10-29 14:00:00,2019-10-29 00:00:00,LABORABLE
29,10,2019,16,671,644,1315,2019-10-29 15:00:00,2019-10-29 00:00:00,LABORABLE
29,10,2019,17,738,736,1474,2019-10-29 16:00:00,2019-10-29 00:00:00,LABORABLE
29,10,2019,18,719,774,1493,2019-10-29 17:00:00,2019-10-29 00:00:00,LABORABLE
29,10,2019,19,716,834,1550,2019-10-29 18:00:00,2019-10-29 00:00:00,LABORABLE
29,10,2019,20,645,784,1429,2019-10-29 19:00:00,2019-10-29 00:00:00,LABORABLE
29,10,2019,21,636,690,1326,2019-10-29 20:00:00,2019-10-29 00:00:00,LABORABLE
29,10,2019,22,504,617,1121,2019-10-29 21:00:00,2019-10-29 00:00:00,LABORABLE
29,10,2019,23,391,405,796,2019-10-29 22:00:00,2019-10-29 00:00:00,LABORABLE
29,10,2019,24,258,366,624,2019-10-29 23:00:00,2019-10-29 00:00:00,LABORABLE
30,10,2019,1,190,241,431,2019-10-30 00:00:00,2019-10-30 00:00:00,LABORABLE
30,10,2019,2,107,192,299,2019-10-30 01:00:00,2019-10-30 00:00:00,LABORABLE
30,10,2019,3,85,132,217,2019-10-30 02:00:00,2019-10-30 00:00:00,LABORABLE
30,10,2019,4,78,121,199,2019-10-30 03:00:00,2019-10-30 00:00:00,LABORABLE
30,10,2019,5,72,85,157,2019-10-30 04:00:00,2019-10-30 00:00:00,LABORABLE
30,10,2019,6,119,154,273,2019-10-30 05:00:00,2019-10-30 00:00:00,LABORABLE
30,10,2019,7,423,455,878,2019-10-30 06:00:00,2019-10-30 00:00:00,LABORABLE
30,10,2019,8,710,682,1392,2019-10-30 07:00:00,2019-10-30 00:00:00,LABORABLE
30,10,2019,9,730,684,1414,2019-10-30 08:00:00,2019-10-30 00:00:00,LABORABLE
30,10,2019,10,709,710,1419,2019-10-30 09:00:00,2019-10-30 00:00:00,LABORABLE
30,10,2019,11,605,703,1308,2019-10-30 10:00:00,2019-10-30 00:00:00,LABORABLE
30,10,2019,12,647,779,1426,2019-10-30 11:00:00,2019-10-30 00:00:00,LABORABLE
30,10,2019,13,643,701,1344,2019-10-30 12:00:00,2019-10-30 00:00:00,LABORABLE
30,10,2019,14,648,763,1411,2019-10-30 13:00:00,2019-10-30 00:00:00,LABORABLE
30,10,2019,15,677,710,1387,2019-10-30 14:00:00,2019-10-30 00:00:00,LABORABLE
30,10,2019,16,661,618,1279,2019-10-30 15:00:00,2019-10-30 00:00:00,LABORABLE
30,10,2019,17,721,765,1486,2019-10-30 16:00:00,2019-10-30 00:00:00,LABORABLE
30,10,2019,18,733,786,1519,2019-10-30 17:00:00,2019-10-30 00:00:00,LABORABLE
30,10,2019,19,727,762,1489,2019-10-30 18:00:00,2019-10-30 00:00:00,LABORABLE
30,10,2019,20,619,803,1422,2019-10-30 19:00:00,2019-10-30 00:00:00,LABORABLE
30,10,2019,21,694,749,1443,2019-10-30 20:00:00,2019-10-30 00:00:00,LABORABLE
30,10,2019,22,572,640,1212,2019-10-30 21:00:00,2019-10-30 00:00:00,LABORABLE
30,10,2019,23,434,472,906,2019-10-30 22:00:00,2019-10-30 00:00:00,LABORABLE
30,10,2019,24,333,370,703,2019-10-30 23:00:00,2019-10-30 00:00:00,LABORABLE
31,10,2019,1,207,289,496,2019-10-31 00:00:00,2019-10-31 00:00:00,LABORABLE
31,10,2019,2,188,219,407,2019-10-31 01:00:00,2019-10-31 00:00:00,LABORABLE
31,10,2019,3,130,156,286,2019-10-31 02:00:00,2019-10-31 00:00:00,LABORABLE
31,10,2019,4,89,117,206,2019-10-31 03:00:00,2019-10-31 00:00:00,LABORABLE
31,10,2019,5,104,120,224,2019-10-31 04:00:00,2019-10-31 00:00:00,LABORABLE
31,10,2019,6,191,174,365,2019-10-31 05:00:00,2019-10-31 00:00:00,LABORABLE
31,10,2019,7,429,437,866,2019-10-31 06:00:00,2019-10-31 00:00:00,LABORABLE
31,10,2019,8,620,591,1211,2019-10-31 07:00:00,2019-10-31 00:00:00,LABORABLE
31,10,2019,9,604,644,1248,2019-10-31 08:00:00,2019-10-31 00:00:00,LABORABLE
31,10,2019,10,665,634,1299,2019-10-31 09:00:00,2019-10-31 00:00:00,LABORABLE
31,10,2019,11,626,691,1317,2019-10-31 10:00:00,2019-10-31 00:00:00,LABORABLE
31,10,2019,12,550,598,1148,2019-10-31 11:00:00,2019-10-31 00:00:00,LABORABLE
31,10,2019,13,700,746,1446,2019-10-31 12:00:00,2019-10-31 00:00:00,LABORABLE
31,10,2019,14,709,771,1480,2019-10-31 13:00:00,2019-10-31 00:00:00,LABORABLE
31,10,2019,15,711,733,1444,2019-10-31 14:00:00,2019-10-31 00:00:00,LABORABLE
31,10,2019,16,636,658,1294,2019-10-31 15:00:00,2019-10-31 00:00:00,LABORABLE
31,10,2019,17,711,699,1410,2019-10-31 16:00:00,2019-10-31 00:00:00,LABORABLE
31,10,2019,18,704,815,1519,2019-10-31 17:00:00,2019-10-31 00:00:00,LABORABLE
31,10,2019,19,705,831,1536,2019-10-31 18:00:00,2019-10-31 00:00:00,LABORABLE
31,10,2019,20,699,733,1432,2019-10-31 19:00:00,2019-10-31 00:00:00,LABORABLE
31,10,2019,21,696,793,1489,2019-10-31 20:00:00,2019-10-31 00:00:00,LABORABLE
31,10,2019,22,673,702,1375,2019-10-31 21:00:00,2019-10-31 00:00:00,LABORABLE
31,10,2019,23,566,490,1056,2019-10-31 22:00:00,2019-10-31 00:00:00,LABORABLE
31,10,2019,24,435,505,940,2019-10-31 23:00:00,2019-10-31 00:00:00,LABORABLE
1,11,2019,1,305,439,744,2019-11-01 00:00:00,2019-01-11 00:00:00,FESTIVO
1,11,2019,2,195,353,548,2019-11-01 01:00:00,2019-01-11 00:00:00,FESTIVO
1,11,2019,3,160,296,456,2019-11-01 02:00:00,2019-01-11 00:00:00,FESTIVO
1,11,2019,4,127,227,354,2019-11-01 03:00:00,2019-01-11 00:00:00,FESTIVO
1,11,2019,5,124,205,329,2019-11-01 04:00:00,2019-01-11 00:00:00,FESTIVO
1,11,2019,6,127,204,331,2019-11-01 05:00:00,2019-01-11 00:00:00,FESTIVO
1,11,2019,7,200,292,492,2019-11-01 06:00:00,2019-01-11 00:00:00,FESTIVO
1,11,2019,8,198,308,506,2019-11-01 07:00:00,2019-01-11 00:00:00,FESTIVO
1,11,2019,9,249,339,588,2019-11-01 08:00:00,2019-01-11 00:00:00,FESTIVO
1,11,2019,10,339,477,816,2019-11-01 09:00:00,2019-01-11 00:00:00,FESTIVO
1,11,2019,11,444,558,1002,2019-11-01 10:00:00,2019-01-11 00:00:00,FESTIVO
1,11,2019,12,507,681,1188,2019-11-01 11:00:00,2019-01-11 00:00:00,FESTIVO
1,11,2019,13,547,704,1251,2019-11-01 12:00:00,2019-01-11 00:00:00,FESTIVO
1,11,2019,14,574,710,1284,2019-11-01 13:00:00,2019-01-11 00:00:00,FESTIVO
1,11,2019,15,488,690,1178,2019-11-01 14:00:00,2019-01-11 00:00:00,FESTIVO
1,11,2019,16,401,637,1038,2019-11-01 15:00:00,2019-01-11 00:00:00,FESTIVO
1,11,2019,17,436,727,1163,2019-11-01 16:00:00,2019-01-11 00:00:00,FESTIVO
1,11,2019,18,544,776,1320,2019-11-01 17:00:00,2019-01-11 00:00:00,FESTIVO
1,11,2019,19,597,776,1373,2019-11-01 18:00:00,2019-01-11 00:00:00,FESTIVO
1,11,2019,20,558,791,1349,2019-11-01 19:00:00,2019-01-11 00:00:00,FESTIVO
1,11,2019,21,429,642,1071,2019-11-01 20:00:00,2019-01-11 00:00:00,FESTIVO
1,11,2019,22,428,550,978,2019-11-01 21:00:00,2019-01-11 00:00:00,FESTIVO
1,11,2019,23,324,450,774,2019-11-01 22:00:00,2019-01-11 00:00:00,FESTIVO
1,11,2019,24,210,322,532,2019-11-01 23:00:00,2019-01-11 00:00:00,FESTIVO
2,11,2019,1,131,230,361,2019-11-02 00:00:00,2019-02-11 00:00:00,LABORABLE
2,11,2019,2,87,169,256,2019-11-02 01:00:00,2019-02-11 00:00:00,LABORABLE
2,11,2019,3,53,127,180,2019-11-02 02:00:00,2019-02-11 00:00:00,LABORABLE
2,11,2019,4,60,93,153,2019-11-02 03:00:00,2019-02-11 00:00:00,LABORABLE
2,11,2019,5,60,95,155,2019-11-02 04:00:00,2019-02-11 00:00:00,LABORABLE
2,11,2019,6,147,176,323,2019-11-02 05:00:00,2019-02-11 00:00:00,LABORABLE
2,11,2019,7,358,462,820,2019-11-02 06:00:00,2019-02-11 00:00:00,LABORABLE
2,11,2019,8,600,676,1276,2019-11-02 07:00:00,2019-02-11 00:00:00,LABORABLE
2,11,2019,9,559,709,1268,2019-11-02 08:00:00,2019-02-11 00:00:00,LABORABLE
2,11,2019,10,636,749,1385,2019-11-02 09:00:00,2019-02-11 00:00:00,LABORABLE
2,11,2019,11,542,742,1284,2019-11-02 10:00:00,2019-02-11 00:00:00,LABORABLE
2,11,2019,12,395,725,1120,2019-11-02 11:00:00,2019-02-11 00:00:00,LABORABLE
2,11,2019,13,587,804,1391,2019-11-02 12:00:00,2019-02-11 00:00:00,LABORABLE
2,11,2019,14,591,788,1379,2019-11-02 13:00:00,2019-02-11 00:00:00,LABORABLE
2,11,2019,15,558,766,1324,2019-11-02 14:00:00,2019-02-11 00:00:00,LABORABLE
2,11,2019,16,582,702,1284,2019-11-02 15:00:00,2019-02-11 00:00:00,LABORABLE
2,11,2019,17,607,789,1396,2019-11-02 16:00:00,2019-02-11 00:00:00,LABORABLE
2,11,2019,18,711,816,1527,2019-11-02 17:00:00,2019-02-11 00:00:00,LABORABLE
2,11,2019,19,740,854,1594,2019-11-02 18:00:00,2019-02-11 00:00:00,LABORABLE
2,11,2019,20,606,810,1416,2019-11-02 19:00:00,2019-02-11 00:00:00,LABORABLE
2,11,2019,21,618,770,1388,2019-11-02 20:00:00,2019-02-11 00:00:00,LABORABLE
2,11,2019,22,523,693,1216,2019-11-02 21:00:00,2019-02-11 00:00:00,LABORABLE
2,11,2019,23,378,489,867,2019-11-02 22:00:00,2019-02-11 00:00:00,LABORABLE
2,11,2019,24,270,352,622,2019-11-02 23:00:00,2019-02-11 00:00:00,LABORABLE
3,11,2019,1,166,289,455,2019-11-03 00:00:00,2019-03-11 00:00:00,LABORABLE
3,11,2019,2,93,208,301,2019-11-03 01:00:00,2019-03-11 00:00:00,LABORABLE
3,11,2019,3,73,156,229,2019-11-03 02:00:00,2019-03-11 00:00:00,LABORABLE
3,11,2019,4,65,111,176,2019-11-03 03:00:00,2019-03-11 00:00:00,LABORABLE
3,11,2019,5,62,125,187,2019-11-03 04:00:00,2019-03-11 00:00:00,LABORABLE
3,11,2019,6,131,186,317,2019-11-03 05:00:00,2019-03-11 00:00:00,LABORABLE
3,11,2019,7,344,434,778,2019-11-03 06:00:00,2019-03-11 00:00:00,LABORABLE
3,11,2019,8,585,677,1262,2019-11-03 07:00:00,2019-03-11 00:00:00,LABORABLE
3,11,2019,9,608,705,1313,2019-11-03 08:00:00,2019-03-11 00:00:00,LABORABLE
3,11,2019,10,505,644,1149,2019-11-03 09:00:00,2019-03-11 00:00:00,LABORABLE
3,11,2019,11,583,662,1245,2019-11-03 10:00:00,2019-03-11 00:00:00,LABORABLE
3,11,2019,12,590,740,1330,2019-11-03 11:00:00,2019-03-11 00:00:00,LABORABLE
3,11,2019,13,599,811,1410,2019-11-03 12:00:00,2019-03-11 00:00:00,LABORABLE
3,11,2019,14,638,810,1448,2019-11-03 13:00:00,2019-03-11 00:00:00,LABORABLE
3,11,2019,15,683,790,1473,2019-11-03 14:00:00,2019-03-11 00:00:00,LABORABLE
3,11,2019,16,600,746,1346,2019-11-03 15:00:00,2019-03-11 00:00:00,LABORABLE
3,11,2019,17,629,682,1311,2019-11-03 16:00:00,2019-03-11 00:00:00,LABORABLE
3,11,2019,18,719,795,1514,2019-11-03 17:00:00,2019-03-11 00:00:00,LABORABLE
3,11,2019,19,704,848,1552,2019-11-03 18:00:00,2019-03-11 00:00:00,LABORABLE
3,11,2019,20,632,951,1583,2019-11-03 19:00:00,2019-03-11 00:00:00,LABORABLE
3,11,2019,21,614,835,1449,2019-11-03 20:00:00,2019-03-11 00:00:00,LABORABLE
3,11,2019,22,551,811,1362,2019-11-03 21:00:00,2019-03-11 00:00:00,LABORABLE
3,11,2019,23,444,607,1051,2019-11-03 22:00:00,2019-03-11 00:00:00,LABORABLE
3,11,2019,24,370,515,885,2019-11-03 23:00:00,2019-03-11 00:00:00,LABORABLE
4,11,2019,1,222,291,513,2019-11-04 00:00:00,2019-04-11 00:00:00,LABORABLE
4,11,2019,2,125,207,332,2019-11-04 01:00:00,2019-04-11 00:00:00,LABORABLE
4,11,2019,3,87,150,237,2019-11-04 02:00:00,2019-04-11 00:00:00,LABORABLE
4,11,2019,4,66,124,190,2019-11-04 03:00:00,2019-04-11 00:00:00,LABORABLE
4,11,2019,5,60,115,175,2019-11-04 04:00:00,2019-04-11 00:00:00,LABORABLE
4,11,2019,6,173,167,340,2019-11-04 05:00:00,2019-04-11 00:00:00,LABORABLE
4,11,2019,7,474,458,932,2019-11-04 06:00:00,2019-04-11 00:00:00,LABORABLE
4,11,2019,8,679,631,1310,2019-11-04 07:00:00,2019-04-11 00:00:00,LABORABLE
4,11,2019,9,722,703,1425,2019-11-04 08:00:00,2019-04-11 00:00:00,LABORABLE
4,11,2019,10,639,691,1330,2019-11-04 09:00:00,2019-04-11 00:00:00,LABORABLE
4,11,2019,11,598,702,1300,2019-11-04 10:00:00,2019-04-11 00:00:00,LABORABLE
4,11,2019,12,605,733,1338,2019-11-04 11:00:00,2019-04-11 00:00:00,LABORABLE
4,11,2019,13,622,744,1366,2019-11-04 12:00:00,2019-04-11 00:00:00,LABORABLE
4,11,2019,14,626,771,1397,2019-11-04 13:00:00,2019-04-11 00:00:00,LABORABLE
4,11,2019,15,638,712,1350,2019-11-04 14:00:00,2019-04-11 00:00:00,LABORABLE
4,11,2019,16,694,720,1414,2019-11-04 15:00:00,2019-04-11 00:00:00,LABORABLE
4,11,2019,17,638,761,1399,2019-11-04 16:00:00,2019-04-11 00:00:00,LABORABLE
4,11,2019,18,734,782,1516,2019-11-04 17:00:00,2019-04-11 00:00:00,LABORABLE
4,11,2019,19,675,794,1469,2019-11-04 18:00:00,2019-04-11 00:00:00,LABORABLE
4,11,2019,20,603,832,1435,2019-11-04 19:00:00,2019-04-11 00:00:00,LABORABLE
4,11,2019,21,650,726,1376,2019-11-04 20:00:00,2019-04-11 00:00:00,LABORABLE
4,11,2019,22,485,632,1117,2019-11-04 21:00:00,2019-04-11 00:00:00,LABORABLE
4,11,2019,23,386,469,855,2019-11-04 22:00:00,2019-04-11 00:00:00,LABORABLE
4,11,2019,24,231,328,559,2019-11-04 23:00:00,2019-04-11 00:00:00,LABORABLE
5,11,2019,1,136,227,363,2019-11-05 00:00:00,2019-05-11 00:00:00,LABORABLE
5,11,2019,2,88,162,250,2019-11-05 01:00:00,2019-05-11 00:00:00,LABORABLE
5,11,2019,3,86,126,212,2019-11-05 02:00:00,2019-05-11 00:00:00,LABORABLE
5,11,2019,4,65,105,170,2019-11-05 03:00:00,2019-05-11 00:00:00,LABORABLE
5,11,2019,5,78,96,174,2019-11-05 04:00:00,2019-05-11 00:00:00,LABORABLE
5,11,2019,6,180,187,367,2019-11-05 05:00:00,2019-05-11 00:00:00,LABORABLE
5,11,2019,7,429,455,884,2019-11-05 06:00:00,2019-05-11 00:00:00,LABORABLE
5,11,2019,8,672,617,1289,2019-11-05 07:00:00,2019-05-11 00:00:00,LABORABLE
5,11,2019,9,678,716,1394,2019-11-05 08:00:00,2019-05-11 00:00:00,LABORABLE
5,11,2019,10,655,764,1419,2019-11-05 09:00:00,2019-05-11 00:00:00,LABORABLE
5,11,2019,11,562,734,1296,2019-11-05 10:00:00,2019-05-11 00:00:00,LABORABLE
5,11,2019,12,598,711,1309,2019-11-05 11:00:00,2019-05-11 00:00:00,LABORABLE
5,11,2019,13,628,804,1432,2019-11-05 12:00:00,2019-05-11 00:00:00,LABORABLE
5,11,2019,14,660,744,1404,2019-11-05 13:00:00,2019-05-11 00:00:00,LABORABLE
5,11,2019,15,670,762,1432,2019-11-05 14:00:00,2019-05-11 00:00:00,LABORABLE
5,11,2019,16,678,692,1370,2019-11-05 15:00:00,2019-05-11 00:00:00,LABORABLE
5,11,2019,17,671,765,1436,2019-11-05 16:00:00,2019-05-11 00:00:00,LABORABLE
5,11,2019,18,737,769,1506,2019-11-05 17:00:00,2019-05-11 00:00:00,LABORABLE
5,11,2019,19,698,818,1516,2019-11-05 18:00:00,2019-05-11 00:00:00,LABORABLE
5,11,2019,20,631,768,1399,2019-11-05 19:00:00,2019-05-11 00:00:00,LABORABLE
5,11,2019,21,644,728,1372,2019-11-05 20:00:00,2019-05-11 00:00:00,LABORABLE
5,11,2019,22,531,630,1161,2019-11-05 21:00:00,2019-05-11 00:00:00,LABORABLE
5,11,2019,23,432,460,892,2019-11-05 22:00:00,2019-05-11 00:00:00,LABORABLE
5,11,2019,24,248,328,576,2019-11-05 23:00:00,2019-05-11 00:00:00,LABORABLE
6,11,2019,1,182,291,473,2019-11-06 00:00:00,2019-06-11 00:00:00,LABORABLE
6,11,2019,2,122,156,278,2019-11-06 01:00:00,2019-06-11 00:00:00,LABORABLE
6,11,2019,3,73,135,208,2019-11-06 02:00:00,2019-06-11 00:00:00,LABORABLE
6,11,2019,4,61,129,190,2019-11-06 03:00:00,2019-06-11 00:00:00,LABORABLE
6,11,2019,5,89,94,183,2019-11-06 04:00:00,2019-06-11 00:00:00,LABORABLE
6,11,2019,6,120,171,291,2019-11-06 05:00:00,2019-06-11 00:00:00,LABORABLE
6,11,2019,7,448,423,871,2019-11-06 06:00:00,2019-06-11 00:00:00,LABORABLE
6,11,2019,8,691,596,1287,2019-11-06 07:00:00,2019-06-11 00:00:00,LABORABLE
6,11,2019,9,667,676,1343,2019-11-06 08:00:00,2019-06-11 00:00:00,LABORABLE
6,11,2019,10,636,726,1362,2019-11-06 09:00:00,2019-06-11 00:00:00,LABORABLE
6,11,2019,11,459,628,1087,2019-11-06 10:00:00,2019-06-11 00:00:00,LABORABLE
6,11,2019,12,604,691,1295,2019-11-06 11:00:00,2019-06-11 00:00:00,LABORABLE
6,11,2019,13,644,681,1325,2019-11-06 12:00:00,2019-06-11 00:00:00,LABORABLE
6,11,2019,14,647,755,1402,2019-11-06 13:00:00,2019-06-11 00:00:00,LABORABLE
6,11,2019,15,664,750,1414,2019-11-06 14:00:00,2019-06-11 00:00:00,LABORABLE
6,11,2019,16,682,695,1377,2019-11-06 15:00:00,2019-06-11 00:00:00,LABORABLE
6,11,2019,17,686,746,1432,2019-11-06 16:00:00,2019-06-11 00:00:00,LABORABLE
6,11,2019,18,709,797,1506,2019-11-06 17:00:00,2019-06-11 00:00:00,LABORABLE
6,11,2019,19,719,801,1520,2019-11-06 18:00:00,2019-06-11 00:00:00,LABORABLE
6,11,2019,20,580,808,1388,2019-11-06 19:00:00,2019-06-11 00:00:00,LABORABLE
6,11,2019,21,675,785,1460,2019-11-06 20:00:00,2019-06-11 00:00:00,LABORABLE
6,11,2019,22,557,655,1212,2019-11-06 21:00:00,2019-06-11 00:00:00,LABORABLE
6,11,2019,23,419,471,890,2019-11-06 22:00:00,2019-06-11 00:00:00,LABORABLE
6,11,2019,24,286,394,680,2019-11-06 23:00:00,2019-06-11 00:00:00,LABORABLE
7,11,2019,1,223,256,479,2019-11-07 00:00:00,2019-07-11 00:00:00,LABORABLE
7,11,2019,2,129,176,305,2019-11-07 01:00:00,2019-07-11 00:00:00,LABORABLE
7,11,2019,3,82,150,232,2019-11-07 02:00:00,2019-07-11 00:00:00,LABORABLE
7,11,2019,4,82,114,196,2019-11-07 03:00:00,2019-07-11 00:00:00,LABORABLE
7,11,2019,5,84,94,178,2019-11-07 04:00:00,2019-07-11 00:00:00,LABORABLE
7,11,2019,6,170,149,319,2019-11-07 05:00:00,2019-07-11 00:00:00,LABORABLE
7,11,2019,7,457,456,913,2019-11-07 06:00:00,2019-07-11 00:00:00,LABORABLE
7,11,2019,8,655,637,1292,2019-11-07 07:00:00,2019-07-11 00:00:00,LABORABLE
7,11,2019,9,698,770,1468,2019-11-07 08:00:00,2019-07-11 00:00:00,LABORABLE
7,11,2019,10,672,695,1367,2019-11-07 09:00:00,2019-07-11 00:00:00,LABORABLE
7,11,2019,11,615,680,1295,2019-11-07 10:00:00,2019-07-11 00:00:00,LABORABLE
7,11,2019,12,488,638,1126,2019-11-07 11:00:00,2019-07-11 00:00:00,LABORABLE
7,11,2019,13,632,812,1444,2019-11-07 12:00:00,2019-07-11 00:00:00,LABORABLE
7,11,2019,14,624,805,1429,2019-11-07 13:00:00,2019-07-11 00:00:00,LABORABLE
7,11,2019,15,634,726,1360,2019-11-07 14:00:00,2019-07-11 00:00:00,LABORABLE
7,11,2019,16,692,651,1343,2019-11-07 15:00:00,2019-07-11 00:00:00,LABORABLE
7,11,2019,17,720,715,1435,2019-11-07 16:00:00,2019-07-11 00:00:00,LABORABLE
7,11,2019,18,628,809,1437,2019-11-07 17:00:00,2019-07-11 00:00:00,LABORABLE
7,11,2019,19,706,770,1476,2019-11-07 18:00:00,2019-07-11 00:00:00,LABORABLE
7,11,2019,20,681,821,1502,2019-11-07 19:00:00,2019-07-11 00:00:00,LABORABLE
7,11,2019,21,689,687,1376,2019-11-07 20:00:00,2019-07-11 00:00:00,LABORABLE
7,11,2019,22,569,660,1229,2019-11-07 21:00:00,2019-07-11 00:00:00,LABORABLE
7,11,2019,23,490,512,1002,2019-11-07 22:00:00,2019-07-11 00:00:00,LABORABLE
7,11,2019,24,288,367,655,2019-11-07 23:00:00,2019-07-11 00:00:00,LABORABLE
8,11,2019,1,213,343,556,2019-11-08 00:00:00,2019-08-11 00:00:00,LABORABLE
8,11,2019,2,138,192,330,2019-11-08 01:00:00,2019-08-11 00:00:00,LABORABLE
8,11,2019,3,107,176,283,2019-11-08 02:00:00,2019-08-11 00:00:00,LABORABLE
8,11,2019,4,86,157,243,2019-11-08 03:00:00,2019-08-11 00:00:00,LABORABLE
8,11,2019,5,100,127,227,2019-11-08 04:00:00,2019-08-11 00:00:00,LABORABLE
8,11,2019,6,196,165,361,2019-11-08 05:00:00,2019-08-11 00:00:00,LABORABLE
8,11,2019,7,312,460,772,2019-11-08 06:00:00,2019-08-11 00:00:00,LABORABLE
8,11,2019,8,686,638,1324,2019-11-08 07:00:00,2019-08-11 00:00:00,LABORABLE
8,11,2019,9,671,673,1344,2019-11-08 08:00:00,2019-08-11 00:00:00,LABORABLE
8,11,2019,10,678,720,1398,2019-11-08 09:00:00,2019-08-11 00:00:00,LABORABLE
8,11,2019,11,566,667,1233,2019-11-08 10:00:00,2019-08-11 00:00:00,LABORABLE
8,11,2019,12,591,712,1303,2019-11-08 11:00:00,2019-08-11 00:00:00,LABORABLE
8,11,2019,13,692,765,1457,2019-11-08 12:00:00,2019-08-11 00:00:00,LABORABLE
8,11,2019,14,685,785,1470,2019-11-08 13:00:00,2019-08-11 00:00:00,LABORABLE
8,11,2019,15,699,696,1395,2019-11-08 14:00:00,2019-08-11 00:00:00,LABORABLE
8,11,2019,16,695,753,1448,2019-11-08 15:00:00,2019-08-11 00:00:00,LABORABLE
8,11,2019,17,668,751,1419,2019-11-08 16:00:00,2019-08-11 00:00:00,LABORABLE
8,11,2019,18,762,826,1588,2019-11-08 17:00:00,2019-08-11 00:00:00,LABORABLE
8,11,2019,19,718,821,1539,2019-11-08 18:00:00,2019-08-11 00:00:00,LABORABLE
8,11,2019,20,697,794,1491,2019-11-08 19:00:00,2019-08-11 00:00:00,LABORABLE
8,11,2019,21,749,870,1619,2019-11-08 20:00:00,2019-08-11 00:00:00,LABORABLE
8,11,2019,22,726,697,1423,2019-11-08 21:00:00,2019-08-11 00:00:00,LABORABLE
8,11,2019,23,607,582,1189,2019-11-08 22:00:00,2019-08-11 00:00:00,LABORABLE
8,11,2019,24,467,533,1000,2019-11-08 23:00:00,2019-08-11 00:00:00,LABORABLE
9,11,2019,1,217,354,571,2019-11-09 00:00:00,2019-09-11 00:00:00,FESTIVO
9,11,2019,2,186,250,436,2019-11-09 01:00:00,2019-09-11 00:00:00,FESTIVO
9,11,2019,3,116,191,307,2019-11-09 02:00:00,2019-09-11 00:00:00,FESTIVO
9,11,2019,4,68,150,218,2019-11-09 03:00:00,2019-09-11 00:00:00,FESTIVO
9,11,2019,5,62,121,183,2019-11-09 04:00:00,2019-09-11 00:00:00,FESTIVO
9,11,2019,6,96,150,246,2019-11-09 05:00:00,2019-09-11 00:00:00,FESTIVO
9,11,2019,7,211,255,466,2019-11-09 06:00:00,2019-09-11 00:00:00,FESTIVO
9,11,2019,8,343,293,636,2019-11-09 07:00:00,2019-09-11 00:00:00,FESTIVO
9,11,2019,9,359,381,740,2019-11-09 08:00:00,2019-09-11 00:00:00,FESTIVO
9,11,2019,10,375,488,863,2019-11-09 09:00:00,2019-09-11 00:00:00,FESTIVO
9,11,2019,11,489,524,1013,2019-11-09 10:00:00,2019-09-11 00:00:00,FESTIVO
9,11,2019,12,523,590,1113,2019-11-09 11:00:00,2019-09-11 00:00:00,FESTIVO
9,11,2019,13,569,685,1254,2019-11-09 12:00:00,2019-09-11 00:00:00,FESTIVO
9,11,2019,14,516,686,1202,2019-11-09 13:00:00,2019-09-11 00:00:00,FESTIVO
9,11,2019,15,442,639,1081,2019-11-09 14:00:00,2019-09-11 00:00:00,FESTIVO
9,11,2019,16,391,582,973,2019-11-09 15:00:00,2019-09-11 00:00:00,FESTIVO
9,11,2019,17,416,604,1020,2019-11-09 16:00:00,2019-09-11 00:00:00,FESTIVO
9,11,2019,18,516,660,1176,2019-11-09 17:00:00,2019-09-11 00:00:00,FESTIVO
9,11,2019,19,492,816,1308,2019-11-09 18:00:00,2019-09-11 00:00:00,FESTIVO
9,11,2019,20,475,736,1211,2019-11-09 19:00:00,2019-09-11 00:00:00,FESTIVO
9,11,2019,21,470,627,1097,2019-11-09 20:00:00,2019-09-11 00:00:00,FESTIVO
9,11,2019,22,441,563,1004,2019-11-09 21:00:00,2019-09-11 00:00:00,FESTIVO
9,11,2019,23,345,464,809,2019-11-09 22:00:00,2019-09-11 00:00:00,FESTIVO
9,11,2019,24,259,343,602,2019-11-09 23:00:00,2019-09-11 00:00:00,FESTIVO
10,11,2019,1,164,273,437,2019-11-10 00:00:00,2019-10-11 00:00:00,LABORABLE
10,11,2019,2,92,195,287,2019-11-10 01:00:00,2019-10-11 00:00:00,LABORABLE
10,11,2019,3,62,146,208,2019-11-10 02:00:00,2019-10-11 00:00:00,LABORABLE
10,11,2019,4,54,104,158,2019-11-10 03:00:00,2019-10-11 00:00:00,LABORABLE
10,11,2019,5,75,92,167,2019-11-10 04:00:00,2019-10-11 00:00:00,LABORABLE
10,11,2019,6,141,162,303,2019-11-10 05:00:00,2019-10-11 00:00:00,LABORABLE
10,11,2019,7,316,373,689,2019-11-10 06:00:00,2019-10-11 00:00:00,LABORABLE
10,11,2019,8,547,597,1144,2019-11-10 07:00:00,2019-10-11 00:00:00,LABORABLE
10,11,2019,9,568,662,1230,2019-11-10 08:00:00,2019-10-11 00:00:00,LABORABLE
10,11,2019,10,595,784,1379,2019-11-10 09:00:00,2019-10-11 00:00:00,LABORABLE
10,11,2019,11,616,717,1333,2019-11-10 10:00:00,2019-10-11 00:00:00,LABORABLE
10,11,2019,12,564,945,1509,2019-11-10 11:00:00,2019-10-11 00:00:00,LABORABLE
10,11,2019,13,611,787,1398,2019-11-10 12:00:00,2019-10-11 00:00:00,LABORABLE
10,11,2019,14,651,780,1431,2019-11-10 13:00:00,2019-10-11 00:00:00,LABORABLE
10,11,2019,15,694,711,1405,2019-11-10 14:00:00,2019-10-11 00:00:00,LABORABLE
10,11,2019,16,589,719,1308,2019-11-10 15:00:00,2019-10-11 00:00:00,LABORABLE
10,11,2019,17,634,812,1446,2019-11-10 16:00:00,2019-10-11 00:00:00,LABORABLE
10,11,2019,18,692,853,1545,2019-11-10 17:00:00,2019-10-11 00:00:00,LABORABLE
10,11,2019,19,711,814,1525,2019-11-10 18:00:00,2019-10-11 00:00:00,LABORABLE
10,11,2019,20,683,797,1480,2019-11-10 19:00:00,2019-10-11 00:00:00,LABORABLE
10,11,2019,21,671,887,1558,2019-11-10 20:00:00,2019-10-11 00:00:00,LABORABLE
10,11,2019,22,552,740,1292,2019-11-10 21:00:00,2019-10-11 00:00:00,LABORABLE
10,11,2019,23,465,575,1040,2019-11-10 22:00:00,2019-10-11 00:00:00,LABORABLE
10,11,2019,24,335,487,822,2019-11-10 23:00:00,2019-10-11 00:00:00,LABORABLE
11,11,2019,1,192,300,492,2019-11-11 00:00:00,2019-11-11 00:00:00,LABORABLE
11,11,2019,2,144,208,352,2019-11-11 01:00:00,2019-11-11 00:00:00,LABORABLE
11,11,2019,3,93,147,240,2019-11-11 02:00:00,2019-11-11 00:00:00,LABORABLE
11,11,2019,4,63,141,204,2019-11-11 03:00:00,2019-11-11 00:00:00,LABORABLE
11,11,2019,5,86,95,181,2019-11-11 04:00:00,2019-11-11 00:00:00,LABORABLE
11,11,2019,6,181,171,352,2019-11-11 05:00:00,2019-11-11 00:00:00,LABORABLE
11,11,2019,7,483,460,943,2019-11-11 06:00:00,2019-11-11 00:00:00,LABORABLE
11,11,2019,8,693,657,1350,2019-11-11 07:00:00,2019-11-11 00:00:00,LABORABLE
11,11,2019,9,699,690,1389,2019-11-11 08:00:00,2019-11-11 00:00:00,LABORABLE
11,11,2019,10,675,733,1408,2019-11-11 09:00:00,2019-11-11 00:00:00,LABORABLE
11,11,2019,11,618,671,1289,2019-11-11 10:00:00,2019-11-11 00:00:00,LABORABLE
11,11,2019,12,622,759,1381,2019-11-11 11:00:00,2019-11-11 00:00:00,LABORABLE
11,11,2019,13,644,729,1373,2019-11-11 12:00:00,2019-11-11 00:00:00,LABORABLE
11,11,2019,14,626,789,1415,2019-11-11 13:00:00,2019-11-11 00:00:00,LABORABLE
11,11,2019,15,675,752,1427,2019-11-11 14:00:00,2019-11-11 00:00:00,LABORABLE
11,11,2019,16,641,723,1364,2019-11-11 15:00:00,2019-11-11 00:00:00,LABORABLE
11,11,2019,17,695,772,1467,2019-11-11 16:00:00,2019-11-11 00:00:00,LABORABLE
11,11,2019,18,691,817,1508,2019-11-11 17:00:00,2019-11-11 00:00:00,LABORABLE
11,11,2019,19,683,761,1444,2019-11-11 18:00:00,2019-11-11 00:00:00,LABORABLE
11,11,2019,20,654,814,1468,2019-11-11 19:00:00,2019-11-11 00:00:00,LABORABLE
11,11,2019,21,625,706,1331,2019-11-11 20:00:00,2019-11-11 00:00:00,LABORABLE
11,11,2019,22,457,606,1063,2019-11-11 21:00:00,2019-11-11 00:00:00,LABORABLE
11,11,2019,23,335,410,745,2019-11-11 22:00:00,2019-11-11 00:00:00,LABORABLE
11,11,2019,24,230,321,551,2019-11-11 23:00:00,2019-11-11 00:00:00,LABORABLE
12,11,2019,1,144,219,363,2019-11-12 00:00:00,2019-12-11 00:00:00,LABORABLE
12,11,2019,2,84,155,239,2019-11-12 01:00:00,2019-12-11 00:00:00,LABORABLE
12,11,2019,3,73,111,184,2019-11-12 02:00:00,2019-12-11 00:00:00,LABORABLE
12,11,2019,4,56,97,153,2019-11-12 03:00:00,2019-12-11 00:00:00,LABORABLE
12,11,2019,5,58,82,140,2019-11-12 04:00:00,2019-12-11 00:00:00,LABORABLE
12,11,2019,6,123,150,273,2019-11-12 05:00:00,2019-12-11 00:00:00,LABORABLE
12,11,2019,7,425,463,888,2019-11-12 06:00:00,2019-12-11 00:00:00,LABORABLE
12,11,2019,8,683,608,1291,2019-11-12 07:00:00,2019-12-11 00:00:00,LABORABLE
12,11,2019,9,693,771,1464,2019-11-12 08:00:00,2019-12-11 00:00:00,LABORABLE
12,11,2019,10,635,659,1294,2019-11-12 09:00:00,2019-12-11 00:00:00,LABORABLE
12,11,2019,11,540,633,1173,2019-11-12 10:00:00,2019-12-11 00:00:00,LABORABLE
12,11,2019,12,592,707,1299,2019-11-12 11:00:00,2019-12-11 00:00:00,LABORABLE
12,11,2019,13,636,744,1380,2019-11-12 12:00:00,2019-12-11 00:00:00,LABORABLE
12,11,2019,14,621,818,1439,2019-11-12 13:00:00,2019-12-11 00:00:00,LABORABLE
12,11,2019,15,636,713,1349,2019-11-12 14:00:00,2019-12-11 00:00:00,LABORABLE
12,11,2019,16,608,684,1292,2019-11-12 15:00:00,2019-12-11 00:00:00,LABORABLE
12,11,2019,17,506,780,1286,2019-11-12 16:00:00,2019-12-11 00:00:00,LABORABLE
12,11,2019,18,708,789,1497,2019-11-12 17:00:00,2019-12-11 00:00:00,LABORABLE
12,11,2019,19,665,723,1388,2019-11-12 18:00:00,2019-12-11 00:00:00,LABORABLE
12,11,2019,20,633,811,1444,2019-11-12 19:00:00,2019-12-11 00:00:00,LABORABLE
12,11,2019,21,640,742,1382,2019-11-12 20:00:00,2019-12-11 00:00:00,LABORABLE
12,11,2019,22,563,717,1280,2019-11-12 21:00:00,2019-12-11 00:00:00,LABORABLE
12,11,2019,23,411,525,936,2019-11-12 22:00:00,2019-12-11 00:00:00,LABORABLE
12,11,2019,24,264,368,632,2019-11-12 23:00:00,2019-12-11 00:00:00,LABORABLE
13,11,2019,1,172,291,463,2019-11-13 00:00:00,2019-11-13 00:00:00,LABORABLE
13,11,2019,2,102,192,294,2019-11-13 01:00:00,2019-11-13 00:00:00,LABORABLE
13,11,2019,3,70,135,205,2019-11-13 02:00:00,2019-11-13 00:00:00,LABORABLE
13,11,2019,4,56,106,162,2019-11-13 03:00:00,2019-11-13 00:00:00,LABORABLE
13,11,2019,5,62,101,163,2019-11-13 04:00:00,2019-11-13 00:00:00,LABORABLE
13,11,2019,6,120,135,255,2019-11-13 05:00:00,2019-11-13 00:00:00,LABORABLE
13,11,2019,7,312,397,709,2019-11-13 06:00:00,2019-11-13 00:00:00,LABORABLE
13,11,2019,8,541,664,1205,2019-11-13 07:00:00,2019-11-13 00:00:00,LABORABLE
13,11,2019,9,697,688,1385,2019-11-13 08:00:00,2019-11-13 00:00:00,LABORABLE
13,11,2019,10,621,716,1337,2019-11-13 09:00:00,2019-11-13 00:00:00,LABORABLE
13,11,2019,11,465,647,1112,2019-11-13 10:00:00,2019-11-13 00:00:00,LABORABLE
13,11,2019,12,403,694,1097,2019-11-13 11:00:00,2019-11-13 00:00:00,LABORABLE
13,11,2019,13,509,640,1149,2019-11-13 12:00:00,2019-11-13 00:00:00,LABORABLE
13,11,2019,14,504,656,1160,2019-11-13 13:00:00,2019-11-13 00:00:00,LABORABLE
13,11,2019,15,678,699,1377,2019-11-13 14:00:00,2019-11-13 00:00:00,LABORABLE
13,11,2019,16,684,645,1329,2019-11-13 15:00:00,2019-11-13 00:00:00,LABORABLE
13,11,2019,17,689,709,1398,2019-11-13 16:00:00,2019-11-13 00:00:00,LABORABLE
13,11,2019,18,676,779,1455,2019-11-13 17:00:00,2019-11-13 00:00:00,LABORABLE
13,11,2019,19,677,743,1420,2019-11-13 18:00:00,2019-11-13 00:00:00,LABORABLE
13,11,2019,20,641,760,1401,2019-11-13 19:00:00,2019-11-13 00:00:00,LABORABLE
13,11,2019,21,650,722,1372,2019-11-13 20:00:00,2019-11-13 00:00:00,LABORABLE
13,11,2019,22,558,592,1150,2019-11-13 21:00:00,2019-11-13 00:00:00,LABORABLE
13,11,2019,23,439,411,850,2019-11-13 22:00:00,2019-11-13 00:00:00,LABORABLE
13,11,2019,24,281,378,659,2019-11-13 23:00:00,2019-11-13 00:00:00,LABORABLE
14,11,2019,1,207,275,482,2019-11-14 00:00:00,2019-11-14 00:00:00,LABORABLE
14,11,2019,2,132,167,299,2019-11-14 01:00:00,2019-11-14 00:00:00,LABORABLE
14,11,2019,3,74,144,218,2019-11-14 02:00:00,2019-11-14 00:00:00,LABORABLE
14,11,2019,4,87,112,199,2019-11-14 03:00:00,2019-11-14 00:00:00,LABORABLE
14,11,2019,5,57,109,166,2019-11-14 04:00:00,2019-11-14 00:00:00,LABORABLE
14,11,2019,6,176,175,351,2019-11-14 05:00:00,2019-11-14 00:00:00,LABORABLE
14,11,2019,7,313,452,765,2019-11-14 06:00:00,2019-11-14 00:00:00,LABORABLE
14,11,2019,8,677,667,1344,2019-11-14 07:00:00,2019-11-14 00:00:00,LABORABLE
14,11,2019,9,679,684,1363,2019-11-14 08:00:00,2019-11-14 00:00:00,LABORABLE
14,11,2019,10,676,747,1423,2019-11-14 09:00:00,2019-11-14 00:00:00,LABORABLE
14,11,2019,11,635,631,1266,2019-11-14 10:00:00,2019-11-14 00:00:00,LABORABLE
14,11,2019,12,546,612,1158,2019-11-14 11:00:00,2019-11-14 00:00:00,LABORABLE
14,11,2019,13,590,716,1306,2019-11-14 12:00:00,2019-11-14 00:00:00,LABORABLE
14,11,2019,14,661,685,1346,2019-11-14 13:00:00,2019-11-14 00:00:00,LABORABLE
14,11,2019,15,651,739,1390,2019-11-14 14:00:00,2019-11-14 00:00:00,LABORABLE
14,11,2019,16,651,677,1328,2019-11-14 15:00:00,2019-11-14 00:00:00,LABORABLE
14,11,2019,17,566,774,1340,2019-11-14 16:00:00,2019-11-14 00:00:00,LABORABLE
14,11,2019,18,725,758,1483,2019-11-14 17:00:00,2019-11-14 00:00:00,LABORABLE
14,11,2019,19,704,782,1486,2019-11-14 18:00:00,2019-11-14 00:00:00,LABORABLE
14,11,2019,20,619,748,1367,2019-11-14 19:00:00,2019-11-14 00:00:00,LABORABLE
14,11,2019,21,712,721,1433,2019-11-14 20:00:00,2019-11-14 00:00:00,LABORABLE
14,11,2019,22,586,603,1189,2019-11-14 21:00:00,2019-11-14 00:00:00,LABORABLE
14,11,2019,23,465,429,894,2019-11-14 22:00:00,2019-11-14 00:00:00,LABORABLE
14,11,2019,24,266,365,631,2019-11-14 23:00:00,2019-11-14 00:00:00,LABORABLE
15,11,2019,1,211,300,511,2019-11-15 00:00:00,2019-11-15 00:00:00,LABORABLE
15,11,2019,2,128,223,351,2019-11-15 01:00:00,2019-11-15 00:00:00,LABORABLE
15,11,2019,3,78,176,254,2019-11-15 02:00:00,2019-11-15 00:00:00,LABORABLE
15,11,2019,4,73,148,221,2019-11-15 03:00:00,2019-11-15 00:00:00,LABORABLE
15,11,2019,5,104,116,220,2019-11-15 04:00:00,2019-11-15 00:00:00,LABORABLE
15,11,2019,6,186,210,396,2019-11-15 05:00:00,2019-11-15 00:00:00,LABORABLE
15,11,2019,7,453,486,939,2019-11-15 06:00:00,2019-11-15 00:00:00,LABORABLE
15,11,2019,8,650,599,1249,2019-11-15 07:00:00,2019-11-15 00:00:00,LABORABLE
15,11,2019,9,684,677,1361,2019-11-15 08:00:00,2019-11-15 00:00:00,LABORABLE
15,11,2019,10,669,674,1343,2019-11-15 09:00:00,2019-11-15 00:00:00,LABORABLE
15,11,2019,11,589,668,1257,2019-11-15 10:00:00,2019-11-15 00:00:00,LABORABLE
15,11,2019,12,582,721,1303,2019-11-15 11:00:00,2019-11-15 00:00:00,LABORABLE
15,11,2019,13,688,740,1428,2019-11-15 12:00:00,2019-11-15 00:00:00,LABORABLE
15,11,2019,14,570,621,1191,2019-11-15 13:00:00,2019-11-15 00:00:00,LABORABLE
15,11,2019,15,696,763,1459,2019-11-15 14:00:00,2019-11-15 00:00:00,LABORABLE
15,11,2019,16,649,742,1391,2019-11-15 15:00:00,2019-11-15 00:00:00,LABORABLE
15,11,2019,17,683,755,1438,2019-11-15 16:00:00,2019-11-15 00:00:00,LABORABLE
15,11,2019,18,737,825,1562,2019-11-15 17:00:00,2019-11-15 00:00:00,LABORABLE
15,11,2019,19,726,826,1552,2019-11-15 18:00:00,2019-11-15 00:00:00,LABORABLE
15,11,2019,20,675,797,1472,2019-11-15 19:00:00,2019-11-15 00:00:00,LABORABLE
15,11,2019,21,672,858,1530,2019-11-15 20:00:00,2019-11-15 00:00:00,LABORABLE
15,11,2019,22,631,727,1358,2019-11-15 21:00:00,2019-11-15 00:00:00,LABORABLE
15,11,2019,23,534,599,1133,2019-11-15 22:00:00,2019-11-15 00:00:00,LABORABLE
15,11,2019,24,431,499,930,2019-11-15 23:00:00,2019-11-15 00:00:00,LABORABLE
16,11,2019,1,165,276,441,2019-11-16 00:00:00,2019-11-16 00:00:00,LABORABLE
16,11,2019,2,107,190,297,2019-11-16 01:00:00,2019-11-16 00:00:00,LABORABLE
16,11,2019,3,66,111,177,2019-11-16 02:00:00,2019-11-16 00:00:00,LABORABLE
16,11,2019,4,54,82,136,2019-11-16 03:00:00,2019-11-16 00:00:00,LABORABLE
16,11,2019,5,58,94,152,2019-11-16 04:00:00,2019-11-16 00:00:00,LABORABLE
16,11,2019,6,136,171,307,2019-11-16 05:00:00,2019-11-16 00:00:00,LABORABLE
16,11,2019,7,353,406,759,2019-11-16 06:00:00,2019-11-16 00:00:00,LABORABLE
16,11,2019,8,573,670,1243,2019-11-16 07:00:00,2019-11-16 00:00:00,LABORABLE
16,11,2019,9,587,759,1346,2019-11-16 08:00:00,2019-11-16 00:00:00,LABORABLE
16,11,2019,10,618,790,1408,2019-11-16 09:00:00,2019-11-16 00:00:00,LABORABLE
16,11,2019,11,559,728,1287,2019-11-16 10:00:00,2019-11-16 00:00:00,LABORABLE
16,11,2019,12,552,748,1300,2019-11-16 11:00:00,2019-11-16 00:00:00,LABORABLE
16,11,2019,13,517,699,1216,2019-11-16 12:00:00,2019-11-16 00:00:00,LABORABLE
16,11,2019,14,600,752,1352,2019-11-16 13:00:00,2019-11-16 00:00:00,LABORABLE
16,11,2019,15,652,795,1447,2019-11-16 14:00:00,2019-11-16 00:00:00,LABORABLE
16,11,2019,16,614,690,1304,2019-11-16 15:00:00,2019-11-16 00:00:00,LABORABLE
16,11,2019,17,630,730,1360,2019-11-16 16:00:00,2019-11-16 00:00:00,LABORABLE
16,11,2019,18,643,778,1421,2019-11-16 17:00:00,2019-11-16 00:00:00,LABORABLE
16,11,2019,19,693,788,1481,2019-11-16 18:00:00,2019-11-16 00:00:00,LABORABLE
16,11,2019,20,637,840,1477,2019-11-16 19:00:00,2019-11-16 00:00:00,LABORABLE
16,11,2019,21,665,779,1444,2019-11-16 20:00:00,2019-11-16 00:00:00,LABORABLE
16,11,2019,22,553,627,1180,2019-11-16 21:00:00,2019-11-16 00:00:00,LABORABLE
16,11,2019,23,380,491,871,2019-11-16 22:00:00,2019-11-16 00:00:00,LABORABLE
16,11,2019,24,255,356,611,2019-11-16 23:00:00,2019-11-16 00:00:00,LABORABLE
17,11,2019,1,195,300,495,2019-11-17 00:00:00,2019-11-17 00:00:00,LABORABLE
17,11,2019,2,94,213,307,2019-11-17 01:00:00,2019-11-17 00:00:00,LABORABLE
17,11,2019,3,74,152,226,2019-11-17 02:00:00,2019-11-17 00:00:00,LABORABLE
17,11,2019,4,83,92,175,2019-11-17 03:00:00,2019-11-17 00:00:00,LABORABLE
17,11,2019,5,62,102,164,2019-11-17 04:00:00,2019-11-17 00:00:00,LABORABLE
17,11,2019,6,140,179,319,2019-11-17 05:00:00,2019-11-17 00:00:00,LABORABLE
17,11,2019,7,282,435,717,2019-11-17 06:00:00,2019-11-17 00:00:00,LABORABLE
17,11,2019,8,562,674,1236,2019-11-17 07:00:00,2019-11-17 00:00:00,LABORABLE
17,11,2019,9,559,740,1299,2019-11-17 08:00:00,2019-11-17 00:00:00,LABORABLE
17,11,2019,10,651,810,1461,2019-11-17 09:00:00,2019-11-17 00:00:00,LABORABLE
17,11,2019,11,394,689,1083,2019-11-17 10:00:00,2019-11-17 00:00:00,LABORABLE
17,11,2019,12,584,723,1307,2019-11-17 11:00:00,2019-11-17 00:00:00,LABORABLE
17,11,2019,13,578,797,1375,2019-11-17 12:00:00,2019-11-17 00:00:00,LABORABLE
17,11,2019,14,656,738,1394,2019-11-17 13:00:00,2019-11-17 00:00:00,LABORABLE
17,11,2019,15,665,818,1483,2019-11-17 14:00:00,2019-11-17 00:00:00,LABORABLE
17,11,2019,16,600,713,1313,2019-11-17 15:00:00,2019-11-17 00:00:00,LABORABLE
17,11,2019,17,611,765,1376,2019-11-17 16:00:00,2019-11-17 00:00:00,LABORABLE
17,11,2019,18,690,821,1511,2019-11-17 17:00:00,2019-11-17 00:00:00,LABORABLE
17,11,2019,19,720,856,1576,2019-11-17 18:00:00,2019-11-17 00:00:00,LABORABLE
17,11,2019,20,641,863,1504,2019-11-17 19:00:00,2019-11-17 00:00:00,LABORABLE
17,11,2019,21,685,883,1568,2019-11-17 20:00:00,2019-11-17 00:00:00,LABORABLE
17,11,2019,22,614,803,1417,2019-11-17 21:00:00,2019-11-17 00:00:00,LABORABLE
17,11,2019,23,487,582,1069,2019-11-17 22:00:00,2019-11-17 00:00:00,LABORABLE
17,11,2019,24,381,498,879,2019-11-17 23:00:00,2019-11-17 00:00:00,LABORABLE
18,11,2019,1,195,231,426,2019-11-18 00:00:00,2019-11-18 00:00:00,LABORABLE
18,11,2019,2,124,188,312,2019-11-18 01:00:00,2019-11-18 00:00:00,LABORABLE
18,11,2019,3,88,159,247,2019-11-18 02:00:00,2019-11-18 00:00:00,LABORABLE
18,11,2019,4,87,115,202,2019-11-18 03:00:00,2019-11-18 00:00:00,LABORABLE
18,11,2019,5,74,118,192,2019-11-18 04:00:00,2019-11-18 00:00:00,LABORABLE
18,11,2019,6,125,178,303,2019-11-18 05:00:00,2019-11-18 00:00:00,LABORABLE
18,11,2019,7,456,423,879,2019-11-18 06:00:00,2019-11-18 00:00:00,LABORABLE
18,11,2019,8,693,649,1342,2019-11-18 07:00:00,2019-11-18 00:00:00,LABORABLE
18,11,2019,9,693,702,1395,2019-11-18 08:00:00,2019-11-18 00:00:00,LABORABLE
18,11,2019,10,654,680,1334,2019-11-18 09:00:00,2019-11-18 00:00:00,LABORABLE
18,11,2019,11,565,659,1224,2019-11-18 10:00:00,2019-11-18 00:00:00,LABORABLE
18,11,2019,12,576,696,1272,2019-11-18 11:00:00,2019-11-18 00:00:00,LABORABLE
18,11,2019,13,649,734,1383,2019-11-18 12:00:00,2019-11-18 00:00:00,LABORABLE
18,11,2019,14,641,756,1397,2019-11-18 13:00:00,2019-11-18 00:00:00,LABORABLE
18,11,2019,15,644,686,1330,2019-11-18 14:00:00,2019-11-18 00:00:00,LABORABLE
18,11,2019,16,687,680,1367,2019-11-18 15:00:00,2019-11-18 00:00:00,LABORABLE
18,11,2019,17,669,700,1369,2019-11-18 16:00:00,2019-11-18 00:00:00,LABORABLE
18,11,2019,18,691,765,1456,2019-11-18 17:00:00,2019-11-18 00:00:00,LABORABLE
18,11,2019,19,668,798,1466,2019-11-18 18:00:00,2019-11-18 00:00:00,LABORABLE
18,11,2019,20,632,774,1406,2019-11-18 19:00:00,2019-11-18 00:00:00,LABORABLE
18,11,2019,21,610,721,1331,2019-11-18 20:00:00,2019-11-18 00:00:00,LABORABLE
18,11,2019,22,490,559,1049,2019-11-18 21:00:00,2019-11-18 00:00:00,LABORABLE
18,11,2019,23,400,439,839,2019-11-18 22:00:00,2019-11-18 00:00:00,LABORABLE
18,11,2019,24,217,314,531,2019-11-18 23:00:00,2019-11-18 00:00:00,LABORABLE
19,11,2019,1,150,224,374,2019-11-19 00:00:00,2019-11-19 00:00:00,LABORABLE
19,11,2019,2,103,160,263,2019-11-19 01:00:00,2019-11-19 00:00:00,LABORABLE
19,11,2019,3,72,115,187,2019-11-19 02:00:00,2019-11-19 00:00:00,LABORABLE
19,11,2019,4,75,101,176,2019-11-19 03:00:00,2019-11-19 00:00:00,LABORABLE
19,11,2019,5,71,91,162,2019-11-19 04:00:00,2019-11-19 00:00:00,LABORABLE
19,11,2019,6,123,149,272,2019-11-19 05:00:00,2019-11-19 00:00:00,LABORABLE
19,11,2019,7,446,409,855,2019-11-19 06:00:00,2019-11-19 00:00:00,LABORABLE
19,11,2019,8,664,596,1260,2019-11-19 07:00:00,2019-11-19 00:00:00,LABORABLE
19,11,2019,9,678,713,1391,2019-11-19 08:00:00,2019-11-19 00:00:00,LABORABLE
19,11,2019,10,645,773,1418,2019-11-19 09:00:00,2019-11-19 00:00:00,LABORABLE
19,11,2019,11,503,653,1156,2019-11-19 10:00:00,2019-11-19 00:00:00,LABORABLE
19,11,2019,12,631,707,1338,2019-11-19 11:00:00,2019-11-19 00:00:00,LABORABLE
19,11,2019,13,599,750,1349,2019-11-19 12:00:00,2019-11-19 00:00:00,LABORABLE
19,11,2019,14,639,760,1399,2019-11-19 13:00:00,2019-11-19 00:00:00,LABORABLE
19,11,2019,15,669,770,1439,2019-11-19 14:00:00,2019-11-19 00:00:00,LABORABLE
19,11,2019,16,650,730,1380,2019-11-19 15:00:00,2019-11-19 00:00:00,LABORABLE
19,11,2019,17,658,772,1430,2019-11-19 16:00:00,2019-11-19 00:00:00,LABORABLE
19,11,2019,18,711,779,1490,2019-11-19 17:00:00,2019-11-19 00:00:00,LABORABLE
19,11,2019,19,691,810,1501,2019-11-19 18:00:00,2019-11-19 00:00:00,LABORABLE
19,11,2019,20,626,774,1400,2019-11-19 19:00:00,2019-11-19 00:00:00,LABORABLE
19,11,2019,21,688,755,1443,2019-11-19 20:00:00,2019-11-19 00:00:00,LABORABLE
19,11,2019,22,543,654,1197,2019-11-19 21:00:00,2019-11-19 00:00:00,LABORABLE
19,11,2019,23,388,463,851,2019-11-19 22:00:00,2019-11-19 00:00:00,LABORABLE
19,11,2019,24,301,298,599,2019-11-19 23:00:00,2019-11-19 00:00:00,LABORABLE
20,11,2019,1,172,229,401,2019-11-20 00:00:00,2019-11-20 00:00:00,LABORABLE
20,11,2019,2,121,178,299,2019-11-20 01:00:00,2019-11-20 00:00:00,LABORABLE
20,11,2019,3,89,121,210,2019-11-20 02:00:00,2019-11-20 00:00:00,LABORABLE
20,11,2019,4,75,107,182,2019-11-20 03:00:00,2019-11-20 00:00:00,LABORABLE
20,11,2019,5,62,106,168,2019-11-20 04:00:00,2019-11-20 00:00:00,LABORABLE
20,11,2019,6,120,162,282,2019-11-20 05:00:00,2019-11-20 00:00:00,LABORABLE
20,11,2019,7,448,445,893,2019-11-20 06:00:00,2019-11-20 00:00:00,LABORABLE
20,11,2019,8,664,631,1295,2019-11-20 07:00:00,2019-11-20 00:00:00,LABORABLE
20,11,2019,9,727,699,1426,2019-11-20 08:00:00,2019-11-20 00:00:00,LABORABLE
20,11,2019,10,657,771,1428,2019-11-20 09:00:00,2019-11-20 00:00:00,LABORABLE
20,11,2019,11,393,768,1161,2019-11-20 10:00:00,2019-11-20 00:00:00,LABORABLE
20,11,2019,12,484,645,1129,2019-11-20 11:00:00,2019-11-20 00:00:00,LABORABLE
20,11,2019,13,639,762,1401,2019-11-20 12:00:00,2019-11-20 00:00:00,LABORABLE
20,11,2019,14,631,798,1429,2019-11-20 13:00:00,2019-11-20 00:00:00,LABORABLE
20,11,2019,15,687,704,1391,2019-11-20 14:00:00,2019-11-20 00:00:00,LABORABLE
20,11,2019,16,652,707,1359,2019-11-20 15:00:00,2019-11-20 00:00:00,LABORABLE
20,11,2019,17,644,783,1427,2019-11-20 16:00:00,2019-11-20 00:00:00,LABORABLE
20,11,2019,18,614,792,1406,2019-11-20 17:00:00,2019-11-20 00:00:00,LABORABLE
20,11,2019,19,707,739,1446,2019-11-20 18:00:00,2019-11-20 00:00:00,LABORABLE
20,11,2019,20,588,788,1376,2019-11-20 19:00:00,2019-11-20 00:00:00,LABORABLE
20,11,2019,21,642,759,1401,2019-11-20 20:00:00,2019-11-20 00:00:00,LABORABLE
20,11,2019,22,515,619,1134,2019-11-20 21:00:00,2019-11-20 00:00:00,LABORABLE
20,11,2019,23,476,459,935,2019-11-20 22:00:00,2019-11-20 00:00:00,LABORABLE
20,11,2019,24,277,323,600,2019-11-20 23:00:00,2019-11-20 00:00:00,LABORABLE
21,11,2019,1,214,279,493,2019-11-21 00:00:00,2019-11-21 00:00:00,LABORABLE
21,11,2019,2,135,163,298,2019-11-21 01:00:00,2019-11-21 00:00:00,LABORABLE
21,11,2019,3,82,143,225,2019-11-21 02:00:00,2019-11-21 00:00:00,LABORABLE
21,11,2019,4,89,110,199,2019-11-21 03:00:00,2019-11-21 00:00:00,LABORABLE
21,11,2019,5,57,92,149,2019-11-21 04:00:00,2019-11-21 00:00:00,LABORABLE
21,11,2019,6,126,176,302,2019-11-21 05:00:00,2019-11-21 00:00:00,LABORABLE
21,11,2019,7,450,415,865,2019-11-21 06:00:00,2019-11-21 00:00:00,LABORABLE
21,11,2019,8,662,598,1260,2019-11-21 07:00:00,2019-11-21 00:00:00,LABORABLE
21,11,2019,9,706,709,1415,2019-11-21 08:00:00,2019-11-21 00:00:00,LABORABLE
21,11,2019,10,658,741,1399,2019-11-21 09:00:00,2019-11-21 00:00:00,LABORABLE
21,11,2019,11,612,693,1305,2019-11-21 10:00:00,2019-11-21 00:00:00,LABORABLE
21,11,2019,12,597,767,1364,2019-11-21 11:00:00,2019-11-21 00:00:00,LABORABLE
21,11,2019,13,611,729,1340,2019-11-21 12:00:00,2019-11-21 00:00:00,LABORABLE
21,11,2019,14,634,778,1412,2019-11-21 13:00:00,2019-11-21 00:00:00,LABORABLE
21,11,2019,15,673,797,1470,2019-11-21 14:00:00,2019-11-21 00:00:00,LABORABLE
21,11,2019,16,612,732,1344,2019-11-21 15:00:00,2019-11-21 00:00:00,LABORABLE
21,11,2019,17,682,777,1459,2019-11-21 16:00:00,2019-11-21 00:00:00,LABORABLE
21,11,2019,18,744,801,1545,2019-11-21 17:00:00,2019-11-21 00:00:00,LABORABLE
21,11,2019,19,708,803,1511,2019-11-21 18:00:00,2019-11-21 00:00:00,LABORABLE
21,11,2019,20,695,789,1484,2019-11-21 19:00:00,2019-11-21 00:00:00,LABORABLE
21,11,2019,21,646,749,1395,2019-11-21 20:00:00,2019-11-21 00:00:00,LABORABLE
21,11,2019,22,588,655,1243,2019-11-21 21:00:00,2019-11-21 00:00:00,LABORABLE
21,11,2019,23,390,506,896,2019-11-21 22:00:00,2019-11-21 00:00:00,LABORABLE
21,11,2019,24,325,396,721,2019-11-21 23:00:00,2019-11-21 00:00:00,LABORABLE
22,11,2019,1,205,299,504,2019-11-22 00:00:00,2019-11-22 00:00:00,LABORABLE
22,11,2019,2,135,223,358,2019-11-22 01:00:00,2019-11-22 00:00:00,LABORABLE
22,11,2019,3,96,181,277,2019-11-22 02:00:00,2019-11-22 00:00:00,LABORABLE
22,11,2019,4,102,124,226,2019-11-22 03:00:00,2019-11-22 00:00:00,LABORABLE
22,11,2019,5,103,136,239,2019-11-22 04:00:00,2019-11-22 00:00:00,LABORABLE
22,11,2019,6,132,186,318,2019-11-22 05:00:00,2019-11-22 00:00:00,LABORABLE
22,11,2019,7,436,415,851,2019-11-22 06:00:00,2019-11-22 00:00:00,LABORABLE
22,11,2019,8,696,594,1290,2019-11-22 07:00:00,2019-11-22 00:00:00,LABORABLE
22,11,2019,9,658,689,1347,2019-11-22 08:00:00,2019-11-22 00:00:00,LABORABLE
22,11,2019,10,624,688,1312,2019-11-22 09:00:00,2019-11-22 00:00:00,LABORABLE
22,11,2019,11,607,696,1303,2019-11-22 10:00:00,2019-11-22 00:00:00,LABORABLE
22,11,2019,12,631,758,1389,2019-11-22 11:00:00,2019-11-22 00:00:00,LABORABLE
22,11,2019,13,612,767,1379,2019-11-22 12:00:00,2019-11-22 00:00:00,LABORABLE
22,11,2019,14,658,739,1397,2019-11-22 13:00:00,2019-11-22 00:00:00,LABORABLE
22,11,2019,15,726,733,1459,2019-11-22 14:00:00,2019-11-22 00:00:00,LABORABLE
22,11,2019,16,658,709,1367,2019-11-22 15:00:00,2019-11-22 00:00:00,LABORABLE
22,11,2019,17,638,758,1396,2019-11-22 16:00:00,2019-11-22 00:00:00,LABORABLE
22,11,2019,18,670,826,1496,2019-11-22 17:00:00,2019-11-22 00:00:00,LABORABLE
22,11,2019,19,655,820,1475,2019-11-22 18:00:00,2019-11-22 00:00:00,LABORABLE
22,11,2019,20,660,834,1494,2019-11-22 19:00:00,2019-11-22 00:00:00,LABORABLE
22,11,2019,21,710,785,1495,2019-11-22 20:00:00,2019-11-22 00:00:00,LABORABLE
22,11,2019,22,603,771,1374,2019-11-22 21:00:00,2019-11-22 00:00:00,LABORABLE
22,11,2019,23,549,588,1137,2019-11-22 22:00:00,2019-11-22 00:00:00,LABORABLE
22,11,2019,24,400,502,902,2019-11-22 23:00:00,2019-11-22 00:00:00,LABORABLE
23,11,2019,1,188,258,446,2019-11-23 00:00:00,2019-11-23 00:00:00,LABORABLE
23,11,2019,2,93,169,262,2019-11-23 01:00:00,2019-11-23 00:00:00,LABORABLE
23,11,2019,3,71,136,207,2019-11-23 02:00:00,2019-11-23 00:00:00,LABORABLE
23,11,2019,4,59,93,152,2019-11-23 03:00:00,2019-11-23 00:00:00,LABORABLE
23,11,2019,5,60,84,144,2019-11-23 04:00:00,2019-11-23 00:00:00,LABORABLE
23,11,2019,6,136,145,281,2019-11-23 05:00:00,2019-11-23 00:00:00,LABORABLE
23,11,2019,7,375,429,804,2019-11-23 06:00:00,2019-11-23 00:00:00,LABORABLE
23,11,2019,8,612,642,1254,2019-11-23 07:00:00,2019-11-23 00:00:00,LABORABLE
23,11,2019,9,628,773,1401,2019-11-23 08:00:00,2019-11-23 00:00:00,LABORABLE
23,11,2019,10,666,725,1391,2019-11-23 09:00:00,2019-11-23 00:00:00,LABORABLE
23,11,2019,11,430,669,1099,2019-11-23 10:00:00,2019-11-23 00:00:00,LABORABLE
23,11,2019,12,544,709,1253,2019-11-23 11:00:00,2019-11-23 00:00:00,LABORABLE
23,11,2019,13,604,733,1337,2019-11-23 12:00:00,2019-11-23 00:00:00,LABORABLE
23,11,2019,14,655,788,1443,2019-11-23 13:00:00,2019-11-23 00:00:00,LABORABLE
23,11,2019,15,603,716,1319,2019-11-23 14:00:00,2019-11-23 00:00:00,LABORABLE
23,11,2019,16,664,688,1352,2019-11-23 15:00:00,2019-11-23 00:00:00,LABORABLE
23,11,2019,17,622,722,1344,2019-11-23 16:00:00,2019-11-23 00:00:00,LABORABLE
23,11,2019,18,720,708,1428,2019-11-23 17:00:00,2019-11-23 00:00:00,LABORABLE
23,11,2019,19,696,788,1484,2019-11-23 18:00:00,2019-11-23 00:00:00,LABORABLE
23,11,2019,20,590,791,1381,2019-11-23 19:00:00,2019-11-23 00:00:00,LABORABLE
23,11,2019,21,636,766,1402,2019-11-23 20:00:00,2019-11-23 00:00:00,LABORABLE
23,11,2019,22,534,613,1147,2019-11-23 21:00:00,2019-11-23 00:00:00,LABORABLE
23,11,2019,23,408,492,900,2019-11-23 22:00:00,2019-11-23 00:00:00,LABORABLE
23,11,2019,24,240,359,599,2019-11-23 23:00:00,2019-11-23 00:00:00,LABORABLE
24,11,2019,1,177,264,441,2019-11-24 00:00:00,2019-11-24 00:00:00,LABORABLE
24,11,2019,2,105,193,298,2019-11-24 01:00:00,2019-11-24 00:00:00,LABORABLE
24,11,2019,3,76,171,247,2019-11-24 02:00:00,2019-11-24 00:00:00,LABORABLE
24,11,2019,4,53,120,173,2019-11-24 03:00:00,2019-11-24 00:00:00,LABORABLE
24,11,2019,5,61,98,159,2019-11-24 04:00:00,2019-11-24 00:00:00,LABORABLE
24,11,2019,6,141,170,311,2019-11-24 05:00:00,2019-11-24 00:00:00,LABORABLE
24,11,2019,7,372,408,780,2019-11-24 06:00:00,2019-11-24 00:00:00,LABORABLE
24,11,2019,8,601,658,1259,2019-11-24 07:00:00,2019-11-24 00:00:00,LABORABLE
24,11,2019,9,567,756,1323,2019-11-24 08:00:00,2019-11-24 00:00:00,LABORABLE
24,11,2019,10,616,769,1385,2019-11-24 09:00:00,2019-11-24 00:00:00,LABORABLE
24,11,2019,11,536,697,1233,2019-11-24 10:00:00,2019-11-24 00:00:00,LABORABLE
24,11,2019,12,607,799,1406,2019-11-24 11:00:00,2019-11-24 00:00:00,LABORABLE
24,11,2019,13,619,730,1349,2019-11-24 12:00:00,2019-11-24 00:00:00,LABORABLE
24,11,2019,14,597,756,1353,2019-11-24 13:00:00,2019-11-24 00:00:00,LABORABLE
24,11,2019,15,724,739,1463,2019-11-24 14:00:00,2019-11-24 00:00:00,LABORABLE
24,11,2019,16,596,781,1377,2019-11-24 15:00:00,2019-11-24 00:00:00,LABORABLE
24,11,2019,17,633,751,1384,2019-11-24 16:00:00,2019-11-24 00:00:00,LABORABLE
24,11,2019,18,673,791,1464,2019-11-24 17:00:00,2019-11-24 00:00:00,LABORABLE
24,11,2019,19,651,609,1260,2019-11-24 18:00:00,2019-11-24 00:00:00,LABORABLE
24,11,2019,20,631,789,1420,2019-11-24 19:00:00,2019-11-24 00:00:00,LABORABLE
24,11,2019,21,674,843,1517,2019-11-24 20:00:00,2019-11-24 00:00:00,LABORABLE
24,11,2019,22,559,795,1354,2019-11-24 21:00:00,2019-11-24 00:00:00,LABORABLE
24,11,2019,23,518,666,1184,2019-11-24 22:00:00,2019-11-24 00:00:00,LABORABLE
24,11,2019,24,366,499,865,2019-11-24 23:00:00,2019-11-24 00:00:00,LABORABLE
25,11,2019,1,163,283,446,2019-11-25 00:00:00,2019-11-25 00:00:00,LABORABLE
25,11,2019,2,120,176,296,2019-11-25 01:00:00,2019-11-25 00:00:00,LABORABLE
25,11,2019,3,94,163,257,2019-11-25 02:00:00,2019-11-25 00:00:00,LABORABLE
25,11,2019,4,78,116,194,2019-11-25 03:00:00,2019-11-25 00:00:00,LABORABLE
25,11,2019,5,60,104,164,2019-11-25 04:00:00,2019-11-25 00:00:00,LABORABLE
25,11,2019,6,181,181,362,2019-11-25 05:00:00,2019-11-25 00:00:00,LABORABLE
25,11,2019,7,455,447,902,2019-11-25 06:00:00,2019-11-25 00:00:00,LABORABLE
25,11,2019,8,644,655,1299,2019-11-25 07:00:00,2019-11-25 00:00:00,LABORABLE
25,11,2019,9,723,606,1329,2019-11-25 08:00:00,2019-11-25 00:00:00,LABORABLE
25,11,2019,10,673,685,1358,2019-11-25 09:00:00,2019-11-25 00:00:00,LABORABLE
25,11,2019,11,618,699,1317,2019-11-25 10:00:00,2019-11-25 00:00:00,LABORABLE
25,11,2019,12,584,717,1301,2019-11-25 11:00:00,2019-11-25 00:00:00,LABORABLE
25,11,2019,13,603,664,1267,2019-11-25 12:00:00,2019-11-25 00:00:00,LABORABLE
25,11,2019,14,642,729,1371,2019-11-25 13:00:00,2019-11-25 00:00:00,LABORABLE
25,11,2019,15,674,763,1437,2019-11-25 14:00:00,2019-11-25 00:00:00,LABORABLE
25,11,2019,16,708,601,1309,2019-11-25 15:00:00,2019-11-25 00:00:00,LABORABLE
25,11,2019,17,662,746,1408,2019-11-25 16:00:00,2019-11-25 00:00:00,LABORABLE
25,11,2019,18,699,762,1461,2019-11-25 17:00:00,2019-11-25 00:00:00,LABORABLE
25,11,2019,19,669,753,1422,2019-11-25 18:00:00,2019-11-25 00:00:00,LABORABLE
25,11,2019,20,587,775,1362,2019-11-25 19:00:00,2019-11-25 00:00:00,LABORABLE
25,11,2019,21,629,734,1363,2019-11-25 20:00:00,2019-11-25 00:00:00,LABORABLE
25,11,2019,22,495,598,1093,2019-11-25 21:00:00,2019-11-25 00:00:00,LABORABLE
25,11,2019,23,397,430,827,2019-11-25 22:00:00,2019-11-25 00:00:00,LABORABLE
25,11,2019,24,232,288,520,2019-11-25 23:00:00,2019-11-25 00:00:00,LABORABLE
26,11,2019,1,153,222,375,2019-11-26 00:00:00,2019-11-26 00:00:00,LABORABLE
26,11,2019,2,96,146,242,2019-11-26 01:00:00,2019-11-26 00:00:00,LABORABLE
26,11,2019,3,72,116,188,2019-11-26 02:00:00,2019-11-26 00:00:00,LABORABLE
26,11,2019,4,70,87,157,2019-11-26 03:00:00,2019-11-26 00:00:00,LABORABLE
26,11,2019,5,79,98,177,2019-11-26 04:00:00,2019-11-26 00:00:00,LABORABLE
26,11,2019,6,180,160,340,2019-11-26 05:00:00,2019-11-26 00:00:00,LABORABLE
26,11,2019,7,464,441,905,2019-11-26 06:00:00,2019-11-26 00:00:00,LABORABLE
26,11,2019,8,635,590,1225,2019-11-26 07:00:00,2019-11-26 00:00:00,LABORABLE
26,11,2019,9,689,664,1353,2019-11-26 08:00:00,2019-11-26 00:00:00,LABORABLE
26,11,2019,10,667,715,1382,2019-11-26 09:00:00,2019-11-26 00:00:00,LABORABLE
26,11,2019,11,560,782,1342,2019-11-26 10:00:00,2019-11-26 00:00:00,LABORABLE
26,11,2019,12,584,686,1270,2019-11-26 11:00:00,2019-11-26 00:00:00,LABORABLE
26,11,2019,13,639,690,1329,2019-11-26 12:00:00,2019-11-26 00:00:00,LABORABLE
26,11,2019,14,651,719,1370,2019-11-26 13:00:00,2019-11-26 00:00:00,LABORABLE
26,11,2019,15,660,723,1383,2019-11-26 14:00:00,2019-11-26 00:00:00,LABORABLE
26,11,2019,16,688,658,1346,2019-11-26 15:00:00,2019-11-26 00:00:00,LABORABLE
26,11,2019,17,671,718,1389,2019-11-26 16:00:00,2019-11-26 00:00:00,LABORABLE
26,11,2019,18,678,767,1445,2019-11-26 17:00:00,2019-11-26 00:00:00,LABORABLE
26,11,2019,19,627,739,1366,2019-11-26 18:00:00,2019-11-26 00:00:00,LABORABLE
26,11,2019,20,620,714,1334,2019-11-26 19:00:00,2019-11-26 00:00:00,LABORABLE
26,11,2019,21,585,624,1209,2019-11-26 20:00:00,2019-11-26 00:00:00,LABORABLE
26,11,2019,22,526,560,1086,2019-11-26 21:00:00,2019-11-26 00:00:00,LABORABLE
26,11,2019,23,359,390,749,2019-11-26 22:00:00,2019-11-26 00:00:00,LABORABLE
26,11,2019,24,257,324,581,2019-11-26 23:00:00,2019-11-26 00:00:00,LABORABLE
27,11,2019,1,172,205,377,2019-11-27 00:00:00,2019-11-27 00:00:00,LABORABLE
27,11,2019,2,104,168,272,2019-11-27 01:00:00,2019-11-27 00:00:00,LABORABLE
27,11,2019,3,83,134,217,2019-11-27 02:00:00,2019-11-27 00:00:00,LABORABLE
27,11,2019,4,56,87,143,2019-11-27 03:00:00,2019-11-27 00:00:00,LABORABLE
27,11,2019,5,60,74,134,2019-11-27 04:00:00,2019-11-27 00:00:00,LABORABLE
27,11,2019,6,120,149,269,2019-11-27 05:00:00,2019-11-27 00:00:00,LABORABLE
27,11,2019,7,427,418,845,2019-11-27 06:00:00,2019-11-27 00:00:00,LABORABLE
27,11,2019,8,663,640,1303,2019-11-27 07:00:00,2019-11-27 00:00:00,LABORABLE
27,11,2019,9,672,687,1359,2019-11-27 08:00:00,2019-11-27 00:00:00,LABORABLE
27,11,2019,10,720,728,1448,2019-11-27 09:00:00,2019-11-27 00:00:00,LABORABLE
27,11,2019,11,558,768,1326,2019-11-27 10:00:00,2019-11-27 00:00:00,LABORABLE
27,11,2019,12,622,693,1315,2019-11-27 11:00:00,2019-11-27 00:00:00,LABORABLE
27,11,2019,13,608,785,1393,2019-11-27 12:00:00,2019-11-27 00:00:00,LABORABLE
27,11,2019,14,650,714,1364,2019-11-27 13:00:00,2019-11-27 00:00:00,LABORABLE
27,11,2019,15,652,747,1399,2019-11-27 14:00:00,2019-11-27 00:00:00,LABORABLE
27,11,2019,16,676,663,1339,2019-11-27 15:00:00,2019-11-27 00:00:00,LABORABLE
27,11,2019,17,693,768,1461,2019-11-27 16:00:00,2019-11-27 00:00:00,LABORABLE
27,11,2019,18,743,801,1544,2019-11-27 17:00:00,2019-11-27 00:00:00,LABORABLE
27,11,2019,19,645,735,1380,2019-11-27 18:00:00,2019-11-27 00:00:00,LABORABLE
27,11,2019,20,616,759,1375,2019-11-27 19:00:00,2019-11-27 00:00:00,LABORABLE
27,11,2019,21,596,705,1301,2019-11-27 20:00:00,2019-11-27 00:00:00,LABORABLE
27,11,2019,22,539,558,1097,2019-11-27 21:00:00,2019-11-27 00:00:00,LABORABLE
27,11,2019,23,439,475,914,2019-11-27 22:00:00,2019-11-27 00:00:00,LABORABLE
27,11,2019,24,285,367,652,2019-11-27 23:00:00,2019-11-27 00:00:00,LABORABLE
28,11,2019,1,219,314,533,2019-11-28 00:00:00,2019-11-28 00:00:00,LABORABLE
28,11,2019,2,121,193,314,2019-11-28 01:00:00,2019-11-28 00:00:00,LABORABLE
28,11,2019,3,78,142,220,2019-11-28 02:00:00,2019-11-28 00:00:00,LABORABLE
28,11,2019,4,88,125,213,2019-11-28 03:00:00,2019-11-28 00:00:00,LABORABLE
28,11,2019,5,57,110,167,2019-11-28 04:00:00,2019-11-28 00:00:00,LABORABLE
28,11,2019,6,161,165,326,2019-11-28 05:00:00,2019-11-28 00:00:00,LABORABLE
28,11,2019,7,444,455,899,2019-11-28 06:00:00,2019-11-28 00:00:00,LABORABLE
28,11,2019,8,675,671,1346,2019-11-28 07:00:00,2019-11-28 00:00:00,LABORABLE
28,11,2019,9,713,711,1424,2019-11-28 08:00:00,2019-11-28 00:00:00,LABORABLE
28,11,2019,10,683,722,1405,2019-11-28 09:00:00,2019-11-28 00:00:00,LABORABLE
28,11,2019,11,613,629,1242,2019-11-28 10:00:00,2019-11-28 00:00:00,LABORABLE
28,11,2019,12,642,726,1368,2019-11-28 11:00:00,2019-11-28 00:00:00,LABORABLE
28,11,2019,13,725,718,1443,2019-11-28 12:00:00,2019-11-28 00:00:00,LABORABLE
28,11,2019,14,789,763,1552,2019-11-28 13:00:00,2019-11-28 00:00:00,LABORABLE
28,11,2019,15,731,671,1402,2019-11-28 14:00:00,2019-11-28 00:00:00,LABORABLE
28,11,2019,16,708,689,1397,2019-11-28 15:00:00,2019-11-28 00:00:00,LABORABLE
28,11,2019,17,631,714,1345,2019-11-28 16:00:00,2019-11-28 00:00:00,LABORABLE
28,11,2019,18,689,814,1503,2019-11-28 17:00:00,2019-11-28 00:00:00,LABORABLE
28,11,2019,19,696,761,1457,2019-11-28 18:00:00,2019-11-28 00:00:00,LABORABLE
28,11,2019,20,661,784,1445,2019-11-28 19:00:00,2019-11-28 00:00:00,LABORABLE
28,11,2019,21,694,691,1385,2019-11-28 20:00:00,2019-11-28 00:00:00,LABORABLE
28,11,2019,22,599,630,1229,2019-11-28 21:00:00,2019-11-28 00:00:00,LABORABLE
28,11,2019,23,470,483,953,2019-11-28 22:00:00,2019-11-28 00:00:00,LABORABLE
28,11,2019,24,346,320,666,2019-11-28 23:00:00,2019-11-28 00:00:00,LABORABLE
29,11,2019,1,227,295,522,2019-11-29 00:00:00,2019-11-29 00:00:00,LABORABLE
29,11,2019,2,152,252,404,2019-11-29 01:00:00,2019-11-29 00:00:00,LABORABLE
29,11,2019,3,110,168,278,2019-11-29 02:00:00,2019-11-29 00:00:00,LABORABLE
29,11,2019,4,87,130,217,2019-11-29 03:00:00,2019-11-29 00:00:00,LABORABLE
29,11,2019,5,100,136,236,2019-11-29 04:00:00,2019-11-29 00:00:00,LABORABLE
29,11,2019,6,132,167,299,2019-11-29 05:00:00,2019-11-29 00:00:00,LABORABLE
29,11,2019,7,426,467,893,2019-11-29 06:00:00,2019-11-29 00:00:00,LABORABLE
29,11,2019,8,691,614,1305,2019-11-29 07:00:00,2019-11-29 00:00:00,LABORABLE
29,11,2019,9,670,678,1348,2019-11-29 08:00:00,2019-11-29 00:00:00,LABORABLE
29,11,2019,10,693,706,1399,2019-11-29 09:00:00,2019-11-29 00:00:00,LABORABLE
29,11,2019,11,627,666,1293,2019-11-29 10:00:00,2019-11-29 00:00:00,LABORABLE
29,11,2019,12,661,661,1322,2019-11-29 11:00:00,2019-11-29 00:00:00,LABORABLE
29,11,2019,13,702,729,1431,2019-11-29 12:00:00,2019-11-29 00:00:00,LABORABLE
29,11,2019,14,517,606,1123,2019-11-29 13:00:00,2019-11-29 00:00:00,LABORABLE
29,11,2019,15,671,740,1411,2019-11-29 14:00:00,2019-11-29 00:00:00,LABORABLE
29,11,2019,16,684,792,1476,2019-11-29 15:00:00,2019-11-29 00:00:00,LABORABLE
29,11,2019,17,699,757,1456,2019-11-29 16:00:00,2019-11-29 00:00:00,LABORABLE
29,11,2019,18,746,800,1546,2019-11-29 17:00:00,2019-11-29 00:00:00,LABORABLE
29,11,2019,19,742,797,1539,2019-11-29 18:00:00,2019-11-29 00:00:00,LABORABLE
29,11,2019,20,673,850,1523,2019-11-29 19:00:00,2019-11-29 00:00:00,LABORABLE
29,11,2019,21,576,869,1445,2019-11-29 20:00:00,2019-11-29 00:00:00,LABORABLE
29,11,2019,22,570,730,1300,2019-11-29 21:00:00,2019-11-29 00:00:00,LABORABLE
29,11,2019,23,510,592,1102,2019-11-29 22:00:00,2019-11-29 00:00:00,LABORABLE
29,11,2019,24,447,521,968,2019-11-29 23:00:00,2019-11-29 00:00:00,LABORABLE
30,11,2019,1,190,221,411,2019-11-30 00:00:00,2019-11-30 00:00:00,LABORABLE
30,11,2019,2,81,115,196,2019-11-30 01:00:00,2019-11-30 00:00:00,LABORABLE
30,11,2019,3,52,76,128,2019-11-30 02:00:00,2019-11-30 00:00:00,LABORABLE
30,11,2019,4,51,56,107,2019-11-30 03:00:00,2019-11-30 00:00:00,LABORABLE
30,11,2019,5,54,58,112,2019-11-30 04:00:00,2019-11-30 00:00:00,LABORABLE
30,11,2019,6,135,132,267,2019-11-30 05:00:00,2019-11-30 00:00:00,LABORABLE
30,11,2019,7,361,401,762,2019-11-30 06:00:00,2019-11-30 00:00:00,LABORABLE
30,11,2019,8,610,625,1235,2019-11-30 07:00:00,2019-11-30 00:00:00,LABORABLE
30,11,2019,9,605,730,1335,2019-11-30 08:00:00,2019-11-30 00:00:00,LABORABLE
30,11,2019,10,604,778,1382,2019-11-30 09:00:00,2019-11-30 00:00:00,LABORABLE
30,11,2019,11,531,701,1232,2019-11-30 10:00:00,2019-11-30 00:00:00,LABORABLE
30,11,2019,12,591,773,1364,2019-11-30 11:00:00,2019-11-30 00:00:00,LABORABLE
30,11,2019,13,622,768,1390,2019-11-30 12:00:00,2019-11-30 00:00:00,LABORABLE
30,11,2019,14,586,806,1392,2019-11-30 13:00:00,2019-11-30 00:00:00,LABORABLE
30,11,2019,15,635,788,1423,2019-11-30 14:00:00,2019-11-30 00:00:00,LABORABLE
30,11,2019,16,633,713,1346,2019-11-30 15:00:00,2019-11-30 00:00:00,LABORABLE
30,11,2019,17,648,755,1403,2019-11-30 16:00:00,2019-11-30 00:00:00,LABORABLE
30,11,2019,18,681,792,1473,2019-11-30 17:00:00,2019-11-30 00:00:00,LABORABLE
30,11,2019,19,685,851,1536,2019-11-30 18:00:00,2019-11-30 00:00:00,LABORABLE
30,11,2019,20,675,823,1498,2019-11-30 19:00:00,2019-11-30 00:00:00,LABORABLE
30,11,2019,21,653,811,1464,2019-11-30 20:00:00,2019-11-30 00:00:00,LABORABLE
30,11,2019,22,558,695,1253,2019-11-30 21:00:00,2019-11-30 00:00:00,LABORABLE
30,11,2019,23,439,550,989,2019-11-30 22:00:00,2019-11-30 00:00:00,LABORABLE
30,11,2019,24,298,382,680,2019-11-30 23:00:00,2019-11-30 00:00:00,LABORABLE
1,12,2019,1,394,553,947,2019-12-01 00:00:00,2019-01-12 00:00:00,LABORABLE
1,12,2019,2,354,434,788,2019-12-01 01:00:00,2019-01-12 00:00:00,LABORABLE
1,12,2019,3,280,392,672,2019-12-01 02:00:00,2019-01-12 00:00:00,LABORABLE
1,12,2019,4,207,347,554,2019-12-01 03:00:00,2019-01-12 00:00:00,LABORABLE
1,12,2019,5,174,324,498,2019-12-01 04:00:00,2019-01-12 00:00:00,LABORABLE
1,12,2019,6,152,266,418,2019-12-01 05:00:00,2019-01-12 00:00:00,LABORABLE
1,12,2019,7,207,297,504,2019-12-01 06:00:00,2019-01-12 00:00:00,LABORABLE
1,12,2019,8,195,269,464,2019-12-01 07:00:00,2019-01-12 00:00:00,LABORABLE
1,12,2019,9,220,317,537,2019-12-01 08:00:00,2019-01-12 00:00:00,LABORABLE
1,12,2019,10,357,371,728,2019-12-01 09:00:00,2019-01-12 00:00:00,LABORABLE
1,12,2019,11,435,524,959,2019-12-01 10:00:00,2019-01-12 00:00:00,LABORABLE
1,12,2019,12,546,603,1149,2019-12-01 11:00:00,2019-01-12 00:00:00,LABORABLE
1,12,2019,13,585,687,1272,2019-12-01 12:00:00,2019-01-12 00:00:00,LABORABLE
1,12,2019,14,521,711,1232,2019-12-01 13:00:00,2019-01-12 00:00:00,LABORABLE
1,12,2019,15,606,750,1356,2019-12-01 14:00:00,2019-01-12 00:00:00,LABORABLE
1,12,2019,16,522,647,1169,2019-12-01 15:00:00,2019-01-12 00:00:00,LABORABLE
1,12,2019,17,532,681,1213,2019-12-01 16:00:00,2019-01-12 00:00:00,LABORABLE
1,12,2019,18,565,702,1267,2019-12-01 17:00:00,2019-01-12 00:00:00,LABORABLE
1,12,2019,19,570,752,1322,2019-12-01 18:00:00,2019-01-12 00:00:00,LABORABLE
1,12,2019,20,567,661,1228,2019-12-01 19:00:00,2019-01-12 00:00:00,LABORABLE
1,12,2019,21,552,652,1204,2019-12-01 20:00:00,2019-01-12 00:00:00,LABORABLE
1,12,2019,22,439,487,926,2019-12-01 21:00:00,2019-01-12 00:00:00,LABORABLE
1,12,2019,23,365,406,771,2019-12-01 22:00:00,2019-01-12 00:00:00,LABORABLE
1,12,2019,24,305,355,660,2019-12-01 23:00:00,2019-01-12 00:00:00,LABORABLE
2,12,2019,1,209,266,475,2019-12-02 00:00:00,2019-02-12 00:00:00,LABORABLE
2,12,2019,2,120,181,301,2019-12-02 01:00:00,2019-02-12 00:00:00,LABORABLE
2,12,2019,3,87,170,257,2019-12-02 02:00:00,2019-02-12 00:00:00,LABORABLE
2,12,2019,4,82,131,213,2019-12-02 03:00:00,2019-02-12 00:00:00,LABORABLE
2,12,2019,5,80,109,189,2019-12-02 04:00:00,2019-02-12 00:00:00,LABORABLE
2,12,2019,6,181,186,367,2019-12-02 05:00:00,2019-02-12 00:00:00,LABORABLE
2,12,2019,7,361,453,814,2019-12-02 06:00:00,2019-02-12 00:00:00,LABORABLE
2,12,2019,8,694,618,1312,2019-12-02 07:00:00,2019-02-12 00:00:00,LABORABLE
2,12,2019,9,693,705,1398,2019-12-02 08:00:00,2019-02-12 00:00:00,LABORABLE
2,12,2019,10,674,742,1416,2019-12-02 09:00:00,2019-02-12 00:00:00,LABORABLE
2,12,2019,11,553,664,1217,2019-12-02 10:00:00,2019-02-12 00:00:00,LABORABLE
2,12,2019,12,592,691,1283,2019-12-02 11:00:00,2019-02-12 00:00:00,LABORABLE
2,12,2019,13,532,619,1151,2019-12-02 12:00:00,2019-02-12 00:00:00,LABORABLE
2,12,2019,14,661,743,1404,2019-12-02 13:00:00,2019-02-12 00:00:00,LABORABLE
2,12,2019,15,687,758,1445,2019-12-02 14:00:00,2019-02-12 00:00:00,LABORABLE
2,12,2019,16,685,713,1398,2019-12-02 15:00:00,2019-02-12 00:00:00,LABORABLE
2,12,2019,17,691,785,1476,2019-12-02 16:00:00,2019-02-12 00:00:00,LABORABLE
2,12,2019,18,728,756,1484,2019-12-02 17:00:00,2019-02-12 00:00:00,LABORABLE
2,12,2019,19,702,780,1482,2019-12-02 18:00:00,2019-02-12 00:00:00,LABORABLE
2,12,2019,20,635,801,1436,2019-12-02 19:00:00,2019-02-12 00:00:00,LABORABLE
2,12,2019,21,645,723,1368,2019-12-02 20:00:00,2019-02-12 00:00:00,LABORABLE
2,12,2019,22,528,599,1127,2019-12-02 21:00:00,2019-02-12 00:00:00,LABORABLE
2,12,2019,23,395,439,834,2019-12-02 22:00:00,2019-02-12 00:00:00,LABORABLE
2,12,2019,24,257,267,524,2019-12-02 23:00:00,2019-02-12 00:00:00,LABORABLE
3,12,2019,1,131,249,380,2019-12-03 00:00:00,2019-03-12 00:00:00,LABORABLE
3,12,2019,2,122,167,289,2019-12-03 01:00:00,2019-03-12 00:00:00,LABORABLE
3,12,2019,3,78,113,191,2019-12-03 02:00:00,2019-03-12 00:00:00,LABORABLE
3,12,2019,4,70,109,179,2019-12-03 03:00:00,2019-03-12 00:00:00,LABORABLE
3,12,2019,5,64,95,159,2019-12-03 04:00:00,2019-03-12 00:00:00,LABORABLE
3,12,2019,6,178,168,346,2019-12-03 05:00:00,2019-03-12 00:00:00,LABORABLE
3,12,2019,7,479,442,921,2019-12-03 06:00:00,2019-03-12 00:00:00,LABORABLE
3,12,2019,8,644,590,1234,2019-12-03 07:00:00,2019-03-12 00:00:00,LABORABLE
3,12,2019,9,728,677,1405,2019-12-03 08:00:00,2019-03-12 00:00:00,LABORABLE
3,12,2019,10,730,773,1503,2019-12-03 09:00:00,2019-03-12 00:00:00,LABORABLE
3,12,2019,11,541,544,1085,2019-12-03 10:00:00,2019-03-12 00:00:00,LABORABLE
3,12,2019,12,711,717,1428,2019-12-03 11:00:00,2019-03-12 00:00:00,LABORABLE
3,12,2019,13,663,786,1449,2019-12-03 12:00:00,2019-03-12 00:00:00,LABORABLE
3,12,2019,14,768,794,1562,2019-12-03 13:00:00,2019-03-12 00:00:00,LABORABLE
3,12,2019,15,730,710,1440,2019-12-03 14:00:00,2019-03-12 00:00:00,LABORABLE
3,12,2019,16,702,717,1419,2019-12-03 15:00:00,2019-03-12 00:00:00,LABORABLE
3,12,2019,17,723,825,1548,2019-12-03 16:00:00,2019-03-12 00:00:00,LABORABLE
3,12,2019,18,690,833,1523,2019-12-03 17:00:00,2019-03-12 00:00:00,LABORABLE
3,12,2019,19,658,806,1464,2019-12-03 18:00:00,2019-03-12 00:00:00,LABORABLE
3,12,2019,20,668,729,1397,2019-12-03 19:00:00,2019-03-12 00:00:00,LABORABLE
3,12,2019,21,657,783,1440,2019-12-03 20:00:00,2019-03-12 00:00:00,LABORABLE
3,12,2019,22,512,593,1105,2019-12-03 21:00:00,2019-03-12 00:00:00,LABORABLE
3,12,2019,23,425,433,858,2019-12-03 22:00:00,2019-03-12 00:00:00,LABORABLE
3,12,2019,24,269,371,640,2019-12-03 23:00:00,2019-03-12 00:00:00,LABORABLE
4,12,2019,1,197,249,446,2019-12-04 00:00:00,2019-04-12 00:00:00,LABORABLE
4,12,2019,2,124,180,304,2019-12-04 01:00:00,2019-04-12 00:00:00,LABORABLE
4,12,2019,3,82,132,214,2019-12-04 02:00:00,2019-04-12 00:00:00,LABORABLE
4,12,2019,4,82,115,197,2019-12-04 03:00:00,2019-04-12 00:00:00,LABORABLE
4,12,2019,5,93,98,191,2019-12-04 04:00:00,2019-04-12 00:00:00,LABORABLE
4,12,2019,6,187,180,367,2019-12-04 05:00:00,2019-04-12 00:00:00,LABORABLE
4,12,2019,7,460,444,904,2019-12-04 06:00:00,2019-04-12 00:00:00,LABORABLE
4,12,2019,8,647,611,1258,2019-12-04 07:00:00,2019-04-12 00:00:00,LABORABLE
4,12,2019,9,696,692,1388,2019-12-04 08:00:00,2019-04-12 00:00:00,LABORABLE
4,12,2019,10,634,717,1351,2019-12-04 09:00:00,2019-04-12 00:00:00,LABORABLE
4,12,2019,11,629,656,1285,2019-12-04 10:00:00,2019-04-12 00:00:00,LABORABLE
4,12,2019,12,528,809,1337,2019-12-04 11:00:00,2019-04-12 00:00:00,LABORABLE
4,12,2019,13,572,782,1354,2019-12-04 12:00:00,2019-04-12 00:00:00,LABORABLE
4,12,2019,14,635,760,1395,2019-12-04 13:00:00,2019-04-12 00:00:00,LABORABLE
4,12,2019,15,723,718,1441,2019-12-04 14:00:00,2019-04-12 00:00:00,LABORABLE
4,12,2019,16,658,682,1340,2019-12-04 15:00:00,2019-04-12 00:00:00,LABORABLE
4,12,2019,17,646,705,1351,2019-12-04 16:00:00,2019-04-12 00:00:00,LABORABLE
4,12,2019,18,707,744,1451,2019-12-04 17:00:00,2019-04-12 00:00:00,LABORABLE
4,12,2019,19,676,741,1417,2019-12-04 18:00:00,2019-04-12 00:00:00,LABORABLE
4,12,2019,20,628,750,1378,2019-12-04 19:00:00,2019-04-12 00:00:00,LABORABLE
4,12,2019,21,656,797,1453,2019-12-04 20:00:00,2019-04-12 00:00:00,LABORABLE
4,12,2019,22,535,622,1157,2019-12-04 21:00:00,2019-04-12 00:00:00,LABORABLE
4,12,2019,23,437,500,937,2019-12-04 22:00:00,2019-04-12 00:00:00,LABORABLE
4,12,2019,24,262,392,654,2019-12-04 23:00:00,2019-04-12 00:00:00,LABORABLE
5,12,2019,1,207,319,526,2019-12-05 00:00:00,2019-05-12 00:00:00,LABORABLE
5,12,2019,2,139,194,333,2019-12-05 01:00:00,2019-05-12 00:00:00,LABORABLE
5,12,2019,3,90,158,248,2019-12-05 02:00:00,2019-05-12 00:00:00,LABORABLE
5,12,2019,4,102,123,225,2019-12-05 03:00:00,2019-05-12 00:00:00,LABORABLE
5,12,2019,5,84,107,191,2019-12-05 04:00:00,2019-05-12 00:00:00,LABORABLE
5,12,2019,6,191,175,366,2019-12-05 05:00:00,2019-05-12 00:00:00,LABORABLE
5,12,2019,7,309,454,763,2019-12-05 06:00:00,2019-05-12 00:00:00,LABORABLE
5,12,2019,8,630,575,1205,2019-12-05 07:00:00,2019-05-12 00:00:00,LABORABLE
5,12,2019,9,734,715,1449,2019-12-05 08:00:00,2019-05-12 00:00:00,LABORABLE
5,12,2019,10,736,699,1435,2019-12-05 09:00:00,2019-05-12 00:00:00,LABORABLE
5,12,2019,11,603,755,1358,2019-12-05 10:00:00,2019-05-12 00:00:00,LABORABLE
5,12,2019,12,623,852,1475,2019-12-05 11:00:00,2019-05-12 00:00:00,LABORABLE
5,12,2019,13,687,761,1448,2019-12-05 12:00:00,2019-05-12 00:00:00,LABORABLE
5,12,2019,14,700,779,1479,2019-12-05 13:00:00,2019-05-12 00:00:00,LABORABLE
5,12,2019,15,693,764,1457,2019-12-05 14:00:00,2019-05-12 00:00:00,LABORABLE
5,12,2019,16,682,752,1434,2019-12-05 15:00:00,2019-05-12 00:00:00,LABORABLE
5,12,2019,17,693,764,1457,2019-12-05 16:00:00,2019-05-12 00:00:00,LABORABLE
5,12,2019,18,740,779,1519,2019-12-05 17:00:00,2019-05-12 00:00:00,LABORABLE
5,12,2019,19,730,856,1586,2019-12-05 18:00:00,2019-05-12 00:00:00,LABORABLE
5,12,2019,20,731,806,1537,2019-12-05 19:00:00,2019-05-12 00:00:00,LABORABLE
5,12,2019,21,677,822,1499,2019-12-05 20:00:00,2019-05-12 00:00:00,LABORABLE
5,12,2019,22,676,690,1366,2019-12-05 21:00:00,2019-05-12 00:00:00,LABORABLE
5,12,2019,23,550,657,1207,2019-12-05 22:00:00,2019-05-12 00:00:00,LABORABLE
5,12,2019,24,392,509,901,2019-12-05 23:00:00,2019-05-12 00:00:00,LABORABLE
6,12,2019,1,308,413,721,2019-12-06 00:00:00,2019-06-12 00:00:00,FESTIVO
6,12,2019,2,209,270,479,2019-12-06 01:00:00,2019-06-12 00:00:00,FESTIVO
6,12,2019,3,166,259,425,2019-12-06 02:00:00,2019-06-12 00:00:00,FESTIVO
6,12,2019,4,119,209,328,2019-12-06 03:00:00,2019-06-12 00:00:00,FESTIVO
6,12,2019,5,111,183,294,2019-12-06 04:00:00,2019-06-12 00:00:00,FESTIVO
6,12,2019,6,131,216,347,2019-12-06 05:00:00,2019-06-12 00:00:00,FESTIVO
6,12,2019,7,206,240,446,2019-12-06 06:00:00,2019-06-12 00:00:00,FESTIVO
6,12,2019,8,242,262,504,2019-12-06 07:00:00,2019-06-12 00:00:00,FESTIVO
6,12,2019,9,316,324,640,2019-12-06 08:00:00,2019-06-12 00:00:00,FESTIVO
6,12,2019,10,369,442,811,2019-12-06 09:00:00,2019-06-12 00:00:00,FESTIVO
6,12,2019,11,503,511,1014,2019-12-06 10:00:00,2019-06-12 00:00:00,FESTIVO
6,12,2019,12,551,621,1172,2019-12-06 11:00:00,2019-06-12 00:00:00,FESTIVO
6,12,2019,13,545,701,1246,2019-12-06 12:00:00,2019-06-12 00:00:00,FESTIVO
6,12,2019,14,585,741,1326,2019-12-06 13:00:00,2019-06-12 00:00:00,FESTIVO
6,12,2019,15,506,704,1210,2019-12-06 14:00:00,2019-06-12 00:00:00,FESTIVO
6,12,2019,16,455,618,1073,2019-12-06 15:00:00,2019-06-12 00:00:00,FESTIVO
6,12,2019,17,475,658,1133,2019-12-06 16:00:00,2019-06-12 00:00:00,FESTIVO
6,12,2019,18,531,696,1227,2019-12-06 17:00:00,2019-06-12 00:00:00,FESTIVO
6,12,2019,19,572,720,1292,2019-12-06 18:00:00,2019-06-12 00:00:00,FESTIVO
6,12,2019,20,576,718,1294,2019-12-06 19:00:00,2019-06-12 00:00:00,FESTIVO
6,12,2019,21,486,680,1166,2019-12-06 20:00:00,2019-06-12 00:00:00,FESTIVO
6,12,2019,22,498,686,1184,2019-12-06 21:00:00,2019-06-12 00:00:00,FESTIVO
6,12,2019,23,509,625,1134,2019-12-06 22:00:00,2019-06-12 00:00:00,FESTIVO
6,12,2019,24,416,574,990,2019-12-06 23:00:00,2019-06-12 00:00:00,FESTIVO
7,12,2019,1,380,438,818,2019-12-07 00:00:00,2019-07-12 00:00:00,LABORABLE
7,12,2019,2,260,389,649,2019-12-07 01:00:00,2019-07-12 00:00:00,LABORABLE
7,12,2019,3,210,303,513,2019-12-07 02:00:00,2019-07-12 00:00:00,LABORABLE
7,12,2019,4,191,307,498,2019-12-07 03:00:00,2019-07-12 00:00:00,LABORABLE
7,12,2019,5,162,264,426,2019-12-07 04:00:00,2019-07-12 00:00:00,LABORABLE
7,12,2019,6,161,246,407,2019-12-07 05:00:00,2019-07-12 00:00:00,LABORABLE
7,12,2019,7,234,323,557,2019-12-07 06:00:00,2019-07-12 00:00:00,LABORABLE
7,12,2019,8,246,305,551,2019-12-07 07:00:00,2019-07-12 00:00:00,LABORABLE
7,12,2019,9,327,332,659,2019-12-07 08:00:00,2019-07-12 00:00:00,LABORABLE
7,12,2019,10,403,470,873,2019-12-07 09:00:00,2019-07-12 00:00:00,LABORABLE
7,12,2019,11,525,631,1156,2019-12-07 10:00:00,2019-07-12 00:00:00,LABORABLE
7,12,2019,12,576,683,1259,2019-12-07 11:00:00,2019-07-12 00:00:00,LABORABLE
7,12,2019,13,622,759,1381,2019-12-07 12:00:00,2019-07-12 00:00:00,LABORABLE
7,12,2019,14,631,778,1409,2019-12-07 13:00:00,2019-07-12 00:00:00,LABORABLE
7,12,2019,15,572,755,1327,2019-12-07 14:00:00,2019-07-12 00:00:00,LABORABLE
7,12,2019,16,528,695,1223,2019-12-07 15:00:00,2019-07-12 00:00:00,LABORABLE
7,12,2019,17,530,716,1246,2019-12-07 16:00:00,2019-07-12 00:00:00,LABORABLE
7,12,2019,18,544,788,1332,2019-12-07 17:00:00,2019-07-12 00:00:00,LABORABLE
7,12,2019,19,608,792,1400,2019-12-07 18:00:00,2019-07-12 00:00:00,LABORABLE
7,12,2019,20,611,751,1362,2019-12-07 19:00:00,2019-07-12 00:00:00,LABORABLE
7,12,2019,21,517,748,1265,2019-12-07 20:00:00,2019-07-12 00:00:00,LABORABLE
7,12,2019,22,542,620,1162,2019-12-07 21:00:00,2019-07-12 00:00:00,LABORABLE
7,12,2019,23,526,605,1131,2019-12-07 22:00:00,2019-07-12 00:00:00,LABORABLE
7,12,2019,24,513,566,1079,2019-12-07 23:00:00,2019-07-12 00:00:00,LABORABLE
8,12,2019,1,392,522,914,2019-12-08 00:00:00,2019-08-12 00:00:00,LABORABLE
8,12,2019,2,294,402,696,2019-12-08 01:00:00,2019-08-12 00:00:00,LABORABLE
8,12,2019,3,251,352,603,2019-12-08 02:00:00,2019-08-12 00:00:00,LABORABLE
8,12,2019,4,196,289,485,2019-12-08 03:00:00,2019-08-12 00:00:00,LABORABLE
8,12,2019,5,163,270,433,2019-12-08 04:00:00,2019-08-12 00:00:00,LABORABLE
8,12,2019,6,151,268,419,2019-12-08 05:00:00,2019-08-12 00:00:00,LABORABLE
8,12,2019,7,212,281,493,2019-12-08 06:00:00,2019-08-12 00:00:00,LABORABLE
8,12,2019,8,180,238,418,2019-12-08 07:00:00,2019-08-12 00:00:00,LABORABLE
8,12,2019,9,207,269,476,2019-12-08 08:00:00,2019-08-12 00:00:00,LABORABLE
8,12,2019,10,269,349,618,2019-12-08 09:00:00,2019-08-12 00:00:00,LABORABLE
8,12,2019,11,368,453,821,2019-12-08 10:00:00,2019-08-12 00:00:00,LABORABLE
8,12,2019,12,481,560,1041,2019-12-08 11:00:00,2019-08-12 00:00:00,LABORABLE
8,12,2019,13,522,628,1150,2019-12-08 12:00:00,2019-08-12 00:00:00,LABORABLE
8,12,2019,14,549,687,1236,2019-12-08 13:00:00,2019-08-12 00:00:00,LABORABLE
8,12,2019,15,537,650,1187,2019-12-08 14:00:00,2019-08-12 00:00:00,LABORABLE
8,12,2019,16,452,650,1102,2019-12-08 15:00:00,2019-08-12 00:00:00,LABORABLE
8,12,2019,17,449,664,1113,2019-12-08 16:00:00,2019-08-12 00:00:00,LABORABLE
8,12,2019,18,527,731,1258,2019-12-08 17:00:00,2019-08-12 00:00:00,LABORABLE
8,12,2019,19,524,693,1217,2019-12-08 18:00:00,2019-08-12 00:00:00,LABORABLE
8,12,2019,20,517,706,1223,2019-12-08 19:00:00,2019-08-12 00:00:00,LABORABLE
8,12,2019,21,486,634,1120,2019-12-08 20:00:00,2019-08-12 00:00:00,LABORABLE
8,12,2019,22,436,569,1005,2019-12-08 21:00:00,2019-08-12 00:00:00,LABORABLE
8,12,2019,23,421,450,871,2019-12-08 22:00:00,2019-08-12 00:00:00,LABORABLE
8,12,2019,24,309,402,711,2019-12-08 23:00:00,2019-08-12 00:00:00,LABORABLE
9,12,2019,1,263,326,589,2019-12-09 00:00:00,2019-09-12 00:00:00,FESTIVO
9,12,2019,2,170,278,448,2019-12-09 01:00:00,2019-09-12 00:00:00,FESTIVO
9,12,2019,3,131,206,337,2019-12-09 02:00:00,2019-09-12 00:00:00,FESTIVO
9,12,2019,4,122,157,279,2019-12-09 03:00:00,2019-09-12 00:00:00,FESTIVO
9,12,2019,5,84,130,214,2019-12-09 04:00:00,2019-09-12 00:00:00,FESTIVO
9,12,2019,6,144,148,292,2019-12-09 05:00:00,2019-09-12 00:00:00,FESTIVO
9,12,2019,7,190,242,432,2019-12-09 06:00:00,2019-09-12 00:00:00,FESTIVO
9,12,2019,8,232,235,467,2019-12-09 07:00:00,2019-09-12 00:00:00,FESTIVO
9,12,2019,9,236,272,508,2019-12-09 08:00:00,2019-09-12 00:00:00,FESTIVO
9,12,2019,10,299,400,699,2019-12-09 09:00:00,2019-09-12 00:00:00,FESTIVO
9,12,2019,11,343,435,778,2019-12-09 10:00:00,2019-09-12 00:00:00,FESTIVO
9,12,2019,12,496,502,998,2019-12-09 11:00:00,2019-09-12 00:00:00,FESTIVO
9,12,2019,13,515,564,1079,2019-12-09 12:00:00,2019-09-12 00:00:00,FESTIVO
9,12,2019,14,518,675,1193,2019-12-09 13:00:00,2019-09-12 00:00:00,FESTIVO
9,12,2019,15,522,598,1120,2019-12-09 14:00:00,2019-09-12 00:00:00,FESTIVO
9,12,2019,16,450,616,1066,2019-12-09 15:00:00,2019-09-12 00:00:00,FESTIVO
9,12,2019,17,432,637,1069,2019-12-09 16:00:00,2019-09-12 00:00:00,FESTIVO
9,12,2019,18,572,705,1277,2019-12-09 17:00:00,2019-09-12 00:00:00,FESTIVO
9,12,2019,19,510,669,1179,2019-12-09 18:00:00,2019-09-12 00:00:00,FESTIVO
9,12,2019,20,489,738,1227,2019-12-09 19:00:00,2019-09-12 00:00:00,FESTIVO
9,12,2019,21,521,650,1171,2019-12-09 20:00:00,2019-09-12 00:00:00,FESTIVO
9,12,2019,22,472,579,1051,2019-12-09 21:00:00,2019-09-12 00:00:00,FESTIVO
9,12,2019,23,387,481,868,2019-12-09 22:00:00,2019-09-12 00:00:00,FESTIVO
9,12,2019,24,257,313,570,2019-12-09 23:00:00,2019-09-12 00:00:00,FESTIVO
10,12,2019,1,180,218,398,2019-12-10 00:00:00,2019-10-12 00:00:00,LABORABLE
10,12,2019,2,103,165,268,2019-12-10 01:00:00,2019-10-12 00:00:00,LABORABLE
10,12,2019,3,87,140,227,2019-12-10 02:00:00,2019-10-12 00:00:00,LABORABLE
10,12,2019,4,79,88,167,2019-12-10 03:00:00,2019-10-12 00:00:00,LABORABLE
10,12,2019,5,64,86,150,2019-12-10 04:00:00,2019-10-12 00:00:00,LABORABLE
10,12,2019,6,124,151,275,2019-12-10 05:00:00,2019-10-12 00:00:00,LABORABLE
10,12,2019,7,456,414,870,2019-12-10 06:00:00,2019-10-12 00:00:00,LABORABLE
10,12,2019,8,612,581,1193,2019-12-10 07:00:00,2019-10-12 00:00:00,LABORABLE
10,12,2019,9,687,675,1362,2019-12-10 08:00:00,2019-10-12 00:00:00,LABORABLE
10,12,2019,10,637,721,1358,2019-12-10 09:00:00,2019-10-12 00:00:00,LABORABLE
10,12,2019,11,554,694,1248,2019-12-10 10:00:00,2019-10-12 00:00:00,LABORABLE
10,12,2019,12,630,755,1385,2019-12-10 11:00:00,2019-10-12 00:00:00,LABORABLE
10,12,2019,13,658,760,1418,2019-12-10 12:00:00,2019-10-12 00:00:00,LABORABLE
10,12,2019,14,647,738,1385,2019-12-10 13:00:00,2019-10-12 00:00:00,LABORABLE
10,12,2019,15,644,778,1422,2019-12-10 14:00:00,2019-10-12 00:00:00,LABORABLE
10,12,2019,16,669,700,1369,2019-12-10 15:00:00,2019-10-12 00:00:00,LABORABLE
10,12,2019,17,705,772,1477,2019-12-10 16:00:00,2019-10-12 00:00:00,LABORABLE
10,12,2019,18,699,817,1516,2019-12-10 17:00:00,2019-10-12 00:00:00,LABORABLE
10,12,2019,19,727,793,1520,2019-12-10 18:00:00,2019-10-12 00:00:00,LABORABLE
10,12,2019,20,633,789,1422,2019-12-10 19:00:00,2019-10-12 00:00:00,LABORABLE
10,12,2019,21,621,737,1358,2019-12-10 20:00:00,2019-10-12 00:00:00,LABORABLE
10,12,2019,22,496,589,1085,2019-12-10 21:00:00,2019-10-12 00:00:00,LABORABLE
10,12,2019,23,395,436,831,2019-12-10 22:00:00,2019-10-12 00:00:00,LABORABLE
10,12,2019,24,234,323,557,2019-12-10 23:00:00,2019-10-12 00:00:00,LABORABLE
11,12,2019,1,176,267,443,2019-12-11 00:00:00,2019-11-12 00:00:00,LABORABLE
11,12,2019,2,121,183,304,2019-12-11 01:00:00,2019-11-12 00:00:00,LABORABLE
11,12,2019,3,105,143,248,2019-12-11 02:00:00,2019-11-12 00:00:00,LABORABLE
11,12,2019,4,77,97,174,2019-12-11 03:00:00,2019-11-12 00:00:00,LABORABLE
11,12,2019,5,98,116,214,2019-12-11 04:00:00,2019-11-12 00:00:00,LABORABLE
11,12,2019,6,126,166,292,2019-12-11 05:00:00,2019-11-12 00:00:00,LABORABLE
11,12,2019,7,442,441,883,2019-12-11 06:00:00,2019-11-12 00:00:00,LABORABLE
11,12,2019,8,620,604,1224,2019-12-11 07:00:00,2019-11-12 00:00:00,LABORABLE
11,12,2019,9,678,645,1323,2019-12-11 08:00:00,2019-11-12 00:00:00,LABORABLE
11,12,2019,10,526,612,1138,2019-12-11 09:00:00,2019-11-12 00:00:00,LABORABLE
11,12,2019,11,570,709,1279,2019-12-11 10:00:00,2019-11-12 00:00:00,LABORABLE
11,12,2019,12,608,706,1314,2019-12-11 11:00:00,2019-11-12 00:00:00,LABORABLE
11,12,2019,13,625,750,1375,2019-12-11 12:00:00,2019-11-12 00:00:00,LABORABLE
11,12,2019,14,703,707,1410,2019-12-11 13:00:00,2019-11-12 00:00:00,LABORABLE
11,12,2019,15,695,700,1395,2019-12-11 14:00:00,2019-11-12 00:00:00,LABORABLE
11,12,2019,16,656,672,1328,2019-12-11 15:00:00,2019-11-12 00:00:00,LABORABLE
11,12,2019,17,666,732,1398,2019-12-11 16:00:00,2019-11-12 00:00:00,LABORABLE
11,12,2019,18,703,750,1453,2019-12-11 17:00:00,2019-11-12 00:00:00,LABORABLE
11,12,2019,19,719,761,1480,2019-12-11 18:00:00,2019-11-12 00:00:00,LABORABLE
11,12,2019,20,645,727,1372,2019-12-11 19:00:00,2019-11-12 00:00:00,LABORABLE
11,12,2019,21,642,714,1356,2019-12-11 20:00:00,2019-11-12 00:00:00,LABORABLE
11,12,2019,22,521,601,1122,2019-12-11 21:00:00,2019-11-12 00:00:00,LABORABLE
11,12,2019,23,403,479,882,2019-12-11 22:00:00,2019-11-12 00:00:00,LABORABLE
11,12,2019,24,302,383,685,2019-12-11 23:00:00,2019-11-12 00:00:00,LABORABLE
12,12,2019,1,186,310,496,2019-12-12 00:00:00,2019-12-12 00:00:00,LABORABLE
12,12,2019,2,144,203,347,2019-12-12 01:00:00,2019-12-12 00:00:00,LABORABLE
12,12,2019,3,87,163,250,2019-12-12 02:00:00,2019-12-12 00:00:00,LABORABLE
12,12,2019,4,83,135,218,2019-12-12 03:00:00,2019-12-12 00:00:00,LABORABLE
12,12,2019,5,104,122,226,2019-12-12 04:00:00,2019-12-12 00:00:00,LABORABLE
12,12,2019,6,180,198,378,2019-12-12 05:00:00,2019-12-12 00:00:00,LABORABLE
12,12,2019,7,462,441,903,2019-12-12 06:00:00,2019-12-12 00:00:00,LABORABLE
12,12,2019,8,671,615,1286,2019-12-12 07:00:00,2019-12-12 00:00:00,LABORABLE
12,12,2019,9,718,712,1430,2019-12-12 08:00:00,2019-12-12 00:00:00,LABORABLE
12,12,2019,10,650,698,1348,2019-12-12 09:00:00,2019-12-12 00:00:00,LABORABLE
12,12,2019,11,639,649,1288,2019-12-12 10:00:00,2019-12-12 00:00:00,LABORABLE
12,12,2019,12,691,739,1430,2019-12-12 11:00:00,2019-12-12 00:00:00,LABORABLE
12,12,2019,13,648,686,1334,2019-12-12 12:00:00,2019-12-12 00:00:00,LABORABLE
12,12,2019,14,637,793,1430,2019-12-12 13:00:00,2019-12-12 00:00:00,LABORABLE
12,12,2019,15,636,720,1356,2019-12-12 14:00:00,2019-12-12 00:00:00,LABORABLE
12,12,2019,16,646,700,1346,2019-12-12 15:00:00,2019-12-12 00:00:00,LABORABLE
12,12,2019,17,664,707,1371,2019-12-12 16:00:00,2019-12-12 00:00:00,LABORABLE
12,12,2019,18,739,771,1510,2019-12-12 17:00:00,2019-12-12 00:00:00,LABORABLE
12,12,2019,19,665,765,1430,2019-12-12 18:00:00,2019-12-12 00:00:00,LABORABLE
12,12,2019,20,631,761,1392,2019-12-12 19:00:00,2019-12-12 00:00:00,LABORABLE
12,12,2019,21,598,762,1360,2019-12-12 20:00:00,2019-12-12 00:00:00,LABORABLE
12,12,2019,22,548,596,1144,2019-12-12 21:00:00,2019-12-12 00:00:00,LABORABLE
12,12,2019,23,416,472,888,2019-12-12 22:00:00,2019-12-12 00:00:00,LABORABLE
12,12,2019,24,319,414,733,2019-12-12 23:00:00,2019-12-12 00:00:00,LABORABLE
13,12,2019,1,192,371,563,2019-12-13 00:00:00,2019-12-13 00:00:00,LABORABLE
13,12,2019,2,136,258,394,2019-12-13 01:00:00,2019-12-13 00:00:00,LABORABLE
13,12,2019,3,116,191,307,2019-12-13 02:00:00,2019-12-13 00:00:00,LABORABLE
13,12,2019,4,103,161,264,2019-12-13 03:00:00,2019-12-13 00:00:00,LABORABLE
13,12,2019,5,103,129,232,2019-12-13 04:00:00,2019-12-13 00:00:00,LABORABLE
13,12,2019,6,192,187,379,2019-12-13 05:00:00,2019-12-13 00:00:00,LABORABLE
13,12,2019,7,320,460,780,2019-12-13 06:00:00,2019-12-13 00:00:00,LABORABLE
13,12,2019,8,663,640,1303,2019-12-13 07:00:00,2019-12-13 00:00:00,LABORABLE
13,12,2019,9,651,686,1337,2019-12-13 08:00:00,2019-12-13 00:00:00,LABORABLE
13,12,2019,10,558,618,1176,2019-12-13 09:00:00,2019-12-13 00:00:00,LABORABLE
13,12,2019,11,581,636,1217,2019-12-13 10:00:00,2019-12-13 00:00:00,LABORABLE
13,12,2019,12,639,708,1347,2019-12-13 11:00:00,2019-12-13 00:00:00,LABORABLE
13,12,2019,13,674,830,1504,2019-12-13 12:00:00,2019-12-13 00:00:00,LABORABLE
13,12,2019,14,702,717,1419,2019-12-13 13:00:00,2019-12-13 00:00:00,LABORABLE
13,12,2019,15,698,715,1413,2019-12-13 14:00:00,2019-12-13 00:00:00,LABORABLE
13,12,2019,16,707,728,1435,2019-12-13 15:00:00,2019-12-13 00:00:00,LABORABLE
13,12,2019,17,635,726,1361,2019-12-13 16:00:00,2019-12-13 00:00:00,LABORABLE
13,12,2019,18,737,817,1554,2019-12-13 17:00:00,2019-12-13 00:00:00,LABORABLE
13,12,2019,19,675,864,1539,2019-12-13 18:00:00,2019-12-13 00:00:00,LABORABLE
13,12,2019,20,707,874,1581,2019-12-13 19:00:00,2019-12-13 00:00:00,LABORABLE
13,12,2019,21,740,836,1576,2019-12-13 20:00:00,2019-12-13 00:00:00,LABORABLE
13,12,2019,22,610,687,1297,2019-12-13 21:00:00,2019-12-13 00:00:00,LABORABLE
13,12,2019,23,550,599,1149,2019-12-13 22:00:00,2019-12-13 00:00:00,LABORABLE
13,12,2019,24,412,556,968,2019-12-13 23:00:00,2019-12-13 00:00:00,LABORABLE
14,12,2019,1,344,524,868,2019-12-14 00:00:00,2019-12-14 00:00:00,LABORABLE
14,12,2019,2,293,434,727,2019-12-14 01:00:00,2019-12-14 00:00:00,LABORABLE
14,12,2019,3,248,359,607,2019-12-14 02:00:00,2019-12-14 00:00:00,LABORABLE
14,12,2019,4,204,304,508,2019-12-14 03:00:00,2019-12-14 00:00:00,LABORABLE
14,12,2019,5,186,265,451,2019-12-14 04:00:00,2019-12-14 00:00:00,LABORABLE
14,12,2019,6,164,270,434,2019-12-14 05:00:00,2019-12-14 00:00:00,LABORABLE
14,12,2019,7,254,311,565,2019-12-14 06:00:00,2019-12-14 00:00:00,LABORABLE
14,12,2019,8,295,308,603,2019-12-14 07:00:00,2019-12-14 00:00:00,LABORABLE
14,12,2019,9,399,407,806,2019-12-14 08:00:00,2019-12-14 00:00:00,LABORABLE
14,12,2019,10,529,497,1026,2019-12-14 09:00:00,2019-12-14 00:00:00,LABORABLE
14,12,2019,11,552,624,1176,2019-12-14 10:00:00,2019-12-14 00:00:00,LABORABLE
14,12,2019,12,645,631,1276,2019-12-14 11:00:00,2019-12-14 00:00:00,LABORABLE
14,12,2019,13,661,765,1426,2019-12-14 12:00:00,2019-12-14 00:00:00,LABORABLE
14,12,2019,14,705,747,1452,2019-12-14 13:00:00,2019-12-14 00:00:00,LABORABLE
14,12,2019,15,687,815,1502,2019-12-14 14:00:00,2019-12-14 00:00:00,LABORABLE
14,12,2019,16,597,758,1355,2019-12-14 15:00:00,2019-12-14 00:00:00,LABORABLE
14,12,2019,17,601,761,1362,2019-12-14 16:00:00,2019-12-14 00:00:00,LABORABLE
14,12,2019,18,615,831,1446,2019-12-14 17:00:00,2019-12-14 00:00:00,LABORABLE
14,12,2019,19,764,830,1594,2019-12-14 18:00:00,2019-12-14 00:00:00,LABORABLE
14,12,2019,20,716,823,1539,2019-12-14 19:00:00,2019-12-14 00:00:00,LABORABLE
14,12,2019,21,679,743,1422,2019-12-14 20:00:00,2019-12-14 00:00:00,LABORABLE
14,12,2019,22,654,674,1328,2019-12-14 21:00:00,2019-12-14 00:00:00,LABORABLE
14,12,2019,23,593,632,1225,2019-12-14 22:00:00,2019-12-14 00:00:00,LABORABLE
14,12,2019,24,519,577,1096,2019-12-14 23:00:00,2019-12-14 00:00:00,LABORABLE
15,12,2019,1,448,561,1009,2019-12-15 00:00:00,2019-12-15 00:00:00,LABORABLE
15,12,2019,2,376,484,860,2019-12-15 01:00:00,2019-12-15 00:00:00,LABORABLE
15,12,2019,3,330,429,759,2019-12-15 02:00:00,2019-12-15 00:00:00,LABORABLE
15,12,2019,4,242,391,633,2019-12-15 03:00:00,2019-12-15 00:00:00,LABORABLE
15,12,2019,5,190,313,503,2019-12-15 04:00:00,2019-12-15 00:00:00,LABORABLE
15,12,2019,6,171,328,499,2019-12-15 05:00:00,2019-12-15 00:00:00,LABORABLE
15,12,2019,7,224,301,525,2019-12-15 06:00:00,2019-12-15 00:00:00,LABORABLE
15,12,2019,8,205,289,494,2019-12-15 07:00:00,2019-12-15 00:00:00,LABORABLE
15,12,2019,9,223,291,514,2019-12-15 08:00:00,2019-12-15 00:00:00,LABORABLE
15,12,2019,10,349,381,730,2019-12-15 09:00:00,2019-12-15 00:00:00,LABORABLE
15,12,2019,11,444,504,948,2019-12-15 10:00:00,2019-12-15 00:00:00,LABORABLE
15,12,2019,12,566,548,1114,2019-12-15 11:00:00,2019-12-15 00:00:00,LABORABLE
15,12,2019,13,590,684,1274,2019-12-15 12:00:00,2019-12-15 00:00:00,LABORABLE
15,12,2019,14,626,703,1329,2019-12-15 13:00:00,2019-12-15 00:00:00,LABORABLE
15,12,2019,15,628,674,1302,2019-12-15 14:00:00,2019-12-15 00:00:00,LABORABLE
15,12,2019,16,557,644,1201,2019-12-15 15:00:00,2019-12-15 00:00:00,LABORABLE
15,12,2019,17,534,684,1218,2019-12-15 16:00:00,2019-12-15 00:00:00,LABORABLE
15,12,2019,18,598,777,1375,2019-12-15 17:00:00,2019-12-15 00:00:00,LABORABLE
15,12,2019,19,623,786,1409,2019-12-15 18:00:00,2019-12-15 00:00:00,LABORABLE
15,12,2019,20,608,751,1359,2019-12-15 19:00:00,2019-12-15 00:00:00,LABORABLE
15,12,2019,21,551,666,1217,2019-12-15 20:00:00,2019-12-15 00:00:00,LABORABLE
15,12,2019,22,518,566,1084,2019-12-15 21:00:00,2019-12-15 00:00:00,LABORABLE
15,12,2019,23,411,435,846,2019-12-15 22:00:00,2019-12-15 00:00:00,LABORABLE
15,12,2019,24,305,395,700,2019-12-15 23:00:00,2019-12-15 00:00:00,LABORABLE
16,12,2019,1,223,233,456,2019-12-16 00:00:00,2019-12-16 00:00:00,LABORABLE
16,12,2019,2,133,181,314,2019-12-16 01:00:00,2019-12-16 00:00:00,LABORABLE
16,12,2019,3,105,185,290,2019-12-16 02:00:00,2019-12-16 00:00:00,LABORABLE
16,12,2019,4,85,108,193,2019-12-16 03:00:00,2019-12-16 00:00:00,LABORABLE
16,12,2019,5,58,122,180,2019-12-16 04:00:00,2019-12-16 00:00:00,LABORABLE
16,12,2019,6,175,162,337,2019-12-16 05:00:00,2019-12-16 00:00:00,LABORABLE
16,12,2019,7,305,436,741,2019-12-16 06:00:00,2019-12-16 00:00:00,LABORABLE
16,12,2019,8,641,644,1285,2019-12-16 07:00:00,2019-12-16 00:00:00,LABORABLE
16,12,2019,9,706,655,1361,2019-12-16 08:00:00,2019-12-16 00:00:00,LABORABLE
16,12,2019,10,637,737,1374,2019-12-16 09:00:00,2019-12-16 00:00:00,LABORABLE
16,12,2019,11,589,647,1236,2019-12-16 10:00:00,2019-12-16 00:00:00,LABORABLE
16,12,2019,12,624,698,1322,2019-12-16 11:00:00,2019-12-16 00:00:00,LABORABLE
16,12,2019,13,641,712,1353,2019-12-16 12:00:00,2019-12-16 00:00:00,LABORABLE
16,12,2019,14,660,795,1455,2019-12-16 13:00:00,2019-12-16 00:00:00,LABORABLE
16,12,2019,15,650,700,1350,2019-12-16 14:00:00,2019-12-16 00:00:00,LABORABLE
16,12,2019,16,663,700,1363,2019-12-16 15:00:00,2019-12-16 00:00:00,LABORABLE
16,12,2019,17,684,782,1466,2019-12-16 16:00:00,2019-12-16 00:00:00,LABORABLE
16,12,2019,18,722,768,1490,2019-12-16 17:00:00,2019-12-16 00:00:00,LABORABLE
16,12,2019,19,669,789,1458,2019-12-16 18:00:00,2019-12-16 00:00:00,LABORABLE
16,12,2019,20,620,767,1387,2019-12-16 19:00:00,2019-12-16 00:00:00,LABORABLE
16,12,2019,21,641,727,1368,2019-12-16 20:00:00,2019-12-16 00:00:00,LABORABLE
16,12,2019,22,510,569,1079,2019-12-16 21:00:00,2019-12-16 00:00:00,LABORABLE
16,12,2019,23,421,450,871,2019-12-16 22:00:00,2019-12-16 00:00:00,LABORABLE
16,12,2019,24,222,316,538,2019-12-16 23:00:00,2019-12-16 00:00:00,LABORABLE
17,12,2019,1,161,220,381,2019-12-17 00:00:00,2019-12-17 00:00:00,LABORABLE
17,12,2019,2,109,159,268,2019-12-17 01:00:00,2019-12-17 00:00:00,LABORABLE
17,12,2019,3,70,127,197,2019-12-17 02:00:00,2019-12-17 00:00:00,LABORABLE
17,12,2019,4,79,110,189,2019-12-17 03:00:00,2019-12-17 00:00:00,LABORABLE
17,12,2019,5,64,123,187,2019-12-17 04:00:00,2019-12-17 00:00:00,LABORABLE
17,12,2019,6,124,166,290,2019-12-17 05:00:00,2019-12-17 00:00:00,LABORABLE
17,12,2019,7,442,436,878,2019-12-17 06:00:00,2019-12-17 00:00:00,LABORABLE
17,12,2019,8,640,622,1262,2019-12-17 07:00:00,2019-12-17 00:00:00,LABORABLE
17,12,2019,9,711,693,1404,2019-12-17 08:00:00,2019-12-17 00:00:00,LABORABLE
17,12,2019,10,634,778,1412,2019-12-17 09:00:00,2019-12-17 00:00:00,LABORABLE
17,12,2019,11,581,652,1233,2019-12-17 10:00:00,2019-12-17 00:00:00,LABORABLE
17,12,2019,12,344,830,1174,2019-12-17 11:00:00,2019-12-17 00:00:00,LABORABLE
17,12,2019,13,638,757,1395,2019-12-17 12:00:00,2019-12-17 00:00:00,LABORABLE
17,12,2019,14,675,794,1469,2019-12-17 13:00:00,2019-12-17 00:00:00,LABORABLE
17,12,2019,15,666,747,1413,2019-12-17 14:00:00,2019-12-17 00:00:00,LABORABLE
17,12,2019,16,652,702,1354,2019-12-17 15:00:00,2019-12-17 00:00:00,LABORABLE
17,12,2019,17,626,742,1368,2019-12-17 16:00:00,2019-12-17 00:00:00,LABORABLE
17,12,2019,18,702,779,1481,2019-12-17 17:00:00,2019-12-17 00:00:00,LABORABLE
17,12,2019,19,686,731,1417,2019-12-17 18:00:00,2019-12-17 00:00:00,LABORABLE
17,12,2019,20,648,767,1415,2019-12-17 19:00:00,2019-12-17 00:00:00,LABORABLE
17,12,2019,21,687,713,1400,2019-12-17 20:00:00,2019-12-17 00:00:00,LABORABLE
17,12,2019,22,517,615,1132,2019-12-17 21:00:00,2019-12-17 00:00:00,LABORABLE
17,12,2019,23,426,479,905,2019-12-17 22:00:00,2019-12-17 00:00:00,LABORABLE
17,12,2019,24,275,326,601,2019-12-17 23:00:00,2019-12-17 00:00:00,LABORABLE
18,12,2019,1,207,259,466,2019-12-18 00:00:00,2019-12-18 00:00:00,LABORABLE
18,12,2019,2,131,187,318,2019-12-18 01:00:00,2019-12-18 00:00:00,LABORABLE
18,12,2019,3,88,144,232,2019-12-18 02:00:00,2019-12-18 00:00:00,LABORABLE
18,12,2019,4,86,97,183,2019-12-18 03:00:00,2019-12-18 00:00:00,LABORABLE
18,12,2019,5,66,110,176,2019-12-18 04:00:00,2019-12-18 00:00:00,LABORABLE
18,12,2019,6,174,182,356,2019-12-18 05:00:00,2019-12-18 00:00:00,LABORABLE
18,12,2019,7,429,427,856,2019-12-18 06:00:00,2019-12-18 00:00:00,LABORABLE
18,12,2019,8,614,622,1236,2019-12-18 07:00:00,2019-12-18 00:00:00,LABORABLE
18,12,2019,9,735,670,1405,2019-12-18 08:00:00,2019-12-18 00:00:00,LABORABLE
18,12,2019,10,645,729,1374,2019-12-18 09:00:00,2019-12-18 00:00:00,LABORABLE
18,12,2019,11,609,672,1281,2019-12-18 10:00:00,2019-12-18 00:00:00,LABORABLE
18,12,2019,12,627,723,1350,2019-12-18 11:00:00,2019-12-18 00:00:00,LABORABLE
18,12,2019,13,673,772,1445,2019-12-18 12:00:00,2019-12-18 00:00:00,LABORABLE
18,12,2019,14,695,765,1460,2019-12-18 13:00:00,2019-12-18 00:00:00,LABORABLE
18,12,2019,15,664,738,1402,2019-12-18 14:00:00,2019-12-18 00:00:00,LABORABLE
18,12,2019,16,712,722,1434,2019-12-18 15:00:00,2019-12-18 00:00:00,LABORABLE
18,12,2019,17,666,754,1420,2019-12-18 16:00:00,2019-12-18 00:00:00,LABORABLE
18,12,2019,18,679,805,1484,2019-12-18 17:00:00,2019-12-18 00:00:00,LABORABLE
18,12,2019,19,727,803,1530,2019-12-18 18:00:00,2019-12-18 00:00:00,LABORABLE
18,12,2019,20,646,764,1410,2019-12-18 19:00:00,2019-12-18 00:00:00,LABORABLE
18,12,2019,21,643,715,1358,2019-12-18 20:00:00,2019-12-18 00:00:00,LABORABLE
18,12,2019,22,460,731,1191,2019-12-18 21:00:00,2019-12-18 00:00:00,LABORABLE
18,12,2019,23,501,540,1041,2019-12-18 22:00:00,2019-12-18 00:00:00,LABORABLE
18,12,2019,24,279,402,681,2019-12-18 23:00:00,2019-12-18 00:00:00,LABORABLE
19,12,2019,1,223,304,527,2019-12-19 00:00:00,2019-12-19 00:00:00,LABORABLE
19,12,2019,2,141,227,368,2019-12-19 01:00:00,2019-12-19 00:00:00,LABORABLE
19,12,2019,3,130,151,281,2019-12-19 02:00:00,2019-12-19 00:00:00,LABORABLE
19,12,2019,4,69,113,182,2019-12-19 03:00:00,2019-12-19 00:00:00,LABORABLE
19,12,2019,5,69,107,176,2019-12-19 04:00:00,2019-12-19 00:00:00,LABORABLE
19,12,2019,6,194,162,356,2019-12-19 05:00:00,2019-12-19 00:00:00,LABORABLE
19,12,2019,7,309,414,723,2019-12-19 06:00:00,2019-12-19 00:00:00,LABORABLE
19,12,2019,8,643,612,1255,2019-12-19 07:00:00,2019-12-19 00:00:00,LABORABLE
19,12,2019,9,687,681,1368,2019-12-19 08:00:00,2019-12-19 00:00:00,LABORABLE
19,12,2019,10,703,716,1419,2019-12-19 09:00:00,2019-12-19 00:00:00,LABORABLE
19,12,2019,11,654,734,1388,2019-12-19 10:00:00,2019-12-19 00:00:00,LABORABLE
19,12,2019,12,604,616,1220,2019-12-19 11:00:00,2019-12-19 00:00:00,LABORABLE
19,12,2019,13,609,829,1438,2019-12-19 12:00:00,2019-12-19 00:00:00,LABORABLE
19,12,2019,14,715,750,1465,2019-12-19 13:00:00,2019-12-19 00:00:00,LABORABLE
19,12,2019,15,666,717,1383,2019-12-19 14:00:00,2019-12-19 00:00:00,LABORABLE
19,12,2019,16,667,649,1316,2019-12-19 15:00:00,2019-12-19 00:00:00,LABORABLE
19,12,2019,17,638,694,1332,2019-12-19 16:00:00,2019-12-19 00:00:00,LABORABLE
19,12,2019,18,693,786,1479,2019-12-19 17:00:00,2019-12-19 00:00:00,LABORABLE
19,12,2019,19,693,732,1425,2019-12-19 18:00:00,2019-12-19 00:00:00,LABORABLE
19,12,2019,20,592,734,1326,2019-12-19 19:00:00,2019-12-19 00:00:00,LABORABLE
19,12,2019,21,650,750,1400,2019-12-19 20:00:00,2019-12-19 00:00:00,LABORABLE
19,12,2019,22,584,641,1225,2019-12-19 21:00:00,2019-12-19 00:00:00,LABORABLE
19,12,2019,23,459,499,958,2019-12-19 22:00:00,2019-12-19 00:00:00,LABORABLE
19,12,2019,24,307,401,708,2019-12-19 23:00:00,2019-12-19 00:00:00,LABORABLE
20,12,2019,1,232,396,628,2019-12-20 00:00:00,2019-12-20 00:00:00,LABORABLE
20,12,2019,2,140,266,406,2019-12-20 01:00:00,2019-12-20 00:00:00,LABORABLE
20,12,2019,3,150,209,359,2019-12-20 02:00:00,2019-12-20 00:00:00,LABORABLE
20,12,2019,4,86,190,276,2019-12-20 03:00:00,2019-12-20 00:00:00,LABORABLE
20,12,2019,5,87,134,221,2019-12-20 04:00:00,2019-12-20 00:00:00,LABORABLE
20,12,2019,6,212,184,396,2019-12-20 05:00:00,2019-12-20 00:00:00,LABORABLE
20,12,2019,7,443,406,849,2019-12-20 06:00:00,2019-12-20 00:00:00,LABORABLE
20,12,2019,8,663,600,1263,2019-12-20 07:00:00,2019-12-20 00:00:00,LABORABLE
20,12,2019,9,664,607,1271,2019-12-20 08:00:00,2019-12-20 00:00:00,LABORABLE
20,12,2019,10,691,726,1417,2019-12-20 09:00:00,2019-12-20 00:00:00,LABORABLE
20,12,2019,11,455,799,1254,2019-12-20 10:00:00,2019-12-20 00:00:00,LABORABLE
20,12,2019,12,713,735,1448,2019-12-20 11:00:00,2019-12-20 00:00:00,LABORABLE
20,12,2019,13,695,769,1464,2019-12-20 12:00:00,2019-12-20 00:00:00,LABORABLE
20,12,2019,14,728,807,1535,2019-12-20 13:00:00,2019-12-20 00:00:00,LABORABLE
20,12,2019,15,711,793,1504,2019-12-20 14:00:00,2019-12-20 00:00:00,LABORABLE
20,12,2019,16,657,733,1390,2019-12-20 15:00:00,2019-12-20 00:00:00,LABORABLE
20,12,2019,17,683,758,1441,2019-12-20 16:00:00,2019-12-20 00:00:00,LABORABLE
20,12,2019,18,660,717,1377,2019-12-20 17:00:00,2019-12-20 00:00:00,LABORABLE
20,12,2019,19,645,789,1434,2019-12-20 18:00:00,2019-12-20 00:00:00,LABORABLE
20,12,2019,20,659,815,1474,2019-12-20 19:00:00,2019-12-20 00:00:00,LABORABLE
20,12,2019,21,684,821,1505,2019-12-20 20:00:00,2019-12-20 00:00:00,LABORABLE
20,12,2019,22,572,696,1268,2019-12-20 21:00:00,2019-12-20 00:00:00,LABORABLE
20,12,2019,23,513,586,1099,2019-12-20 22:00:00,2019-12-20 00:00:00,LABORABLE
20,12,2019,24,352,524,876,2019-12-20 23:00:00,2019-12-20 00:00:00,LABORABLE
21,12,2019,1,366,494,860,2019-12-21 00:00:00,2019-12-21 00:00:00,LABORABLE
21,12,2019,2,296,408,704,2019-12-21 01:00:00,2019-12-21 00:00:00,LABORABLE
21,12,2019,3,259,356,615,2019-12-21 02:00:00,2019-12-21 00:00:00,LABORABLE
21,12,2019,4,220,289,509,2019-12-21 03:00:00,2019-12-21 00:00:00,LABORABLE
21,12,2019,5,164,244,408,2019-12-21 04:00:00,2019-12-21 00:00:00,LABORABLE
21,12,2019,6,197,263,460,2019-12-21 05:00:00,2019-12-21 00:00:00,LABORABLE
21,12,2019,7,262,302,564,2019-12-21 06:00:00,2019-12-21 00:00:00,LABORABLE
21,12,2019,8,297,304,601,2019-12-21 07:00:00,2019-12-21 00:00:00,LABORABLE
21,12,2019,9,373,375,748,2019-12-21 08:00:00,2019-12-21 00:00:00,LABORABLE
21,12,2019,10,453,510,963,2019-12-21 09:00:00,2019-12-21 00:00:00,LABORABLE
21,12,2019,11,594,653,1247,2019-12-21 10:00:00,2019-12-21 00:00:00,LABORABLE
21,12,2019,12,672,693,1365,2019-12-21 11:00:00,2019-12-21 00:00:00,LABORABLE
21,12,2019,13,717,768,1485,2019-12-21 12:00:00,2019-12-21 00:00:00,LABORABLE
21,12,2019,14,732,841,1573,2019-12-21 13:00:00,2019-12-21 00:00:00,LABORABLE
21,12,2019,15,690,866,1556,2019-12-21 14:00:00,2019-12-21 00:00:00,LABORABLE
21,12,2019,16,591,747,1338,2019-12-21 15:00:00,2019-12-21 00:00:00,LABORABLE
21,12,2019,17,581,747,1328,2019-12-21 16:00:00,2019-12-21 00:00:00,LABORABLE
21,12,2019,18,659,817,1476,2019-12-21 17:00:00,2019-12-21 00:00:00,LABORABLE
21,12,2019,19,731,807,1538,2019-12-21 18:00:00,2019-12-21 00:00:00,LABORABLE
21,12,2019,20,663,892,1555,2019-12-21 19:00:00,2019-12-21 00:00:00,LABORABLE
21,12,2019,21,694,798,1492,2019-12-21 20:00:00,2019-12-21 00:00:00,LABORABLE
21,12,2019,22,597,772,1369,2019-12-21 21:00:00,2019-12-21 00:00:00,LABORABLE
21,12,2019,23,622,655,1277,2019-12-21 22:00:00,2019-12-21 00:00:00,LABORABLE
21,12,2019,24,602,556,1158,2019-12-21 23:00:00,2019-12-21 00:00:00,LABORABLE
22,12,2019,1,404,541,945,2019-12-22 00:00:00,2019-12-22 00:00:00,LABORABLE
22,12,2019,2,375,449,824,2019-12-22 01:00:00,2019-12-22 00:00:00,LABORABLE
22,12,2019,3,274,405,679,2019-12-22 02:00:00,2019-12-22 00:00:00,LABORABLE
22,12,2019,4,234,361,595,2019-12-22 03:00:00,2019-12-22 00:00:00,LABORABLE
22,12,2019,5,198,273,471,2019-12-22 04:00:00,2019-12-22 00:00:00,LABORABLE
22,12,2019,6,177,287,464,2019-12-22 05:00:00,2019-12-22 00:00:00,LABORABLE
22,12,2019,7,215,285,500,2019-12-22 06:00:00,2019-12-22 00:00:00,LABORABLE
22,12,2019,8,221,251,472,2019-12-22 07:00:00,2019-12-22 00:00:00,LABORABLE
22,12,2019,9,216,294,510,2019-12-22 08:00:00,2019-12-22 00:00:00,LABORABLE
22,12,2019,10,383,398,781,2019-12-22 09:00:00,2019-12-22 00:00:00,LABORABLE
22,12,2019,11,491,532,1023,2019-12-22 10:00:00,2019-12-22 00:00:00,LABORABLE
22,12,2019,12,563,606,1169,2019-12-22 11:00:00,2019-12-22 00:00:00,LABORABLE
22,12,2019,13,562,696,1258,2019-12-22 12:00:00,2019-12-22 00:00:00,LABORABLE
22,12,2019,14,633,778,1411,2019-12-22 13:00:00,2019-12-22 00:00:00,LABORABLE
22,12,2019,15,651,768,1419,2019-12-22 14:00:00,2019-12-22 00:00:00,LABORABLE
22,12,2019,16,530,658,1188,2019-12-22 15:00:00,2019-12-22 00:00:00,LABORABLE
22,12,2019,17,546,705,1251,2019-12-22 16:00:00,2019-12-22 00:00:00,LABORABLE
22,12,2019,18,503,750,1253,2019-12-22 17:00:00,2019-12-22 00:00:00,LABORABLE
22,12,2019,19,618,774,1392,2019-12-22 18:00:00,2019-12-22 00:00:00,LABORABLE
22,12,2019,20,594,717,1311,2019-12-22 19:00:00,2019-12-22 00:00:00,LABORABLE
22,12,2019,21,541,722,1263,2019-12-22 20:00:00,2019-12-22 00:00:00,LABORABLE
22,12,2019,22,527,631,1158,2019-12-22 21:00:00,2019-12-22 00:00:00,LABORABLE
22,12,2019,23,444,547,991,2019-12-22 22:00:00,2019-12-22 00:00:00,LABORABLE
22,12,2019,24,333,378,711,2019-12-22 23:00:00,2019-12-22 00:00:00,LABORABLE
23,12,2019,1,218,345,563,2019-12-23 00:00:00,2019-12-23 00:00:00,LABORABLE
23,12,2019,2,151,260,411,2019-12-23 01:00:00,2019-12-23 00:00:00,LABORABLE
23,12,2019,3,120,170,290,2019-12-23 02:00:00,2019-12-23 00:00:00,LABORABLE
23,12,2019,4,82,144,226,2019-12-23 03:00:00,2019-12-23 00:00:00,LABORABLE
23,12,2019,5,58,111,169,2019-12-23 04:00:00,2019-12-23 00:00:00,LABORABLE
23,12,2019,6,175,182,357,2019-12-23 05:00:00,2019-12-23 00:00:00,LABORABLE
23,12,2019,7,361,346,707,2019-12-23 06:00:00,2019-12-23 00:00:00,LABORABLE
23,12,2019,8,512,470,982,2019-12-23 07:00:00,2019-12-23 00:00:00,LABORABLE
23,12,2019,9,517,593,1110,2019-12-23 08:00:00,2019-12-23 00:00:00,LABORABLE
23,12,2019,10,563,634,1197,2019-12-23 09:00:00,2019-12-23 00:00:00,LABORABLE
23,12,2019,11,653,739,1392,2019-12-23 10:00:00,2019-12-23 00:00:00,LABORABLE
23,12,2019,12,676,757,1433,2019-12-23 11:00:00,2019-12-23 00:00:00,LABORABLE
23,12,2019,13,694,804,1498,2019-12-23 12:00:00,2019-12-23 00:00:00,LABORABLE
23,12,2019,14,745,834,1579,2019-12-23 13:00:00,2019-12-23 00:00:00,LABORABLE
23,12,2019,15,687,818,1505,2019-12-23 14:00:00,2019-12-23 00:00:00,LABORABLE
23,12,2019,16,666,725,1391,2019-12-23 15:00:00,2019-12-23 00:00:00,LABORABLE
23,12,2019,17,674,761,1435,2019-12-23 16:00:00,2019-12-23 00:00:00,LABORABLE
23,12,2019,18,751,848,1599,2019-12-23 17:00:00,2019-12-23 00:00:00,LABORABLE
23,12,2019,19,728,860,1588,2019-12-23 18:00:00,2019-12-23 00:00:00,LABORABLE
23,12,2019,20,646,872,1518,2019-12-23 19:00:00,2019-12-23 00:00:00,LABORABLE
23,12,2019,21,627,826,1453,2019-12-23 20:00:00,2019-12-23 00:00:00,LABORABLE
23,12,2019,22,570,731,1301,2019-12-23 21:00:00,2019-12-23 00:00:00,LABORABLE
23,12,2019,23,425,538,963,2019-12-23 22:00:00,2019-12-23 00:00:00,LABORABLE
23,12,2019,24,312,422,734,2019-12-23 23:00:00,2019-12-23 00:00:00,LABORABLE
24,12,2019,1,208,332,540,2019-12-24 00:00:00,2019-12-24 00:00:00,LABORABLE
24,12,2019,2,102,242,344,2019-12-24 01:00:00,2019-12-24 00:00:00,LABORABLE
24,12,2019,3,64,201,265,2019-12-24 02:00:00,2019-12-24 00:00:00,LABORABLE
24,12,2019,4,61,134,195,2019-12-24 03:00:00,2019-12-24 00:00:00,LABORABLE
24,12,2019,5,64,122,186,2019-12-24 04:00:00,2019-12-24 00:00:00,LABORABLE
24,12,2019,6,143,147,290,2019-12-24 05:00:00,2019-12-24 00:00:00,LABORABLE
24,12,2019,7,322,389,711,2019-12-24 06:00:00,2019-12-24 00:00:00,LABORABLE
24,12,2019,8,552,645,1197,2019-12-24 07:00:00,2019-12-24 00:00:00,LABORABLE
24,12,2019,9,405,783,1188,2019-12-24 08:00:00,2019-12-24 00:00:00,LABORABLE
24,12,2019,10,514,593,1107,2019-12-24 09:00:00,2019-12-24 00:00:00,LABORABLE
24,12,2019,11,573,710,1283,2019-12-24 10:00:00,2019-12-24 00:00:00,LABORABLE
24,12,2019,12,650,785,1435,2019-12-24 11:00:00,2019-12-24 00:00:00,LABORABLE
24,12,2019,13,717,842,1559,2019-12-24 12:00:00,2019-12-24 00:00:00,LABORABLE
24,12,2019,14,730,870,1600,2019-12-24 13:00:00,2019-12-24 00:00:00,LABORABLE
24,12,2019,15,680,873,1553,2019-12-24 14:00:00,2019-12-24 00:00:00,LABORABLE
24,12,2019,16,579,829,1408,2019-12-24 15:00:00,2019-12-24 00:00:00,LABORABLE
24,12,2019,17,577,814,1391,2019-12-24 16:00:00,2019-12-24 00:00:00,LABORABLE
24,12,2019,18,585,880,1465,2019-12-24 17:00:00,2019-12-24 00:00:00,LABORABLE
24,12,2019,19,686,851,1537,2019-12-24 18:00:00,2019-12-24 00:00:00,LABORABLE
24,12,2019,20,751,815,1566,2019-12-24 19:00:00,2019-12-24 00:00:00,LABORABLE
24,12,2019,21,819,797,1616,2019-12-24 20:00:00,2019-12-24 00:00:00,LABORABLE
24,12,2019,22,598,727,1325,2019-12-24 21:00:00,2019-12-24 00:00:00,LABORABLE
24,12,2019,23,355,456,811,2019-12-24 22:00:00,2019-12-24 00:00:00,LABORABLE
24,12,2019,24,367,493,860,2019-12-24 23:00:00,2019-12-24 00:00:00,LABORABLE
25,12,2019,1,576,567,1143,2019-12-25 00:00:00,2019-12-25 00:00:00,FESTIVO
25,12,2019,2,633,618,1251,2019-12-25 01:00:00,2019-12-25 00:00:00,FESTIVO
25,12,2019,3,472,505,977,2019-12-25 02:00:00,2019-12-25 00:00:00,FESTIVO
25,12,2019,4,316,392,708,2019-12-25 03:00:00,2019-12-25 00:00:00,FESTIVO
25,12,2019,5,215,268,483,2019-12-25 04:00:00,2019-12-25 00:00:00,FESTIVO
25,12,2019,6,179,229,408,2019-12-25 05:00:00,2019-12-25 00:00:00,FESTIVO
25,12,2019,7,166,230,396,2019-12-25 06:00:00,2019-12-25 00:00:00,FESTIVO
25,12,2019,8,182,236,418,2019-12-25 07:00:00,2019-12-25 00:00:00,FESTIVO
25,12,2019,9,119,167,286,2019-12-25 08:00:00,2019-12-25 00:00:00,FESTIVO
25,12,2019,10,132,167,299,2019-12-25 09:00:00,2019-12-25 00:00:00,FESTIVO
25,12,2019,11,186,233,419,2019-12-25 10:00:00,2019-12-25 00:00:00,FESTIVO
25,12,2019,12,268,363,631,2019-12-25 11:00:00,2019-12-25 00:00:00,FESTIVO
25,12,2019,13,422,470,892,2019-12-25 12:00:00,2019-12-25 00:00:00,FESTIVO
25,12,2019,14,640,598,1238,2019-12-25 13:00:00,2019-12-25 00:00:00,FESTIVO
25,12,2019,15,557,610,1167,2019-12-25 14:00:00,2019-12-25 00:00:00,FESTIVO
25,12,2019,16,368,527,895,2019-12-25 15:00:00,2019-12-25 00:00:00,FESTIVO
25,12,2019,17,396,566,962,2019-12-25 16:00:00,2019-12-25 00:00:00,FESTIVO
25,12,2019,18,517,652,1169,2019-12-25 17:00:00,2019-12-25 00:00:00,FESTIVO
25,12,2019,19,635,706,1341,2019-12-25 18:00:00,2019-12-25 00:00:00,FESTIVO
25,12,2019,20,696,725,1421,2019-12-25 19:00:00,2019-12-25 00:00:00,FESTIVO
25,12,2019,21,554,597,1151,2019-12-25 20:00:00,2019-12-25 00:00:00,FESTIVO
25,12,2019,22,425,550,975,2019-12-25 21:00:00,2019-12-25 00:00:00,FESTIVO
25,12,2019,23,415,416,831,2019-12-25 22:00:00,2019-12-25 00:00:00,FESTIVO
25,12,2019,24,242,366,608,2019-12-25 23:00:00,2019-12-25 00:00:00,FESTIVO
26,12,2019,1,167,299,466,2019-12-26 00:00:00,2019-12-26 00:00:00,LABORABLE
26,12,2019,2,120,170,290,2019-12-26 01:00:00,2019-12-26 00:00:00,LABORABLE
26,12,2019,3,90,143,233,2019-12-26 02:00:00,2019-12-26 00:00:00,LABORABLE
26,12,2019,4,71,102,173,2019-12-26 03:00:00,2019-12-26 00:00:00,LABORABLE
26,12,2019,5,81,99,180,2019-12-26 04:00:00,2019-12-26 00:00:00,LABORABLE
26,12,2019,6,133,150,283,2019-12-26 05:00:00,2019-12-26 00:00:00,LABORABLE
26,12,2019,7,318,319,637,2019-12-26 06:00:00,2019-12-26 00:00:00,LABORABLE
26,12,2019,8,533,488,1021,2019-12-26 07:00:00,2019-12-26 00:00:00,LABORABLE
26,12,2019,9,556,562,1118,2019-12-26 08:00:00,2019-12-26 00:00:00,LABORABLE
26,12,2019,10,543,621,1164,2019-12-26 09:00:00,2019-12-26 00:00:00,LABORABLE
26,12,2019,11,569,640,1209,2019-12-26 10:00:00,2019-12-26 00:00:00,LABORABLE
26,12,2019,12,639,709,1348,2019-12-26 11:00:00,2019-12-26 00:00:00,LABORABLE
26,12,2019,13,648,763,1411,2019-12-26 12:00:00,2019-12-26 00:00:00,LABORABLE
26,12,2019,14,644,842,1486,2019-12-26 13:00:00,2019-12-26 00:00:00,LABORABLE
26,12,2019,15,621,764,1385,2019-12-26 14:00:00,2019-12-26 00:00:00,LABORABLE
26,12,2019,16,601,686,1287,2019-12-26 15:00:00,2019-12-26 00:00:00,LABORABLE
26,12,2019,17,624,698,1322,2019-12-26 16:00:00,2019-12-26 00:00:00,LABORABLE
26,12,2019,18,661,774,1435,2019-12-26 17:00:00,2019-12-26 00:00:00,LABORABLE
26,12,2019,19,650,856,1506,2019-12-26 18:00:00,2019-12-26 00:00:00,LABORABLE
26,12,2019,20,622,828,1450,2019-12-26 19:00:00,2019-12-26 00:00:00,LABORABLE
26,12,2019,21,622,759,1381,2019-12-26 20:00:00,2019-12-26 00:00:00,LABORABLE
26,12,2019,22,543,642,1185,2019-12-26 21:00:00,2019-12-26 00:00:00,LABORABLE
26,12,2019,23,450,533,983,2019-12-26 22:00:00,2019-12-26 00:00:00,LABORABLE
26,12,2019,24,318,378,696,2019-12-26 23:00:00,2019-12-26 00:00:00,LABORABLE
27,12,2019,1,254,349,603,2019-12-27 00:00:00,2019-12-27 00:00:00,LABORABLE
27,12,2019,2,152,268,420,2019-12-27 01:00:00,2019-12-27 00:00:00,LABORABLE
27,12,2019,3,111,212,323,2019-12-27 02:00:00,2019-12-27 00:00:00,LABORABLE
27,12,2019,4,91,156,247,2019-12-27 03:00:00,2019-12-27 00:00:00,LABORABLE
27,12,2019,5,106,142,248,2019-12-27 04:00:00,2019-12-27 00:00:00,LABORABLE
27,12,2019,6,179,161,340,2019-12-27 05:00:00,2019-12-27 00:00:00,LABORABLE
27,12,2019,7,347,312,659,2019-12-27 06:00:00,2019-12-27 00:00:00,LABORABLE
27,12,2019,8,538,478,1016,2019-12-27 07:00:00,2019-12-27 00:00:00,LABORABLE
27,12,2019,9,529,570,1099,2019-12-27 08:00:00,2019-12-27 00:00:00,LABORABLE
27,12,2019,10,543,643,1186,2019-12-27 09:00:00,2019-12-27 00:00:00,LABORABLE
27,12,2019,11,573,669,1242,2019-12-27 10:00:00,2019-12-27 00:00:00,LABORABLE
27,12,2019,12,565,809,1374,2019-12-27 11:00:00,2019-12-27 00:00:00,LABORABLE
27,12,2019,13,683,709,1392,2019-12-27 12:00:00,2019-12-27 00:00:00,LABORABLE
27,12,2019,14,687,783,1470,2019-12-27 13:00:00,2019-12-27 00:00:00,LABORABLE
27,12,2019,15,644,763,1407,2019-12-27 14:00:00,2019-12-27 00:00:00,LABORABLE
27,12,2019,16,594,727,1321,2019-12-27 15:00:00,2019-12-27 00:00:00,LABORABLE
27,12,2019,17,645,780,1425,2019-12-27 16:00:00,2019-12-27 00:00:00,LABORABLE
27,12,2019,18,607,795,1402,2019-12-27 17:00:00,2019-12-27 00:00:00,LABORABLE
27,12,2019,19,677,833,1510,2019-12-27 18:00:00,2019-12-27 00:00:00,LABORABLE
27,12,2019,20,704,856,1560,2019-12-27 19:00:00,2019-12-27 00:00:00,LABORABLE
27,12,2019,21,662,864,1526,2019-12-27 20:00:00,2019-12-27 00:00:00,LABORABLE
27,12,2019,22,563,711,1274,2019-12-27 21:00:00,2019-12-27 00:00:00,LABORABLE
27,12,2019,23,513,601,1114,2019-12-27 22:00:00,2019-12-27 00:00:00,LABORABLE
27,12,2019,24,404,503,907,2019-12-27 23:00:00,2019-12-27 00:00:00,LABORABLE
28,12,2019,1,326,406,732,2019-12-28 00:00:00,2019-12-28 00:00:00,LABORABLE
28,12,2019,2,276,365,641,2019-12-28 01:00:00,2019-12-28 00:00:00,LABORABLE
28,12,2019,3,207,314,521,2019-12-28 02:00:00,2019-12-28 00:00:00,LABORABLE
28,12,2019,4,152,238,390,2019-12-28 03:00:00,2019-12-28 00:00:00,LABORABLE
28,12,2019,5,170,193,363,2019-12-28 04:00:00,2019-12-28 00:00:00,LABORABLE
28,12,2019,6,160,249,409,2019-12-28 05:00:00,2019-12-28 00:00:00,LABORABLE
28,12,2019,7,208,269,477,2019-12-28 06:00:00,2019-12-28 00:00:00,LABORABLE
28,12,2019,8,276,258,534,2019-12-28 07:00:00,2019-12-28 00:00:00,LABORABLE
28,12,2019,9,316,349,665,2019-12-28 08:00:00,2019-12-28 00:00:00,LABORABLE
28,12,2019,10,417,475,892,2019-12-28 09:00:00,2019-12-28 00:00:00,LABORABLE
28,12,2019,11,500,539,1039,2019-12-28 10:00:00,2019-12-28 00:00:00,LABORABLE
28,12,2019,12,619,623,1242,2019-12-28 11:00:00,2019-12-28 00:00:00,LABORABLE
28,12,2019,13,581,761,1342,2019-12-28 12:00:00,2019-12-28 00:00:00,LABORABLE
28,12,2019,14,630,749,1379,2019-12-28 13:00:00,2019-12-28 00:00:00,LABORABLE
28,12,2019,15,618,731,1349,2019-12-28 14:00:00,2019-12-28 00:00:00,LABORABLE
28,12,2019,16,497,724,1221,2019-12-28 15:00:00,2019-12-28 00:00:00,LABORABLE
28,12,2019,17,476,730,1206,2019-12-28 16:00:00,2019-12-28 00:00:00,LABORABLE
28,12,2019,18,549,758,1307,2019-12-28 17:00:00,2019-12-28 00:00:00,LABORABLE
28,12,2019,19,619,728,1347,2019-12-28 18:00:00,2019-12-28 00:00:00,LABORABLE
28,12,2019,20,629,769,1398,2019-12-28 19:00:00,2019-12-28 00:00:00,LABORABLE
28,12,2019,21,612,765,1377,2019-12-28 20:00:00,2019-12-28 00:00:00,LABORABLE
28,12,2019,22,616,700,1316,2019-12-28 21:00:00,2019-12-28 00:00:00,LABORABLE
28,12,2019,23,740,574,1314,2019-12-28 22:00:00,2019-12-28 00:00:00,LABORABLE
28,12,2019,24,495,560,1055,2019-12-28 23:00:00,2019-12-28 00:00:00,LABORABLE
29,12,2019,1,390,542,932,2019-12-29 00:00:00,2019-12-29 00:00:00,LABORABLE
29,12,2019,2,297,442,739,2019-12-29 01:00:00,2019-12-29 00:00:00,LABORABLE
29,12,2019,3,279,385,664,2019-12-29 02:00:00,2019-12-29 00:00:00,LABORABLE
29,12,2019,4,209,357,566,2019-12-29 03:00:00,2019-12-29 00:00:00,LABORABLE
29,12,2019,5,183,234,417,2019-12-29 04:00:00,2019-12-29 00:00:00,LABORABLE
29,12,2019,6,165,243,408,2019-12-29 05:00:00,2019-12-29 00:00:00,LABORABLE
29,12,2019,7,169,307,476,2019-12-29 06:00:00,2019-12-29 00:00:00,LABORABLE
29,12,2019,8,177,240,417,2019-12-29 07:00:00,2019-12-29 00:00:00,LABORABLE
29,12,2019,9,228,257,485,2019-12-29 08:00:00,2019-12-29 00:00:00,LABORABLE
29,12,2019,10,327,369,696,2019-12-29 09:00:00,2019-12-29 00:00:00,LABORABLE
29,12,2019,11,373,448,821,2019-12-29 10:00:00,2019-12-29 00:00:00,LABORABLE
29,12,2019,12,487,552,1039,2019-12-29 11:00:00,2019-12-29 00:00:00,LABORABLE
29,12,2019,13,555,633,1188,2019-12-29 12:00:00,2019-12-29 00:00:00,LABORABLE
29,12,2019,14,536,686,1222,2019-12-29 13:00:00,2019-12-29 00:00:00,LABORABLE
29,12,2019,15,531,682,1213,2019-12-29 14:00:00,2019-12-29 00:00:00,LABORABLE
29,12,2019,16,494,701,1195,2019-12-29 15:00:00,2019-12-29 00:00:00,LABORABLE
29,12,2019,17,438,690,1128,2019-12-29 16:00:00,2019-12-29 00:00:00,LABORABLE
29,12,2019,18,531,735,1266,2019-12-29 17:00:00,2019-12-29 00:00:00,LABORABLE
29,12,2019,19,569,753,1322,2019-12-29 18:00:00,2019-12-29 00:00:00,LABORABLE
29,12,2019,20,601,749,1350,2019-12-29 19:00:00,2019-12-29 00:00:00,LABORABLE
29,12,2019,21,503,665,1168,2019-12-29 20:00:00,2019-12-29 00:00:00,LABORABLE
29,12,2019,22,511,578,1089,2019-12-29 21:00:00,2019-12-29 00:00:00,LABORABLE
29,12,2019,23,619,487,1106,2019-12-29 22:00:00,2019-12-29 00:00:00,LABORABLE
29,12,2019,24,416,462,878,2019-12-29 23:00:00,2019-12-29 00:00:00,LABORABLE
30,12,2019,1,233,321,554,2019-12-30 00:00:00,2019-12-30 00:00:00,LABORABLE
30,12,2019,2,156,226,382,2019-12-30 01:00:00,2019-12-30 00:00:00,LABORABLE
30,12,2019,3,116,163,279,2019-12-30 02:00:00,2019-12-30 00:00:00,LABORABLE
30,12,2019,4,97,137,234,2019-12-30 03:00:00,2019-12-30 00:00:00,LABORABLE
30,12,2019,5,58,128,186,2019-12-30 04:00:00,2019-12-30 00:00:00,LABORABLE
30,12,2019,6,165,175,340,2019-12-30 05:00:00,2019-12-30 00:00:00,LABORABLE
30,12,2019,7,299,293,592,2019-12-30 06:00:00,2019-12-30 00:00:00,LABORABLE
30,12,2019,8,480,453,933,2019-12-30 07:00:00,2019-12-30 00:00:00,LABORABLE
30,12,2019,9,538,552,1090,2019-12-30 08:00:00,2019-12-30 00:00:00,LABORABLE
30,12,2019,10,529,654,1183,2019-12-30 09:00:00,2019-12-30 00:00:00,LABORABLE
30,12,2019,11,601,666,1267,2019-12-30 10:00:00,2019-12-30 00:00:00,LABORABLE
30,12,2019,12,668,685,1353,2019-12-30 11:00:00,2019-12-30 00:00:00,LABORABLE
30,12,2019,13,683,868,1551,2019-12-30 12:00:00,2019-12-30 00:00:00,LABORABLE
30,12,2019,14,671,808,1479,2019-12-30 13:00:00,2019-12-30 00:00:00,LABORABLE
30,12,2019,15,671,787,1458,2019-12-30 14:00:00,2019-12-30 00:00:00,LABORABLE
30,12,2019,16,634,731,1365,2019-12-30 15:00:00,2019-12-30 00:00:00,LABORABLE
30,12,2019,17,611,800,1411,2019-12-30 16:00:00,2019-12-30 00:00:00,LABORABLE
30,12,2019,18,620,774,1394,2019-12-30 17:00:00,2019-12-30 00:00:00,LABORABLE
30,12,2019,19,678,802,1480,2019-12-30 18:00:00,2019-12-30 00:00:00,LABORABLE
30,12,2019,20,680,863,1543,2019-12-30 19:00:00,2019-12-30 00:00:00,LABORABLE
30,12,2019,21,615,766,1381,2019-12-30 20:00:00,2019-12-30 00:00:00,LABORABLE
30,12,2019,22,537,688,1225,2019-12-30 21:00:00,2019-12-30 00:00:00,LABORABLE
30,12,2019,23,473,499,972,2019-12-30 22:00:00,2019-12-30 00:00:00,LABORABLE
30,12,2019,24,308,454,762,2019-12-30 23:00:00,2019-12-30 00:00:00,LABORABLE
31,12,2019,1,264,343,607,2019-12-31 00:00:00,2019-12-31 00:00:00,LABORABLE
31,12,2019,2,187,263,450,2019-12-31 01:00:00,2019-12-31 00:00:00,LABORABLE
31,12,2019,3,120,224,344,2019-12-31 02:00:00,2019-12-31 00:00:00,LABORABLE
31,12,2019,4,97,129,226,2019-12-31 03:00:00,2019-12-31 00:00:00,LABORABLE
31,12,2019,5,108,143,251,2019-12-31 04:00:00,2019-12-31 00:00:00,LABORABLE
31,12,2019,6,150,172,322,2019-12-31 05:00:00,2019-12-31 00:00:00,LABORABLE
31,12,2019,7,202,259,461,2019-12-31 06:00:00,2019-12-31 00:00:00,LABORABLE
31,12,2019,8,345,342,687,2019-12-31 07:00:00,2019-12-31 00:00:00,LABORABLE
31,12,2019,9,393,438,831,2019-12-31 08:00:00,2019-12-31 00:00:00,LABORABLE
31,12,2019,10,445,565,1010,2019-12-31 09:00:00,2019-12-31 00:00:00,LABORABLE
31,12,2019,11,534,644,1178,2019-12-31 10:00:00,2019-12-31 00:00:00,LABORABLE
31,12,2019,12,621,862,1483,2019-12-31 11:00:00,2019-12-31 00:00:00,LABORABLE
31,12,2019,13,734,842,1576,2019-12-31 12:00:00,2019-12-31 00:00:00,LABORABLE
31,12,2019,14,760,817,1577,2019-12-31 13:00:00,2019-12-31 00:00:00,LABORABLE
31,12,2019,15,689,851,1540,2019-12-31 14:00:00,2019-12-31 00:00:00,LABORABLE
31,12,2019,16,627,835,1462,2019-12-31 15:00:00,2019-12-31 00:00:00,LABORABLE
31,12,2019,17,621,803,1424,2019-12-31 16:00:00,2019-12-31 00:00:00,LABORABLE
31,12,2019,18,629,783,1412,2019-12-31 17:00:00,2019-12-31 00:00:00,LABORABLE
31,12,2019,19,639,836,1475,2019-12-31 18:00:00,2019-12-31 00:00:00,LABORABLE
31,12,2019,20,746,785,1531,2019-12-31 19:00:00,2019-12-31 00:00:00,LABORABLE
31,12,2019,21,771,705,1476,2019-12-31 20:00:00,2019-12-31 00:00:00,LABORABLE
31,12,2019,22,550,604,1154,2019-12-31 21:00:00,2019-12-31 00:00:00,LABORABLE
31,12,2019,23,328,473,801,2019-12-31 22:00:00,2019-12-31 00:00:00,LABORABLE
31,12,2019,24,223,344,567,2019-12-31 23:00:00,2019-12-31 00:00:00,LABORABLE
1,1,2020,1,450,488,938,2020-01-01 00:00:00,2020-01-01 00:00:00,FESTIVO
1,1,2020,2,796,763,1559,2020-01-01 01:00:00,2020-01-01 00:00:00,FESTIVO
1,1,2020,3,653,576,1229,2020-01-01 02:00:00,2020-01-01 00:00:00,FESTIVO
1,1,2020,4,439,482,921,2020-01-01 03:00:00,2020-01-01 00:00:00,FESTIVO
1,1,2020,5,332,407,739,2020-01-01 04:00:00,2020-01-01 00:00:00,FESTIVO
1,1,2020,6,291,350,641,2020-01-01 05:00:00,2020-01-01 00:00:00,FESTIVO
1,1,2020,7,279,353,632,2020-01-01 06:00:00,2020-01-01 00:00:00,FESTIVO
1,1,2020,8,235,295,530,2020-01-01 07:00:00,2020-01-01 00:00:00,FESTIVO
1,1,2020,9,180,227,407,2020-01-01 08:00:00,2020-01-01 00:00:00,FESTIVO
1,1,2020,10,156,214,370,2020-01-01 09:00:00,2020-01-01 00:00:00,FESTIVO
1,1,2020,11,167,234,401,2020-01-01 10:00:00,2020-01-01 00:00:00,FESTIVO
1,1,2020,12,244,289,533,2020-01-01 11:00:00,2020-01-01 00:00:00,FESTIVO
1,1,2020,13,363,349,712,2020-01-01 12:00:00,2020-01-01 00:00:00,FESTIVO
1,1,2020,14,459,536,995,2020-01-01 13:00:00,2020-01-01 00:00:00,FESTIVO
1,1,2020,15,498,513,1011,2020-01-01 14:00:00,2020-01-01 00:00:00,FESTIVO
1,1,2020,16,362,551,913,2020-01-01 15:00:00,2020-01-01 00:00:00,FESTIVO
1,1,2020,17,353,522,875,2020-01-01 16:00:00,2020-01-01 00:00:00,FESTIVO
1,1,2020,18,501,603,1104,2020-01-01 17:00:00,2020-01-01 00:00:00,FESTIVO
1,1,2020,19,612,697,1309,2020-01-01 18:00:00,2020-01-01 00:00:00,FESTIVO
1,1,2020,20,580,706,1286,2020-01-01 19:00:00,2020-01-01 00:00:00,FESTIVO
1,1,2020,21,499,582,1081,2020-01-01 20:00:00,2020-01-01 00:00:00,FESTIVO
1,1,2020,22,403,499,902,2020-01-01 21:00:00,2020-01-01 00:00:00,FESTIVO
1,1,2020,23,331,470,801,2020-01-01 22:00:00,2020-01-01 00:00:00,FESTIVO
1,1,2020,24,230,345,575,2020-01-01 23:00:00,2020-01-01 00:00:00,FESTIVO
2,1,2020,1,200,295,495,2020-01-02 00:00:00,2020-02-01 00:00:00,LABORABLE
2,1,2020,2,135,207,342,2020-01-02 01:00:00,2020-02-01 00:00:00,LABORABLE
2,1,2020,3,92,149,241,2020-01-02 02:00:00,2020-02-01 00:00:00,LABORABLE
2,1,2020,4,76,116,192,2020-01-02 03:00:00,2020-02-01 00:00:00,LABORABLE
2,1,2020,5,90,107,197,2020-01-02 04:00:00,2020-02-01 00:00:00,LABORABLE
2,1,2020,6,169,165,334,2020-01-02 05:00:00,2020-02-01 00:00:00,LABORABLE
2,1,2020,7,414,415,829,2020-01-02 06:00:00,2020-02-01 00:00:00,LABORABLE
2,1,2020,8,652,606,1258,2020-01-02 07:00:00,2020-02-01 00:00:00,LABORABLE
2,1,2020,9,686,692,1378,2020-01-02 08:00:00,2020-02-01 00:00:00,LABORABLE
2,1,2020,10,656,695,1351,2020-01-02 09:00:00,2020-02-01 00:00:00,LABORABLE
2,1,2020,11,600,662,1262,2020-01-02 10:00:00,2020-02-01 00:00:00,LABORABLE
2,1,2020,12,625,712,1337,2020-01-02 11:00:00,2020-02-01 00:00:00,LABORABLE
2,1,2020,13,642,734,1376,2020-01-02 12:00:00,2020-02-01 00:00:00,LABORABLE
2,1,2020,14,655,760,1415,2020-01-02 13:00:00,2020-02-01 00:00:00,LABORABLE
2,1,2020,15,655,725,1380,2020-01-02 14:00:00,2020-02-01 00:00:00,LABORABLE
2,1,2020,16,641,677,1318,2020-01-02 15:00:00,2020-02-01 00:00:00,LABORABLE
2,1,2020,17,656,731,1387,2020-01-02 16:00:00,2020-02-01 00:00:00,LABORABLE
2,1,2020,18,698,776,1474,2020-01-02 17:00:00,2020-02-01 00:00:00,LABORABLE
2,1,2020,19,706,788,1494,2020-01-02 18:00:00,2020-02-01 00:00:00,LABORABLE
2,1,2020,20,656,775,1431,2020-01-02 19:00:00,2020-02-01 00:00:00,LABORABLE
2,1,2020,21,654,740,1394,2020-01-02 20:00:00,2020-02-01 00:00:00,LABORABLE
2,1,2020,22,575,634,1209,2020-01-02 21:00:00,2020-02-01 00:00:00,LABORABLE
2,1,2020,23,460,511,971,2020-01-02 22:00:00,2020-02-01 00:00:00,LABORABLE
2,1,2020,24,312,384,696,2020-01-02 23:00:00,2020-02-01 00:00:00,LABORABLE
3,1,2020,1,216,333,549,2020-01-03 00:00:00,2020-03-01 00:00:00,LABORABLE
3,1,2020,2,140,237,377,2020-01-03 01:00:00,2020-03-01 00:00:00,LABORABLE
3,1,2020,3,109,185,294,2020-01-03 02:00:00,2020-03-01 00:00:00,LABORABLE
3,1,2020,4,97,149,246,2020-01-03 03:00:00,2020-03-01 00:00:00,LABORABLE
3,1,2020,5,104,132,236,2020-01-03 04:00:00,2020-03-01 00:00:00,LABORABLE
3,1,2020,6,180,182,362,2020-01-03 05:00:00,2020-03-01 00:00:00,LABORABLE
3,1,2020,7,239,407,646,2020-01-03 06:00:00,2020-03-01 00:00:00,LABORABLE
3,1,2020,8,378,572,950,2020-01-03 07:00:00,2020-03-01 00:00:00,LABORABLE
3,1,2020,9,626,635,1261,2020-01-03 08:00:00,2020-03-01 00:00:00,LABORABLE
3,1,2020,10,620,667,1287,2020-01-03 09:00:00,2020-03-01 00:00:00,LABORABLE
3,1,2020,11,577,654,1231,2020-01-03 10:00:00,2020-03-01 00:00:00,LABORABLE
3,1,2020,12,619,704,1323,2020-01-03 11:00:00,2020-03-01 00:00:00,LABORABLE
3,1,2020,13,650,744,1394,2020-01-03 12:00:00,2020-03-01 00:00:00,LABORABLE
3,1,2020,14,657,766,1423,2020-01-03 13:00:00,2020-03-01 00:00:00,LABORABLE
3,1,2020,15,664,741,1405,2020-01-03 14:00:00,2020-03-01 00:00:00,LABORABLE
3,1,2020,16,638,712,1350,2020-01-03 15:00:00,2020-03-01 00:00:00,LABORABLE
3,1,2020,17,644,742,1386,2020-01-03 16:00:00,2020-03-01 00:00:00,LABORABLE
3,1,2020,18,682,775,1457,2020-01-03 17:00:00,2020-03-01 00:00:00,LABORABLE
3,1,2020,19,687,800,1487,2020-01-03 18:00:00,2020-03-01 00:00:00,LABORABLE
3,1,2020,20,671,807,1478,2020-01-03 19:00:00,2020-03-01 00:00:00,LABORABLE
3,1,2020,21,666,786,1452,2020-01-03 20:00:00,2020-03-01 00:00:00,LABORABLE
3,1,2020,22,601,702,1303,2020-01-03 21:00:00,2020-03-01 00:00:00,LABORABLE
3,1,2020,23,524,601,1125,2020-01-03 22:00:00,2020-03-01 00:00:00,LABORABLE
3,1,2020,24,399,516,915,2020-01-03 23:00:00,2020-03-01 00:00:00,LABORABLE
4,1,2020,1,341,440,781,2020-01-04 00:00:00,2020-04-01 00:00:00,LABORABLE
4,1,2020,2,271,377,648,2020-01-04 01:00:00,2020-04-01 00:00:00,LABORABLE
4,1,2020,3,197,310,507,2020-01-04 02:00:00,2020-04-01 00:00:00,LABORABLE
4,1,2020,4,163,253,416,2020-01-04 03:00:00,2020-04-01 00:00:00,LABORABLE
4,1,2020,5,144,223,367,2020-01-04 04:00:00,2020-04-01 00:00:00,LABORABLE
4,1,2020,6,161,220,381,2020-01-04 05:00:00,2020-04-01 00:00:00,LABORABLE
4,1,2020,7,223,270,493,2020-01-04 06:00:00,2020-04-01 00:00:00,LABORABLE
4,1,2020,8,281,293,574,2020-01-04 07:00:00,2020-04-01 00:00:00,LABORABLE
4,1,2020,9,356,376,732,2020-01-04 08:00:00,2020-04-01 00:00:00,LABORABLE
4,1,2020,10,455,488,943,2020-01-04 09:00:00,2020-04-01 00:00:00,LABORABLE
4,1,2020,11,556,598,1154,2020-01-04 10:00:00,2020-04-01 00:00:00,LABORABLE
4,1,2020,12,628,678,1306,2020-01-04 11:00:00,2020-04-01 00:00:00,LABORABLE
4,1,2020,13,651,749,1400,2020-01-04 12:00:00,2020-04-01 00:00:00,LABORABLE
4,1,2020,14,681,787,1468,2020-01-04 13:00:00,2020-04-01 00:00:00,LABORABLE
4,1,2020,15,646,788,1434,2020-01-04 14:00:00,2020-04-01 00:00:00,LABORABLE
4,1,2020,16,541,710,1251,2020-01-04 15:00:00,2020-04-01 00:00:00,LABORABLE
4,1,2020,17,536,703,1239,2020-01-04 16:00:00,2020-04-01 00:00:00,LABORABLE
4,1,2020,18,588,745,1333,2020-01-04 17:00:00,2020-04-01 00:00:00,LABORABLE
4,1,2020,19,669,770,1439,2020-01-04 18:00:00,2020-04-01 00:00:00,LABORABLE
4,1,2020,20,642,769,1411,2020-01-04 19:00:00,2020-04-01 00:00:00,LABORABLE
4,1,2020,21,625,714,1339,2020-01-04 20:00:00,2020-04-01 00:00:00,LABORABLE
4,1,2020,22,585,674,1259,2020-01-04 21:00:00,2020-04-01 00:00:00,LABORABLE
4,1,2020,23,545,596,1141,2020-01-04 22:00:00,2020-04-01 00:00:00,LABORABLE
4,1,2020,24,467,548,1015,2020-01-04 23:00:00,2020-04-01 00:00:00,LABORABLE
5,1,2020,1,405,488,893,2020-01-05 00:00:00,2020-05-01 00:00:00,LABORABLE
5,1,2020,2,326,431,757,2020-01-05 01:00:00,2020-05-01 00:00:00,LABORABLE
5,1,2020,3,254,375,629,2020-01-05 02:00:00,2020-05-01 00:00:00,LABORABLE
5,1,2020,4,194,316,510,2020-01-05 03:00:00,2020-05-01 00:00:00,LABORABLE
5,1,2020,5,159,269,428,2020-01-05 04:00:00,2020-05-01 00:00:00,LABORABLE
5,1,2020,6,148,267,415,2020-01-05 05:00:00,2020-05-01 00:00:00,LABORABLE
5,1,2020,7,190,287,477,2020-01-05 06:00:00,2020-05-01 00:00:00,LABORABLE
5,1,2020,8,187,242,429,2020-01-05 07:00:00,2020-05-01 00:00:00,LABORABLE
5,1,2020,9,217,274,491,2020-01-05 08:00:00,2020-05-01 00:00:00,LABORABLE
5,1,2020,10,337,379,716,2020-01-05 09:00:00,2020-05-01 00:00:00,LABORABLE
5,1,2020,11,429,481,910,2020-01-05 10:00:00,2020-05-01 00:00:00,LABORABLE
5,1,2020,12,521,541,1062,2020-01-05 11:00:00,2020-05-01 00:00:00,LABORABLE
5,1,2020,13,570,630,1200,2020-01-05 12:00:00,2020-05-01 00:00:00,LABORABLE
5,1,2020,14,603,711,1314,2020-01-05 13:00:00,2020-05-01 00:00:00,LABORABLE
5,1,2020,15,583,696,1279,2020-01-05 14:00:00,2020-05-01 00:00:00,LABORABLE
5,1,2020,16,506,646,1152,2020-01-05 15:00:00,2020-05-01 00:00:00,LABORABLE
5,1,2020,17,505,676,1181,2020-01-05 16:00:00,2020-05-01 00:00:00,LABORABLE
5,1,2020,18,555,737,1292,2020-01-05 17:00:00,2020-05-01 00:00:00,LABORABLE
5,1,2020,19,584,730,1314,2020-01-05 18:00:00,2020-05-01 00:00:00,LABORABLE
5,1,2020,20,568,705,1273,2020-01-05 19:00:00,2020-05-01 00:00:00,LABORABLE
5,1,2020,21,527,660,1187,2020-01-05 20:00:00,2020-05-01 00:00:00,LABORABLE
5,1,2020,22,503,585,1088,2020-01-05 21:00:00,2020-05-01 00:00:00,LABORABLE
5,1,2020,23,430,484,914,2020-01-05 22:00:00,2020-05-01 00:00:00,LABORABLE
5,1,2020,24,319,397,716,2020-01-05 23:00:00,2020-05-01 00:00:00,LABORABLE
6,1,2020,1,223,314,537,2020-01-06 00:00:00,2020-06-01 00:00:00,FESTIVO
6,1,2020,2,153,245,398,2020-01-06 01:00:00,2020-06-01 00:00:00,FESTIVO
6,1,2020,3,118,197,315,2020-01-06 02:00:00,2020-06-01 00:00:00,FESTIVO
6,1,2020,4,94,154,248,2020-01-06 03:00:00,2020-06-01 00:00:00,FESTIVO
6,1,2020,5,97,142,239,2020-01-06 04:00:00,2020-06-01 00:00:00,FESTIVO
6,1,2020,6,174,197,371,2020-01-06 05:00:00,2020-06-01 00:00:00,FESTIVO
6,1,2020,7,396,410,806,2020-01-06 06:00:00,2020-06-01 00:00:00,FESTIVO
6,1,2020,8,587,562,1149,2020-01-06 07:00:00,2020-06-01 00:00:00,FESTIVO
6,1,2020,9,643,624,1267,2020-01-06 08:00:00,2020-06-01 00:00:00,FESTIVO
6,1,2020,10,612,633,1245,2020-01-06 09:00:00,2020-06-01 00:00:00,FESTIVO
6,1,2020,11,561,614,1175,2020-01-06 10:00:00,2020-06-01 00:00:00,FESTIVO
6,1,2020,12,586,653,1239,2020-01-06 11:00:00,2020-06-01 00:00:00,FESTIVO
6,1,2020,13,603,697,1300,2020-01-06 12:00:00,2020-06-01 00:00:00,FESTIVO
6,1,2020,14,659,758,1417,2020-01-06 13:00:00,2020-06-01 00:00:00,FESTIVO
6,1,2020,15,666,714,1380,2020-01-06 14:00:00,2020-06-01 00:00:00,FESTIVO
6,1,2020,16,649,691,1340,2020-01-06 15:00:00,2020-06-01 00:00:00,FESTIVO
6,1,2020,17,625,737,1362,2020-01-06 16:00:00,2020-06-01 00:00:00,FESTIVO
6,1,2020,18,676,764,1440,2020-01-06 17:00:00,2020-06-01 00:00:00,FESTIVO
6,1,2020,19,667,780,1447,2020-01-06 18:00:00,2020-06-01 00:00:00,FESTIVO
6,1,2020,20,630,793,1423,2020-01-06 19:00:00,2020-06-01 00:00:00,FESTIVO
6,1,2020,21,624,723,1347,2020-01-06 20:00:00,2020-06-01 00:00:00,FESTIVO
6,1,2020,22,509,597,1106,2020-01-06 21:00:00,2020-06-01 00:00:00,FESTIVO
6,1,2020,23,394,444,838,2020-01-06 22:00:00,2020-06-01 00:00:00,FESTIVO
6,1,2020,24,254,331,585,2020-01-06 23:00:00,2020-06-01 00:00:00,FESTIVO
7,1,2020,1,171,251,422,2020-01-07 00:00:00,2020-07-01 00:00:00,LABORABLE
7,1,2020,2,113,208,321,2020-01-07 01:00:00,2020-07-01 00:00:00,LABORABLE
7,1,2020,3,80,159,239,2020-01-07 02:00:00,2020-07-01 00:00:00,LABORABLE
7,1,2020,4,78,117,195,2020-01-07 03:00:00,2020-07-01 00:00:00,LABORABLE
7,1,2020,5,92,106,198,2020-01-07 04:00:00,2020-07-01 00:00:00,LABORABLE
7,1,2020,6,180,168,348,2020-01-07 05:00:00,2020-07-01 00:00:00,LABORABLE
7,1,2020,7,380,410,790,2020-01-07 06:00:00,2020-07-01 00:00:00,LABORABLE
7,1,2020,8,618,571,1189,2020-01-07 07:00:00,2020-07-01 00:00:00,LABORABLE
7,1,2020,9,637,664,1301,2020-01-07 08:00:00,2020-07-01 00:00:00,LABORABLE
7,1,2020,10,611,697,1308,2020-01-07 09:00:00,2020-07-01 00:00:00,LABORABLE
7,1,2020,11,567,660,1227,2020-01-07 10:00:00,2020-07-01 00:00:00,LABORABLE
7,1,2020,12,615,735,1350,2020-01-07 11:00:00,2020-07-01 00:00:00,LABORABLE
7,1,2020,13,642,760,1402,2020-01-07 12:00:00,2020-07-01 00:00:00,LABORABLE
7,1,2020,14,660,759,1419,2020-01-07 13:00:00,2020-07-01 00:00:00,LABORABLE
7,1,2020,15,663,730,1393,2020-01-07 14:00:00,2020-07-01 00:00:00,LABORABLE
7,1,2020,16,649,705,1354,2020-01-07 15:00:00,2020-07-01 00:00:00,LABORABLE
7,1,2020,17,650,752,1402,2020-01-07 16:00:00,2020-07-01 00:00:00,LABORABLE
7,1,2020,18,679,776,1455,2020-01-07 17:00:00,2020-07-01 00:00:00,LABORABLE
7,1,2020,19,669,776,1445,2020-01-07 18:00:00,2020-07-01 00:00:00,LABORABLE
7,1,2020,20,652,759,1411,2020-01-07 19:00:00,2020-07-01 00:00:00,LABORABLE
7,1,2020,21,652,731,1383,2020-01-07 20:00:00,2020-07-01 00:00:00,LABORABLE
7,1,2020,22,520,604,1124,2020-01-07 21:00:00,2020-07-01 00:00:00,LABORABLE
7,1,2020,23,391,452,843,2020-01-07 22:00:00,2020-07-01 00:00:00,LABORABLE
7,1,2020,24,263,341,604,2020-01-07 23:00:00,2020-07-01 00:00:00,LABORABLE
8,1,2020,1,226,293,519,2020-01-08 00:00:00,2020-08-01 00:00:00,LABORABLE
8,1,2020,2,103,243,346,2020-01-08 01:00:00,2020-08-01 00:00:00,LABORABLE
8,1,2020,3,68,184,252,2020-01-08 02:00:00,2020-08-01 00:00:00,LABORABLE
8,1,2020,4,59,146,205,2020-01-08 03:00:00,2020-08-01 00:00:00,LABORABLE
8,1,2020,5,65,113,178,2020-01-08 04:00:00,2020-08-01 00:00:00,LABORABLE
8,1,2020,6,108,178,286,2020-01-08 05:00:00,2020-08-01 00:00:00,LABORABLE
8,1,2020,7,399,401,800,2020-01-08 06:00:00,2020-08-01 00:00:00,LABORABLE
8,1,2020,8,599,565,1164,2020-01-08 07:00:00,2020-08-01 00:00:00,LABORABLE
8,1,2020,9,618,620,1238,2020-01-08 08:00:00,2020-08-01 00:00:00,LABORABLE
8,1,2020,10,581,637,1218,2020-01-08 09:00:00,2020-08-01 00:00:00,LABORABLE
8,1,2020,11,507,604,1111,2020-01-08 10:00:00,2020-08-01 00:00:00,LABORABLE
8,1,2020,12,553,650,1203,2020-01-08 11:00:00,2020-08-01 00:00:00,LABORABLE
8,1,2020,13,579,693,1272,2020-01-08 12:00:00,2020-08-01 00:00:00,LABORABLE
8,1,2020,14,619,710,1329,2020-01-08 13:00:00,2020-08-01 00:00:00,LABORABLE
8,1,2020,15,637,685,1322,2020-01-08 14:00:00,2020-08-01 00:00:00,LABORABLE
8,1,2020,16,613,646,1259,2020-01-08 15:00:00,2020-08-01 00:00:00,LABORABLE
8,1,2020,17,616,713,1329,2020-01-08 16:00:00,2020-08-01 00:00:00,LABORABLE
8,1,2020,18,665,732,1397,2020-01-08 17:00:00,2020-08-01 00:00:00,LABORABLE
8,1,2020,19,681,746,1427,2020-01-08 18:00:00,2020-08-01 00:00:00,LABORABLE
8,1,2020,20,638,757,1395,2020-01-08 19:00:00,2020-08-01 00:00:00,LABORABLE
8,1,2020,21,633,715,1348,2020-01-08 20:00:00,2020-08-01 00:00:00,LABORABLE
8,1,2020,22,499,600,1099,2020-01-08 21:00:00,2020-08-01 00:00:00,LABORABLE
8,1,2020,23,420,474,894,2020-01-08 22:00:00,2020-08-01 00:00:00,LABORABLE
8,1,2020,24,279,360,639,2020-01-08 23:00:00,2020-08-01 00:00:00,LABORABLE
9,1,2020,1,200,295,495,2020-01-09 00:00:00,2020-09-01 00:00:00,LABORABLE
9,1,2020,2,135,207,342,2020-01-09 01:00:00,2020-09-01 00:00:00,LABORABLE
9,1,2020,3,92,149,241,2020-01-09 02:00:00,2020-09-01 00:00:00,LABORABLE
9,1,2020,4,76,116,192,2020-01-09 03:00:00,2020-09-01 00:00:00,LABORABLE
9,1,2020,5,90,107,197,2020-01-09 04:00:00,2020-09-01 00:00:00,LABORABLE
9,1,2020,6,169,165,334,2020-01-09 05:00:00,2020-09-01 00:00:00,LABORABLE
9,1,2020,7,414,415,829,2020-01-09 06:00:00,2020-09-01 00:00:00,LABORABLE
9,1,2020,8,652,606,1258,2020-01-09 07:00:00,2020-09-01 00:00:00,LABORABLE
9,1,2020,9,686,692,1378,2020-01-09 08:00:00,2020-09-01 00:00:00,LABORABLE
9,1,2020,10,656,695,1351,2020-01-09 09:00:00,2020-09-01 00:00:00,LABORABLE
9,1,2020,11,600,662,1262,2020-01-09 10:00:00,2020-09-01 00:00:00,LABORABLE
9,1,2020,12,625,712,1337,2020-01-09 11:00:00,2020-09-01 00:00:00,LABORABLE
9,1,2020,13,642,734,1376,2020-01-09 12:00:00,2020-09-01 00:00:00,LABORABLE
9,1,2020,14,655,760,1415,2020-01-09 13:00:00,2020-09-01 00:00:00,LABORABLE
9,1,2020,15,655,725,1380,2020-01-09 14:00:00,2020-09-01 00:00:00,LABORABLE
9,1,2020,16,641,677,1318,2020-01-09 15:00:00,2020-09-01 00:00:00,LABORABLE
9,1,2020,17,656,731,1387,2020-01-09 16:00:00,2020-09-01 00:00:00,LABORABLE
9,1,2020,18,698,776,1474,2020-01-09 17:00:00,2020-09-01 00:00:00,LABORABLE
9,1,2020,19,706,788,1494,2020-01-09 18:00:00,2020-09-01 00:00:00,LABORABLE
9,1,2020,20,656,775,1431,2020-01-09 19:00:00,2020-09-01 00:00:00,LABORABLE
9,1,2020,21,654,740,1394,2020-01-09 20:00:00,2020-09-01 00:00:00,LABORABLE
9,1,2020,22,575,634,1209,2020-01-09 21:00:00,2020-09-01 00:00:00,LABORABLE
9,1,2020,23,460,511,971,2020-01-09 22:00:00,2020-09-01 00:00:00,LABORABLE
9,1,2020,24,312,384,696,2020-01-09 23:00:00,2020-09-01 00:00:00,LABORABLE
10,1,2020,1,216,333,549,2020-01-10 00:00:00,2020-10-01 00:00:00,LABORABLE
10,1,2020,2,140,237,377,2020-01-10 01:00:00,2020-10-01 00:00:00,LABORABLE
10,1,2020,3,109,185,294,2020-01-10 02:00:00,2020-10-01 00:00:00,LABORABLE
10,1,2020,4,97,149,246,2020-01-10 03:00:00,2020-10-01 00:00:00,LABORABLE
10,1,2020,5,104,132,236,2020-01-10 04:00:00,2020-10-01 00:00:00,LABORABLE
10,1,2020,6,180,182,362,2020-01-10 05:00:00,2020-10-01 00:00:00,LABORABLE
10,1,2020,7,239,407,646,2020-01-10 06:00:00,2020-10-01 00:00:00,LABORABLE
10,1,2020,8,378,572,950,2020-01-10 07:00:00,2020-10-01 00:00:00,LABORABLE
10,1,2020,9,669,590,1259,2020-01-10 08:00:00,2020-10-01 00:00:00,LABORABLE
10,1,2020,10,686,661,1347,2020-01-10 09:00:00,2020-10-01 00:00:00,LABORABLE
10,1,2020,11,602,664,1266,2020-01-10 10:00:00,2020-10-01 00:00:00,LABORABLE
10,1,2020,12,619,703,1322,2020-01-10 11:00:00,2020-10-01 00:00:00,LABORABLE
10,1,2020,13,645,776,1421,2020-01-10 12:00:00,2020-10-01 00:00:00,LABORABLE
10,1,2020,14,640,828,1468,2020-01-10 13:00:00,2020-10-01 00:00:00,LABORABLE
10,1,2020,15,668,749,1417,2020-01-10 14:00:00,2020-10-01 00:00:00,LABORABLE
10,1,2020,16,627,658,1285,2020-01-10 15:00:00,2020-10-01 00:00:00,LABORABLE
10,1,2020,17,640,756,1396,2020-01-10 16:00:00,2020-10-01 00:00:00,LABORABLE
10,1,2020,18,683,795,1478,2020-01-10 17:00:00,2020-10-01 00:00:00,LABORABLE
10,1,2020,19,704,801,1505,2020-01-10 18:00:00,2020-10-01 00:00:00,LABORABLE
10,1,2020,20,683,826,1509,2020-01-10 19:00:00,2020-10-01 00:00:00,LABORABLE
10,1,2020,21,659,777,1436,2020-01-10 20:00:00,2020-10-01 00:00:00,LABORABLE
10,1,2020,22,547,728,1275,2020-01-10 21:00:00,2020-10-01 00:00:00,LABORABLE
10,1,2020,23,455,572,1027,2020-01-10 22:00:00,2020-10-01 00:00:00,LABORABLE
10,1,2020,24,361,498,859,2020-01-10 23:00:00,2020-10-01 00:00:00,LABORABLE
11,1,2020,1,314,376,690,2020-01-11 00:00:00,2020-11-01 00:00:00,LABORABLE
11,1,2020,2,278,346,624,2020-01-11 01:00:00,2020-11-01 00:00:00,LABORABLE
11,1,2020,3,192,294,486,2020-01-11 02:00:00,2020-11-01 00:00:00,LABORABLE
11,1,2020,4,150,246,396,2020-01-11 03:00:00,2020-11-01 00:00:00,LABORABLE
11,1,2020,5,136,203,339,2020-01-11 04:00:00,2020-11-01 00:00:00,LABORABLE
11,1,2020,6,162,207,369,2020-01-11 05:00:00,2020-11-01 00:00:00,LABORABLE
11,1,2020,7,214,272,486,2020-01-11 06:00:00,2020-11-01 00:00:00,LABORABLE
11,1,2020,8,246,271,517,2020-01-11 07:00:00,2020-11-01 00:00:00,LABORABLE
11,1,2020,9,351,388,739,2020-01-11 08:00:00,2020-11-01 00:00:00,LABORABLE
11,1,2020,10,488,514,1002,2020-01-11 09:00:00,2020-11-01 00:00:00,LABORABLE
11,1,2020,11,559,588,1147,2020-01-11 10:00:00,2020-11-01 00:00:00,LABORABLE
11,1,2020,12,669,715,1384,2020-01-11 11:00:00,2020-11-01 00:00:00,LABORABLE
11,1,2020,13,650,801,1451,2020-01-11 12:00:00,2020-11-01 00:00:00,LABORABLE
11,1,2020,14,702,770,1472,2020-01-11 13:00:00,2020-11-01 00:00:00,LABORABLE
11,1,2020,15,640,787,1427,2020-01-11 14:00:00,2020-11-01 00:00:00,LABORABLE
11,1,2020,16,505,733,1238,2020-01-11 15:00:00,2020-11-01 00:00:00,LABORABLE
11,1,2020,17,597,699,1296,2020-01-11 16:00:00,2020-11-01 00:00:00,LABORABLE
11,1,2020,18,600,734,1334,2020-01-11 17:00:00,2020-11-01 00:00:00,LABORABLE
11,1,2020,19,664,807,1471,2020-01-11 18:00:00,2020-11-01 00:00:00,LABORABLE
11,1,2020,20,631,761,1392,2020-01-11 19:00:00,2020-11-01 00:00:00,LABORABLE
11,1,2020,21,683,721,1404,2020-01-11 20:00:00,2020-11-01 00:00:00,LABORABLE
11,1,2020,22,586,694,1280,2020-01-11 21:00:00,2020-11-01 00:00:00,LABORABLE
11,1,2020,23,549,576,1125,2020-01-11 22:00:00,2020-11-01 00:00:00,LABORABLE
11,1,2020,24,403,512,915,2020-01-11 23:00:00,2020-11-01 00:00:00,LABORABLE
12,1,2020,1,389,479,868,2020-01-12 00:00:00,2020-12-01 00:00:00,LABORABLE
12,1,2020,2,327,412,739,2020-01-12 01:00:00,2020-12-01 00:00:00,LABORABLE
12,1,2020,3,249,367,616,2020-01-12 02:00:00,2020-12-01 00:00:00,LABORABLE
12,1,2020,4,182,300,482,2020-01-12 03:00:00,2020-12-01 00:00:00,LABORABLE
12,1,2020,5,129,249,378,2020-01-12 04:00:00,2020-12-01 00:00:00,LABORABLE
12,1,2020,6,138,267,405,2020-01-12 05:00:00,2020-12-01 00:00:00,LABORABLE
12,1,2020,7,175,269,444,2020-01-12 06:00:00,2020-12-01 00:00:00,LABORABLE
12,1,2020,8,209,214,423,2020-01-12 07:00:00,2020-12-01 00:00:00,LABORABLE
12,1,2020,9,226,236,462,2020-01-12 08:00:00,2020-12-01 00:00:00,LABORABLE
12,1,2020,10,336,376,712,2020-01-12 09:00:00,2020-12-01 00:00:00,LABORABLE
12,1,2020,11,421,531,952,2020-01-12 10:00:00,2020-12-01 00:00:00,LABORABLE
12,1,2020,12,519,537,1056,2020-01-12 11:00:00,2020-12-01 00:00:00,LABORABLE
12,1,2020,13,540,605,1145,2020-01-12 12:00:00,2020-12-01 00:00:00,LABORABLE
12,1,2020,14,597,656,1253,2020-01-12 13:00:00,2020-12-01 00:00:00,LABORABLE
12,1,2020,15,567,660,1227,2020-01-12 14:00:00,2020-12-01 00:00:00,LABORABLE
12,1,2020,16,511,595,1106,2020-01-12 15:00:00,2020-12-01 00:00:00,LABORABLE
12,1,2020,17,508,674,1182,2020-01-12 16:00:00,2020-12-01 00:00:00,LABORABLE
12,1,2020,18,523,794,1317,2020-01-12 17:00:00,2020-12-01 00:00:00,LABORABLE
12,1,2020,19,594,742,1336,2020-01-12 18:00:00,2020-12-01 00:00:00,LABORABLE
12,1,2020,20,547,698,1245,2020-01-12 19:00:00,2020-12-01 00:00:00,LABORABLE
12,1,2020,21,450,596,1046,2020-01-12 20:00:00,2020-12-01 00:00:00,LABORABLE
12,1,2020,22,473,522,995,2020-01-12 21:00:00,2020-12-01 00:00:00,LABORABLE
12,1,2020,23,458,491,949,2020-01-12 22:00:00,2020-12-01 00:00:00,LABORABLE
12,1,2020,24,248,363,611,2020-01-12 23:00:00,2020-12-01 00:00:00,LABORABLE
13,1,2020,1,163,282,445,2020-01-13 00:00:00,2020-01-13 00:00:00,LABORABLE
13,1,2020,2,115,252,367,2020-01-13 01:00:00,2020-01-13 00:00:00,LABORABLE
13,1,2020,3,93,137,230,2020-01-13 02:00:00,2020-01-13 00:00:00,LABORABLE
13,1,2020,4,76,136,212,2020-01-13 03:00:00,2020-01-13 00:00:00,LABORABLE
13,1,2020,5,87,97,184,2020-01-13 04:00:00,2020-01-13 00:00:00,LABORABLE
13,1,2020,6,126,163,289,2020-01-13 05:00:00,2020-01-13 00:00:00,LABORABLE
13,1,2020,7,442,397,839,2020-01-13 06:00:00,2020-01-13 00:00:00,LABORABLE
13,1,2020,8,644,578,1222,2020-01-13 07:00:00,2020-01-13 00:00:00,LABORABLE
13,1,2020,9,642,667,1309,2020-01-13 08:00:00,2020-01-13 00:00:00,LABORABLE
13,1,2020,10,674,643,1317,2020-01-13 09:00:00,2020-01-13 00:00:00,LABORABLE
13,1,2020,11,570,649,1219,2020-01-13 10:00:00,2020-01-13 00:00:00,LABORABLE
13,1,2020,12,575,714,1289,2020-01-13 11:00:00,2020-01-13 00:00:00,LABORABLE
13,1,2020,13,594,765,1359,2020-01-13 12:00:00,2020-01-13 00:00:00,LABORABLE
13,1,2020,14,648,722,1370,2020-01-13 13:00:00,2020-01-13 00:00:00,LABORABLE
13,1,2020,15,667,694,1361,2020-01-13 14:00:00,2020-01-13 00:00:00,LABORABLE
13,1,2020,16,672,684,1356,2020-01-13 15:00:00,2020-01-13 00:00:00,LABORABLE
13,1,2020,17,602,764,1366,2020-01-13 16:00:00,2020-01-13 00:00:00,LABORABLE
13,1,2020,18,708,809,1517,2020-01-13 17:00:00,2020-01-13 00:00:00,LABORABLE
13,1,2020,19,681,793,1474,2020-01-13 18:00:00,2020-01-13 00:00:00,LABORABLE
13,1,2020,20,569,731,1300,2020-01-13 19:00:00,2020-01-13 00:00:00,LABORABLE
13,1,2020,21,603,667,1270,2020-01-13 20:00:00,2020-01-13 00:00:00,LABORABLE
13,1,2020,22,453,531,984,2020-01-13 21:00:00,2020-01-13 00:00:00,LABORABLE
13,1,2020,23,326,429,755,2020-01-13 22:00:00,2020-01-13 00:00:00,LABORABLE
13,1,2020,24,242,328,570,2020-01-13 23:00:00,2020-01-13 00:00:00,LABORABLE
14,1,2020,1,139,219,358,2020-01-14 00:00:00,2020-01-14 00:00:00,LABORABLE
14,1,2020,2,95,151,246,2020-01-14 01:00:00,2020-01-14 00:00:00,LABORABLE
14,1,2020,3,74,139,213,2020-01-14 02:00:00,2020-01-14 00:00:00,LABORABLE
14,1,2020,4,83,103,186,2020-01-14 03:00:00,2020-01-14 00:00:00,LABORABLE
14,1,2020,5,92,83,175,2020-01-14 04:00:00,2020-01-14 00:00:00,LABORABLE
14,1,2020,6,130,173,303,2020-01-14 05:00:00,2020-01-14 00:00:00,LABORABLE
14,1,2020,7,383,425,808,2020-01-14 06:00:00,2020-01-14 00:00:00,LABORABLE
14,1,2020,8,614,596,1210,2020-01-14 07:00:00,2020-01-14 00:00:00,LABORABLE
14,1,2020,9,663,713,1376,2020-01-14 08:00:00,2020-01-14 00:00:00,LABORABLE
14,1,2020,10,647,653,1300,2020-01-14 09:00:00,2020-01-14 00:00:00,LABORABLE
14,1,2020,11,552,714,1266,2020-01-14 10:00:00,2020-01-14 00:00:00,LABORABLE
14,1,2020,12,470,621,1091,2020-01-14 11:00:00,2020-01-14 00:00:00,LABORABLE
14,1,2020,13,636,754,1390,2020-01-14 12:00:00,2020-01-14 00:00:00,LABORABLE
14,1,2020,14,655,730,1385,2020-01-14 13:00:00,2020-01-14 00:00:00,LABORABLE
14,1,2020,15,670,693,1363,2020-01-14 14:00:00,2020-01-14 00:00:00,LABORABLE
14,1,2020,16,672,684,1356,2020-01-14 15:00:00,2020-01-14 00:00:00,LABORABLE
14,1,2020,17,619,809,1428,2020-01-14 16:00:00,2020-01-14 00:00:00,LABORABLE
14,1,2020,18,685,794,1479,2020-01-14 17:00:00,2020-01-14 00:00:00,LABORABLE
14,1,2020,19,666,795,1461,2020-01-14 18:00:00,2020-01-14 00:00:00,LABORABLE
14,1,2020,20,605,626,1231,2020-01-14 19:00:00,2020-01-14 00:00:00,LABORABLE
14,1,2020,21,639,785,1424,2020-01-14 20:00:00,2020-01-14 00:00:00,LABORABLE
14,1,2020,22,484,626,1110,2020-01-14 21:00:00,2020-01-14 00:00:00,LABORABLE
14,1,2020,23,341,460,801,2020-01-14 22:00:00,2020-01-14 00:00:00,LABORABLE
14,1,2020,24,246,324,570,2020-01-14 23:00:00,2020-01-14 00:00:00,LABORABLE
15,1,2020,1,179,252,431,2020-01-15 00:00:00,2020-01-15 00:00:00,LABORABLE
15,1,2020,2,90,164,254,2020-01-15 01:00:00,2020-01-15 00:00:00,LABORABLE
15,1,2020,3,59,123,182,2020-01-15 02:00:00,2020-01-15 00:00:00,LABORABLE
15,1,2020,4,81,98,179,2020-01-15 03:00:00,2020-01-15 00:00:00,LABORABLE
15,1,2020,5,95,80,175,2020-01-15 04:00:00,2020-01-15 00:00:00,LABORABLE
15,1,2020,6,108,144,252,2020-01-15 05:00:00,2020-01-15 00:00:00,LABORABLE
15,1,2020,7,278,422,700,2020-01-15 06:00:00,2020-01-15 00:00:00,LABORABLE
15,1,2020,8,662,609,1271,2020-01-15 07:00:00,2020-01-15 00:00:00,LABORABLE
15,1,2020,9,679,694,1373,2020-01-15 08:00:00,2020-01-15 00:00:00,LABORABLE
15,1,2020,10,619,670,1289,2020-01-15 09:00:00,2020-01-15 00:00:00,LABORABLE
15,1,2020,11,545,597,1142,2020-01-15 10:00:00,2020-01-15 00:00:00,LABORABLE
15,1,2020,12,376,796,1172,2020-01-15 11:00:00,2020-01-15 00:00:00,LABORABLE
15,1,2020,13,444,612,1056,2020-01-15 12:00:00,2020-01-15 00:00:00,LABORABLE
15,1,2020,14,632,731,1363,2020-01-15 13:00:00,2020-01-15 00:00:00,LABORABLE
15,1,2020,15,668,719,1387,2020-01-15 14:00:00,2020-01-15 00:00:00,LABORABLE
15,1,2020,16,658,632,1290,2020-01-15 15:00:00,2020-01-15 00:00:00,LABORABLE
15,1,2020,17,655,824,1479,2020-01-15 16:00:00,2020-01-15 00:00:00,LABORABLE
15,1,2020,18,709,769,1478,2020-01-15 17:00:00,2020-01-15 00:00:00,LABORABLE
15,1,2020,19,677,741,1418,2020-01-15 18:00:00,2020-01-15 00:00:00,LABORABLE
15,1,2020,20,637,759,1396,2020-01-15 19:00:00,2020-01-15 00:00:00,LABORABLE
15,1,2020,21,668,738,1406,2020-01-15 20:00:00,2020-01-15 00:00:00,LABORABLE
15,1,2020,22,469,625,1094,2020-01-15 21:00:00,2020-01-15 00:00:00,LABORABLE
15,1,2020,23,398,450,848,2020-01-15 22:00:00,2020-01-15 00:00:00,LABORABLE
15,1,2020,24,256,311,567,2020-01-15 23:00:00,2020-01-15 00:00:00,LABORABLE
16,1,2020,1,180,272,452,2020-01-16 00:00:00,2020-01-16 00:00:00,LABORABLE
16,1,2020,2,137,163,300,2020-01-16 01:00:00,2020-01-16 00:00:00,LABORABLE
16,1,2020,3,89,133,222,2020-01-16 02:00:00,2020-01-16 00:00:00,LABORABLE
16,1,2020,4,73,107,180,2020-01-16 03:00:00,2020-01-16 00:00:00,LABORABLE
16,1,2020,5,90,108,198,2020-01-16 04:00:00,2020-01-16 00:00:00,LABORABLE
16,1,2020,6,173,152,325,2020-01-16 05:00:00,2020-01-16 00:00:00,LABORABLE
16,1,2020,7,428,422,850,2020-01-16 06:00:00,2020-01-16 00:00:00,LABORABLE
16,1,2020,8,665,610,1275,2020-01-16 07:00:00,2020-01-16 00:00:00,LABORABLE
16,1,2020,9,700,714,1414,2020-01-16 08:00:00,2020-01-16 00:00:00,LABORABLE
16,1,2020,10,543,556,1099,2020-01-16 09:00:00,2020-01-16 00:00:00,LABORABLE
16,1,2020,11,571,644,1215,2020-01-16 10:00:00,2020-01-16 00:00:00,LABORABLE
16,1,2020,12,381,722,1103,2020-01-16 11:00:00,2020-01-16 00:00:00,LABORABLE
16,1,2020,13,628,769,1397,2020-01-16 12:00:00,2020-01-16 00:00:00,LABORABLE
16,1,2020,14,637,771,1408,2020-01-16 13:00:00,2020-01-16 00:00:00,LABORABLE
16,1,2020,15,645,786,1431,2020-01-16 14:00:00,2020-01-16 00:00:00,LABORABLE
16,1,2020,16,610,708,1318,2020-01-16 15:00:00,2020-01-16 00:00:00,LABORABLE
16,1,2020,17,576,630,1206,2020-01-16 16:00:00,2020-01-16 00:00:00,LABORABLE
16,1,2020,18,711,775,1486,2020-01-16 17:00:00,2020-01-16 00:00:00,LABORABLE
16,1,2020,19,703,805,1508,2020-01-16 18:00:00,2020-01-16 00:00:00,LABORABLE
16,1,2020,20,678,787,1465,2020-01-16 19:00:00,2020-01-16 00:00:00,LABORABLE
16,1,2020,21,654,760,1414,2020-01-16 20:00:00,2020-01-16 00:00:00,LABORABLE
16,1,2020,22,553,617,1170,2020-01-16 21:00:00,2020-01-16 00:00:00,LABORABLE
16,1,2020,23,427,515,942,2020-01-16 22:00:00,2020-01-16 00:00:00,LABORABLE
16,1,2020,24,291,355,646,2020-01-16 23:00:00,2020-01-16 00:00:00,LABORABLE
17,1,2020,1,205,327,532,2020-01-17 00:00:00,2020-01-17 00:00:00,LABORABLE
17,1,2020,2,121,218,339,2020-01-17 01:00:00,2020-01-17 00:00:00,LABORABLE
17,1,2020,3,83,159,242,2020-01-17 02:00:00,2020-01-17 00:00:00,LABORABLE
17,1,2020,4,93,116,209,2020-01-17 03:00:00,2020-01-17 00:00:00,LABORABLE
17,1,2020,5,111,117,228,2020-01-17 04:00:00,2020-01-17 00:00:00,LABORABLE
17,1,2020,6,122,161,283,2020-01-17 05:00:00,2020-01-17 00:00:00,LABORABLE
17,1,2020,7,239,417,656,2020-01-17 06:00:00,2020-01-17 00:00:00,LABORABLE
17,1,2020,8,378,631,1009,2020-01-17 07:00:00,2020-01-17 00:00:00,LABORABLE
17,1,2020,9,680,695,1375,2020-01-17 08:00:00,2020-01-17 00:00:00,LABORABLE
17,1,2020,10,651,705,1356,2020-01-17 09:00:00,2020-01-17 00:00:00,LABORABLE
17,1,2020,11,566,666,1232,2020-01-17 10:00:00,2020-01-17 00:00:00,LABORABLE
17,1,2020,12,633,696,1329,2020-01-17 11:00:00,2020-01-17 00:00:00,LABORABLE
17,1,2020,13,674,736,1410,2020-01-17 12:00:00,2020-01-17 00:00:00,LABORABLE
17,1,2020,14,605,695,1300,2020-01-17 13:00:00,2020-01-17 00:00:00,LABORABLE
17,1,2020,15,716,900,1616,2020-01-17 14:00:00,2020-01-17 00:00:00,LABORABLE
17,1,2020,16,640,710,1350,2020-01-17 15:00:00,2020-01-17 00:00:00,LABORABLE
17,1,2020,17,661,780,1441,2020-01-17 16:00:00,2020-01-17 00:00:00,LABORABLE
17,1,2020,18,689,720,1409,2020-01-17 17:00:00,2020-01-17 00:00:00,LABORABLE
17,1,2020,19,724,794,1518,2020-01-17 18:00:00,2020-01-17 00:00:00,LABORABLE
17,1,2020,20,691,834,1525,2020-01-17 19:00:00,2020-01-17 00:00:00,LABORABLE
17,1,2020,21,698,799,1497,2020-01-17 20:00:00,2020-01-17 00:00:00,LABORABLE
17,1,2020,22,581,729,1310,2020-01-17 21:00:00,2020-01-17 00:00:00,LABORABLE
17,1,2020,23,499,580,1079,2020-01-17 22:00:00,2020-01-17 00:00:00,LABORABLE
17,1,2020,24,412,523,935,2020-01-17 23:00:00,2020-01-17 00:00:00,LABORABLE
18,1,2020,1,313,410,723,2020-01-18 00:00:00,2020-01-18 00:00:00,LABORABLE
18,1,2020,2,246,334,580,2020-01-18 01:00:00,2020-01-18 00:00:00,LABORABLE
18,1,2020,3,169,254,423,2020-01-18 02:00:00,2020-01-18 00:00:00,LABORABLE
18,1,2020,4,156,232,388,2020-01-18 03:00:00,2020-01-18 00:00:00,LABORABLE
18,1,2020,5,123,212,335,2020-01-18 04:00:00,2020-01-18 00:00:00,LABORABLE
18,1,2020,6,152,179,331,2020-01-18 05:00:00,2020-01-18 00:00:00,LABORABLE
18,1,2020,7,224,256,480,2020-01-18 06:00:00,2020-01-18 00:00:00,LABORABLE
18,1,2020,8,273,275,548,2020-01-18 07:00:00,2020-01-18 00:00:00,LABORABLE
18,1,2020,9,350,363,713,2020-01-18 08:00:00,2020-01-18 00:00:00,LABORABLE
18,1,2020,10,472,500,972,2020-01-18 09:00:00,2020-01-18 00:00:00,LABORABLE
18,1,2020,11,518,626,1144,2020-01-18 10:00:00,2020-01-18 00:00:00,LABORABLE
18,1,2020,12,599,727,1326,2020-01-18 11:00:00,2020-01-18 00:00:00,LABORABLE
18,1,2020,13,619,723,1342,2020-01-18 12:00:00,2020-01-18 00:00:00,LABORABLE
18,1,2020,14,685,764,1449,2020-01-18 13:00:00,2020-01-18 00:00:00,LABORABLE
18,1,2020,15,686,731,1417,2020-01-18 14:00:00,2020-01-18 00:00:00,LABORABLE
18,1,2020,16,500,686,1186,2020-01-18 15:00:00,2020-01-18 00:00:00,LABORABLE
18,1,2020,17,522,686,1208,2020-01-18 16:00:00,2020-01-18 00:00:00,LABORABLE
18,1,2020,18,586,665,1251,2020-01-18 17:00:00,2020-01-18 00:00:00,LABORABLE
18,1,2020,19,699,797,1496,2020-01-18 18:00:00,2020-01-18 00:00:00,LABORABLE
18,1,2020,20,605,719,1324,2020-01-18 19:00:00,2020-01-18 00:00:00,LABORABLE
18,1,2020,21,609,689,1298,2020-01-18 20:00:00,2020-01-18 00:00:00,LABORABLE
18,1,2020,22,571,612,1183,2020-01-18 21:00:00,2020-01-18 00:00:00,LABORABLE
18,1,2020,23,493,547,1040,2020-01-18 22:00:00,2020-01-18 00:00:00,LABORABLE
18,1,2020,24,407,545,952,2020-01-18 23:00:00,2020-01-18 00:00:00,LABORABLE
19,1,2020,1,382,501,883,2020-01-19 00:00:00,2020-01-19 00:00:00,LABORABLE
19,1,2020,2,297,438,735,2020-01-19 01:00:00,2020-01-19 00:00:00,LABORABLE
19,1,2020,3,232,366,598,2020-01-19 02:00:00,2020-01-19 00:00:00,LABORABLE
19,1,2020,4,198,292,490,2020-01-19 03:00:00,2020-01-19 00:00:00,LABORABLE
19,1,2020,5,150,248,398,2020-01-19 04:00:00,2020-01-19 00:00:00,LABORABLE
19,1,2020,6,106,252,358,2020-01-19 05:00:00,2020-01-19 00:00:00,LABORABLE
19,1,2020,7,180,277,457,2020-01-19 06:00:00,2020-01-19 00:00:00,LABORABLE
19,1,2020,8,160,206,366,2020-01-19 07:00:00,2020-01-19 00:00:00,LABORABLE
19,1,2020,9,208,256,464,2020-01-19 08:00:00,2020-01-19 00:00:00,LABORABLE
19,1,2020,10,313,363,676,2020-01-19 09:00:00,2020-01-19 00:00:00,LABORABLE
19,1,2020,11,382,481,863,2020-01-19 10:00:00,2020-01-19 00:00:00,LABORABLE
19,1,2020,12,472,554,1026,2020-01-19 11:00:00,2020-01-19 00:00:00,LABORABLE
19,1,2020,13,511,603,1114,2020-01-19 12:00:00,2020-01-19 00:00:00,LABORABLE
19,1,2020,14,589,678,1267,2020-01-19 13:00:00,2020-01-19 00:00:00,LABORABLE
19,1,2020,15,593,657,1250,2020-01-19 14:00:00,2020-01-19 00:00:00,LABORABLE
19,1,2020,16,440,665,1105,2020-01-19 15:00:00,2020-01-19 00:00:00,LABORABLE
19,1,2020,17,531,650,1181,2020-01-19 16:00:00,2020-01-19 00:00:00,LABORABLE
19,1,2020,18,546,716,1262,2020-01-19 17:00:00,2020-01-19 00:00:00,LABORABLE
19,1,2020,19,543,718,1261,2020-01-19 18:00:00,2020-01-19 00:00:00,LABORABLE
19,1,2020,20,532,695,1227,2020-01-19 19:00:00,2020-01-19 00:00:00,LABORABLE
19,1,2020,21,481,640,1121,2020-01-19 20:00:00,2020-01-19 00:00:00,LABORABLE
19,1,2020,22,461,589,1050,2020-01-19 21:00:00,2020-01-19 00:00:00,LABORABLE
19,1,2020,23,360,402,762,2020-01-19 22:00:00,2020-01-19 00:00:00,LABORABLE
19,1,2020,24,277,346,623,2020-01-19 23:00:00,2020-01-19 00:00:00,LABORABLE
20,1,2020,1,175,259,434,2020-01-20 00:00:00,2020-01-20 00:00:00,LABORABLE
20,1,2020,2,121,188,309,2020-01-20 01:00:00,2020-01-20 00:00:00,LABORABLE
20,1,2020,3,84,147,231,2020-01-20 02:00:00,2020-01-20 00:00:00,LABORABLE
20,1,2020,4,83,124,207,2020-01-20 03:00:00,2020-01-20 00:00:00,LABORABLE
20,1,2020,5,84,121,205,2020-01-20 04:00:00,2020-01-20 00:00:00,LABORABLE
20,1,2020,6,185,155,340,2020-01-20 05:00:00,2020-01-20 00:00:00,LABORABLE
20,1,2020,7,461,409,870,2020-01-20 06:00:00,2020-01-20 00:00:00,LABORABLE
20,1,2020,8,636,583,1219,2020-01-20 07:00:00,2020-01-20 00:00:00,LABORABLE
20,1,2020,9,680,703,1383,2020-01-20 08:00:00,2020-01-20 00:00:00,LABORABLE
20,1,2020,10,618,699,1317,2020-01-20 09:00:00,2020-01-20 00:00:00,LABORABLE
20,1,2020,11,528,784,1312,2020-01-20 10:00:00,2020-01-20 00:00:00,LABORABLE
20,1,2020,12,402,801,1203,2020-01-20 11:00:00,2020-01-20 00:00:00,LABORABLE
20,1,2020,13,628,714,1342,2020-01-20 12:00:00,2020-01-20 00:00:00,LABORABLE
20,1,2020,14,620,815,1435,2020-01-20 13:00:00,2020-01-20 00:00:00,LABORABLE
20,1,2020,15,680,737,1417,2020-01-20 14:00:00,2020-01-20 00:00:00,LABORABLE
20,1,2020,16,654,729,1383,2020-01-20 15:00:00,2020-01-20 00:00:00,LABORABLE
20,1,2020,17,636,716,1352,2020-01-20 16:00:00,2020-01-20 00:00:00,LABORABLE
20,1,2020,18,684,766,1450,2020-01-20 17:00:00,2020-01-20 00:00:00,LABORABLE
20,1,2020,19,663,775,1438,2020-01-20 18:00:00,2020-01-20 00:00:00,LABORABLE
20,1,2020,20,583,783,1366,2020-01-20 19:00:00,2020-01-20 00:00:00,LABORABLE
20,1,2020,21,606,677,1283,2020-01-20 20:00:00,2020-01-20 00:00:00,LABORABLE
20,1,2020,22,486,523,1009,2020-01-20 21:00:00,2020-01-20 00:00:00,LABORABLE
20,1,2020,23,330,411,741,2020-01-20 22:00:00,2020-01-20 00:00:00,LABORABLE
20,1,2020,24,214,317,531,2020-01-20 23:00:00,2020-01-20 00:00:00,LABORABLE
21,1,2020,1,144,227,371,2020-01-21 00:00:00,2020-01-21 00:00:00,LABORABLE
21,1,2020,2,106,206,312,2020-01-21 01:00:00,2020-01-21 00:00:00,LABORABLE
21,1,2020,3,77,118,195,2020-01-21 02:00:00,2020-01-21 00:00:00,LABORABLE
21,1,2020,4,69,93,162,2020-01-21 03:00:00,2020-01-21 00:00:00,LABORABLE
21,1,2020,5,90,98,188,2020-01-21 04:00:00,2020-01-21 00:00:00,LABORABLE
21,1,2020,6,130,163,293,2020-01-21 05:00:00,2020-01-21 00:00:00,LABORABLE
21,1,2020,7,427,409,836,2020-01-21 06:00:00,2020-01-21 00:00:00,LABORABLE
21,1,2020,8,627,581,1208,2020-01-21 07:00:00,2020-01-21 00:00:00,LABORABLE
21,1,2020,9,704,691,1395,2020-01-21 08:00:00,2020-01-21 00:00:00,LABORABLE
21,1,2020,10,617,688,1305,2020-01-21 09:00:00,2020-01-21 00:00:00,LABORABLE
21,1,2020,11,567,612,1179,2020-01-21 10:00:00,2020-01-21 00:00:00,LABORABLE
21,1,2020,12,417,782,1199,2020-01-21 11:00:00,2020-01-21 00:00:00,LABORABLE
21,1,2020,13,627,723,1350,2020-01-21 12:00:00,2020-01-21 00:00:00,LABORABLE
21,1,2020,14,610,696,1306,2020-01-21 13:00:00,2020-01-21 00:00:00,LABORABLE
21,1,2020,15,662,678,1340,2020-01-21 14:00:00,2020-01-21 00:00:00,LABORABLE
21,1,2020,16,707,716,1423,2020-01-21 15:00:00,2020-01-21 00:00:00,LABORABLE
21,1,2020,17,666,683,1349,2020-01-21 16:00:00,2020-01-21 00:00:00,LABORABLE
21,1,2020,18,658,713,1371,2020-01-21 17:00:00,2020-01-21 00:00:00,LABORABLE
21,1,2020,19,664,712,1376,2020-01-21 18:00:00,2020-01-21 00:00:00,LABORABLE
21,1,2020,20,622,727,1349,2020-01-21 19:00:00,2020-01-21 00:00:00,LABORABLE
21,1,2020,21,579,631,1210,2020-01-21 20:00:00,2020-01-21 00:00:00,LABORABLE
21,1,2020,22,469,564,1033,2020-01-21 21:00:00,2020-01-21 00:00:00,LABORABLE
21,1,2020,23,365,426,791,2020-01-21 22:00:00,2020-01-21 00:00:00,LABORABLE
21,1,2020,24,203,306,509,2020-01-21 23:00:00,2020-01-21 00:00:00,LABORABLE
22,1,2020,1,160,246,406,2020-01-22 00:00:00,2020-01-22 00:00:00,LABORABLE
22,1,2020,2,97,151,248,2020-01-22 01:00:00,2020-01-22 00:00:00,LABORABLE
22,1,2020,3,78,113,191,2020-01-22 02:00:00,2020-01-22 00:00:00,LABORABLE
22,1,2020,4,73,92,165,2020-01-22 03:00:00,2020-01-22 00:00:00,LABORABLE
22,1,2020,5,81,97,178,2020-01-22 04:00:00,2020-01-22 00:00:00,LABORABLE
22,1,2020,6,108,139,247,2020-01-22 05:00:00,2020-01-22 00:00:00,LABORABLE
22,1,2020,7,408,383,791,2020-01-22 06:00:00,2020-01-22 00:00:00,LABORABLE
22,1,2020,8,619,554,1173,2020-01-22 07:00:00,2020-01-22 00:00:00,LABORABLE
22,1,2020,9,694,699,1393,2020-01-22 08:00:00,2020-01-22 00:00:00,LABORABLE
22,1,2020,10,640,664,1304,2020-01-22 09:00:00,2020-01-22 00:00:00,LABORABLE
22,1,2020,11,526,618,1144,2020-01-22 10:00:00,2020-01-22 00:00:00,LABORABLE
22,1,2020,12,600,707,1307,2020-01-22 11:00:00,2020-01-22 00:00:00,LABORABLE
22,1,2020,13,470,670,1140,2020-01-22 12:00:00,2020-01-22 00:00:00,LABORABLE
22,1,2020,14,592,747,1339,2020-01-22 13:00:00,2020-01-22 00:00:00,LABORABLE
22,1,2020,15,637,701,1338,2020-01-22 14:00:00,2020-01-22 00:00:00,LABORABLE
22,1,2020,16,655,657,1312,2020-01-22 15:00:00,2020-01-22 00:00:00,LABORABLE
22,1,2020,17,637,680,1317,2020-01-22 16:00:00,2020-01-22 00:00:00,LABORABLE
22,1,2020,18,648,783,1431,2020-01-22 17:00:00,2020-01-22 00:00:00,LABORABLE
22,1,2020,19,662,759,1421,2020-01-22 18:00:00,2020-01-22 00:00:00,LABORABLE
22,1,2020,20,604,747,1351,2020-01-22 19:00:00,2020-01-22 00:00:00,LABORABLE
22,1,2020,21,620,670,1290,2020-01-22 20:00:00,2020-01-22 00:00:00,LABORABLE
22,1,2020,22,446,620,1066,2020-01-22 21:00:00,2020-01-22 00:00:00,LABORABLE
22,1,2020,23,368,411,779,2020-01-22 22:00:00,2020-01-22 00:00:00,LABORABLE
22,1,2020,24,292,323,615,2020-01-22 23:00:00,2020-01-22 00:00:00,LABORABLE
23,1,2020,1,203,236,439,2020-01-23 00:00:00,2020-01-23 00:00:00,LABORABLE
23,1,2020,2,104,167,271,2020-01-23 01:00:00,2020-01-23 00:00:00,LABORABLE
23,1,2020,3,80,144,224,2020-01-23 02:00:00,2020-01-23 00:00:00,LABORABLE
23,1,2020,4,82,127,209,2020-01-23 03:00:00,2020-01-23 00:00:00,LABORABLE
23,1,2020,5,88,111,199,2020-01-23 04:00:00,2020-01-23 00:00:00,LABORABLE
23,1,2020,6,168,140,308,2020-01-23 05:00:00,2020-01-23 00:00:00,LABORABLE
23,1,2020,7,432,382,814,2020-01-23 06:00:00,2020-01-23 00:00:00,LABORABLE
23,1,2020,8,654,594,1248,2020-01-23 07:00:00,2020-01-23 00:00:00,LABORABLE
23,1,2020,9,713,717,1430,2020-01-23 08:00:00,2020-01-23 00:00:00,LABORABLE
23,1,2020,10,641,683,1324,2020-01-23 09:00:00,2020-01-23 00:00:00,LABORABLE
23,1,2020,11,615,655,1270,2020-01-23 10:00:00,2020-01-23 00:00:00,LABORABLE
23,1,2020,12,645,728,1373,2020-01-23 11:00:00,2020-01-23 00:00:00,LABORABLE
23,1,2020,13,614,739,1353,2020-01-23 12:00:00,2020-01-23 00:00:00,LABORABLE
23,1,2020,14,638,715,1353,2020-01-23 13:00:00,2020-01-23 00:00:00,LABORABLE
23,1,2020,15,647,731,1378,2020-01-23 14:00:00,2020-01-23 00:00:00,LABORABLE
23,1,2020,16,632,658,1290,2020-01-23 15:00:00,2020-01-23 00:00:00,LABORABLE
23,1,2020,17,658,722,1380,2020-01-23 16:00:00,2020-01-23 00:00:00,LABORABLE
23,1,2020,18,744,799,1543,2020-01-23 17:00:00,2020-01-23 00:00:00,LABORABLE
23,1,2020,19,706,790,1496,2020-01-23 18:00:00,2020-01-23 00:00:00,LABORABLE
23,1,2020,20,676,739,1415,2020-01-23 19:00:00,2020-01-23 00:00:00,LABORABLE
23,1,2020,21,632,698,1330,2020-01-23 20:00:00,2020-01-23 00:00:00,LABORABLE
23,1,2020,22,522,615,1137,2020-01-23 21:00:00,2020-01-23 00:00:00,LABORABLE
23,1,2020,23,456,530,986,2020-01-23 22:00:00,2020-01-23 00:00:00,LABORABLE
23,1,2020,24,288,376,664,2020-01-23 23:00:00,2020-01-23 00:00:00,LABORABLE
24,1,2020,1,187,280,467,2020-01-24 00:00:00,2020-01-24 00:00:00,LABORABLE
24,1,2020,2,108,270,378,2020-01-24 01:00:00,2020-01-24 00:00:00,LABORABLE
24,1,2020,3,102,161,263,2020-01-24 02:00:00,2020-01-24 00:00:00,LABORABLE
24,1,2020,4,101,136,237,2020-01-24 03:00:00,2020-01-24 00:00:00,LABORABLE
24,1,2020,5,113,134,247,2020-01-24 04:00:00,2020-01-24 00:00:00,LABORABLE
24,1,2020,6,122,185,307,2020-01-24 05:00:00,2020-01-24 00:00:00,LABORABLE
24,1,2020,7,239,394,633,2020-01-24 06:00:00,2020-01-24 00:00:00,LABORABLE
24,1,2020,8,378,614,992,2020-01-24 07:00:00,2020-01-24 00:00:00,LABORABLE
24,1,2020,9,672,671,1343,2020-01-24 08:00:00,2020-01-24 00:00:00,LABORABLE
24,1,2020,10,634,679,1313,2020-01-24 09:00:00,2020-01-24 00:00:00,LABORABLE
24,1,2020,11,600,654,1254,2020-01-24 10:00:00,2020-01-24 00:00:00,LABORABLE
24,1,2020,12,581,670,1251,2020-01-24 11:00:00,2020-01-24 00:00:00,LABORABLE
24,1,2020,13,612,786,1398,2020-01-24 12:00:00,2020-01-24 00:00:00,LABORABLE
24,1,2020,14,511,884,1395,2020-01-24 13:00:00,2020-01-24 00:00:00,LABORABLE
24,1,2020,15,681,783,1464,2020-01-24 14:00:00,2020-01-24 00:00:00,LABORABLE
24,1,2020,16,632,712,1344,2020-01-24 15:00:00,2020-01-24 00:00:00,LABORABLE
24,1,2020,17,681,763,1444,2020-01-24 16:00:00,2020-01-24 00:00:00,LABORABLE
24,1,2020,18,704,795,1499,2020-01-24 17:00:00,2020-01-24 00:00:00,LABORABLE
24,1,2020,19,672,798,1470,2020-01-24 18:00:00,2020-01-24 00:00:00,LABORABLE
24,1,2020,20,683,791,1474,2020-01-24 19:00:00,2020-01-24 00:00:00,LABORABLE
24,1,2020,21,680,800,1480,2020-01-24 20:00:00,2020-01-24 00:00:00,LABORABLE
24,1,2020,22,639,685,1324,2020-01-24 21:00:00,2020-01-24 00:00:00,LABORABLE
24,1,2020,23,577,582,1159,2020-01-24 22:00:00,2020-01-24 00:00:00,LABORABLE
24,1,2020,24,339,491,830,2020-01-24 23:00:00,2020-01-24 00:00:00,LABORABLE
25,1,2020,1,350,445,795,2020-01-25 00:00:00,2020-01-25 00:00:00,LABORABLE
25,1,2020,2,273,364,637,2020-01-25 01:00:00,2020-01-25 00:00:00,LABORABLE
25,1,2020,3,188,318,506,2020-01-25 02:00:00,2020-01-25 00:00:00,LABORABLE
25,1,2020,4,137,233,370,2020-01-25 03:00:00,2020-01-25 00:00:00,LABORABLE
25,1,2020,5,148,201,349,2020-01-25 04:00:00,2020-01-25 00:00:00,LABORABLE
25,1,2020,6,146,195,341,2020-01-25 05:00:00,2020-01-25 00:00:00,LABORABLE
25,1,2020,7,215,250,465,2020-01-25 06:00:00,2020-01-25 00:00:00,LABORABLE
25,1,2020,8,270,283,553,2020-01-25 07:00:00,2020-01-25 00:00:00,LABORABLE
25,1,2020,9,362,359,721,2020-01-25 08:00:00,2020-01-25 00:00:00,LABORABLE
25,1,2020,10,436,482,918,2020-01-25 09:00:00,2020-01-25 00:00:00,LABORABLE
25,1,2020,11,535,570,1105,2020-01-25 10:00:00,2020-01-25 00:00:00,LABORABLE
25,1,2020,12,600,640,1240,2020-01-25 11:00:00,2020-01-25 00:00:00,LABORABLE
25,1,2020,13,667,716,1383,2020-01-25 12:00:00,2020-01-25 00:00:00,LABORABLE
25,1,2020,14,697,817,1514,2020-01-25 13:00:00,2020-01-25 00:00:00,LABORABLE
25,1,2020,15,606,822,1428,2020-01-25 14:00:00,2020-01-25 00:00:00,LABORABLE
25,1,2020,16,554,674,1228,2020-01-25 15:00:00,2020-01-25 00:00:00,LABORABLE
25,1,2020,17,546,703,1249,2020-01-25 16:00:00,2020-01-25 00:00:00,LABORABLE
25,1,2020,18,602,725,1327,2020-01-25 17:00:00,2020-01-25 00:00:00,LABORABLE
25,1,2020,19,676,713,1389,2020-01-25 18:00:00,2020-01-25 00:00:00,LABORABLE
25,1,2020,20,644,759,1403,2020-01-25 19:00:00,2020-01-25 00:00:00,LABORABLE
25,1,2020,21,558,753,1311,2020-01-25 20:00:00,2020-01-25 00:00:00,LABORABLE
25,1,2020,22,554,660,1214,2020-01-25 21:00:00,2020-01-25 00:00:00,LABORABLE
25,1,2020,23,537,613,1150,2020-01-25 22:00:00,2020-01-25 00:00:00,LABORABLE
25,1,2020,24,496,563,1059,2020-01-25 23:00:00,2020-01-25 00:00:00,LABORABLE
26,1,2020,1,393,436,829,2020-01-26 00:00:00,2020-01-26 00:00:00,LABORABLE
26,1,2020,2,326,460,786,2020-01-26 01:00:00,2020-01-26 00:00:00,LABORABLE
26,1,2020,3,257,363,620,2020-01-26 02:00:00,2020-01-26 00:00:00,LABORABLE
26,1,2020,4,181,293,474,2020-01-26 03:00:00,2020-01-26 00:00:00,LABORABLE
26,1,2020,5,146,298,444,2020-01-26 04:00:00,2020-01-26 00:00:00,LABORABLE
26,1,2020,6,139,259,398,2020-01-26 05:00:00,2020-01-26 00:00:00,LABORABLE
26,1,2020,7,189,272,461,2020-01-26 06:00:00,2020-01-26 00:00:00,LABORABLE
26,1,2020,8,153,215,368,2020-01-26 07:00:00,2020-01-26 00:00:00,LABORABLE
26,1,2020,9,209,280,489,2020-01-26 08:00:00,2020-01-26 00:00:00,LABORABLE
26,1,2020,10,351,311,662,2020-01-26 09:00:00,2020-01-26 00:00:00,LABORABLE
26,1,2020,11,448,344,792,2020-01-26 10:00:00,2020-01-26 00:00:00,LABORABLE
26,1,2020,12,500,281,781,2020-01-26 11:00:00,2020-01-26 00:00:00,LABORABLE
26,1,2020,13,534,377,911,2020-01-26 12:00:00,2020-01-26 00:00:00,LABORABLE
26,1,2020,14,594,783,1377,2020-01-26 13:00:00,2020-01-26 00:00:00,LABORABLE
26,1,2020,15,577,751,1328,2020-01-26 14:00:00,2020-01-26 00:00:00,LABORABLE
26,1,2020,16,531,642,1173,2020-01-26 15:00:00,2020-01-26 00:00:00,LABORABLE
26,1,2020,17,528,716,1244,2020-01-26 16:00:00,2020-01-26 00:00:00,LABORABLE
26,1,2020,18,558,731,1289,2020-01-26 17:00:00,2020-01-26 00:00:00,LABORABLE
26,1,2020,19,583,777,1360,2020-01-26 18:00:00,2020-01-26 00:00:00,LABORABLE
26,1,2020,20,557,691,1248,2020-01-26 19:00:00,2020-01-26 00:00:00,LABORABLE
26,1,2020,21,559,636,1195,2020-01-26 20:00:00,2020-01-26 00:00:00,LABORABLE
26,1,2020,22,535,547,1082,2020-01-26 21:00:00,2020-01-26 00:00:00,LABORABLE
26,1,2020,23,389,481,870,2020-01-26 22:00:00,2020-01-26 00:00:00,LABORABLE
26,1,2020,24,442,347,789,2020-01-26 23:00:00,2020-01-26 00:00:00,LABORABLE
27,1,2020,1,203,268,471,2020-01-27 00:00:00,2020-01-27 00:00:00,LABORABLE
27,1,2020,2,132,195,327,2020-01-27 01:00:00,2020-01-27 00:00:00,LABORABLE
27,1,2020,3,86,149,235,2020-01-27 02:00:00,2020-01-27 00:00:00,LABORABLE
27,1,2020,4,81,129,210,2020-01-27 03:00:00,2020-01-27 00:00:00,LABORABLE
27,1,2020,5,77,114,191,2020-01-27 04:00:00,2020-01-27 00:00:00,LABORABLE
27,1,2020,6,126,158,284,2020-01-27 05:00:00,2020-01-27 00:00:00,LABORABLE
27,1,2020,7,422,422,844,2020-01-27 06:00:00,2020-01-27 00:00:00,LABORABLE
27,1,2020,8,649,583,1232,2020-01-27 07:00:00,2020-01-27 00:00:00,LABORABLE
27,1,2020,9,710,693,1403,2020-01-27 08:00:00,2020-01-27 00:00:00,LABORABLE
27,1,2020,10,621,610,1231,2020-01-27 09:00:00,2020-01-27 00:00:00,LABORABLE
27,1,2020,11,491,624,1115,2020-01-27 10:00:00,2020-01-27 00:00:00,LABORABLE
27,1,2020,12,536,678,1214,2020-01-27 11:00:00,2020-01-27 00:00:00,LABORABLE
27,1,2020,13,616,619,1235,2020-01-27 12:00:00,2020-01-27 00:00:00,LABORABLE
27,1,2020,14,586,726,1312,2020-01-27 13:00:00,2020-01-27 00:00:00,LABORABLE
27,1,2020,15,632,641,1273,2020-01-27 14:00:00,2020-01-27 00:00:00,LABORABLE
27,1,2020,16,640,703,1343,2020-01-27 15:00:00,2020-01-27 00:00:00,LABORABLE
27,1,2020,17,647,695,1342,2020-01-27 16:00:00,2020-01-27 00:00:00,LABORABLE
27,1,2020,18,683,742,1425,2020-01-27 17:00:00,2020-01-27 00:00:00,LABORABLE
27,1,2020,19,649,800,1449,2020-01-27 18:00:00,2020-01-27 00:00:00,LABORABLE
27,1,2020,20,616,749,1365,2020-01-27 19:00:00,2020-01-27 00:00:00,LABORABLE
27,1,2020,21,600,667,1267,2020-01-27 20:00:00,2020-01-27 00:00:00,LABORABLE
27,1,2020,22,461,528,989,2020-01-27 21:00:00,2020-01-27 00:00:00,LABORABLE
27,1,2020,23,324,370,694,2020-01-27 22:00:00,2020-01-27 00:00:00,LABORABLE
27,1,2020,24,193,274,467,2020-01-27 23:00:00,2020-01-27 00:00:00,LABORABLE
28,1,2020,1,157,227,384,2020-01-28 00:00:00,2020-01-28 00:00:00,LABORABLE
28,1,2020,2,95,169,264,2020-01-28 01:00:00,2020-01-28 00:00:00,LABORABLE
28,1,2020,3,63,122,185,2020-01-28 02:00:00,2020-01-28 00:00:00,LABORABLE
28,1,2020,4,72,108,180,2020-01-28 03:00:00,2020-01-28 00:00:00,LABORABLE
28,1,2020,5,85,106,191,2020-01-28 04:00:00,2020-01-28 00:00:00,LABORABLE
28,1,2020,6,188,144,332,2020-01-28 05:00:00,2020-01-28 00:00:00,LABORABLE
28,1,2020,7,411,432,843,2020-01-28 06:00:00,2020-01-28 00:00:00,LABORABLE
28,1,2020,8,670,559,1229,2020-01-28 07:00:00,2020-01-28 00:00:00,LABORABLE
28,1,2020,9,652,724,1376,2020-01-28 08:00:00,2020-01-28 00:00:00,LABORABLE
28,1,2020,10,630,794,1424,2020-01-28 09:00:00,2020-01-28 00:00:00,LABORABLE
28,1,2020,11,597,636,1233,2020-01-28 10:00:00,2020-01-28 00:00:00,LABORABLE
28,1,2020,12,478,564,1042,2020-01-28 11:00:00,2020-01-28 00:00:00,LABORABLE
28,1,2020,13,616,740,1356,2020-01-28 12:00:00,2020-01-28 00:00:00,LABORABLE
28,1,2020,14,641,741,1382,2020-01-28 13:00:00,2020-01-28 00:00:00,LABORABLE
28,1,2020,15,657,670,1327,2020-01-28 14:00:00,2020-01-28 00:00:00,LABORABLE
28,1,2020,16,682,637,1319,2020-01-28 15:00:00,2020-01-28 00:00:00,LABORABLE
28,1,2020,17,646,778,1424,2020-01-28 16:00:00,2020-01-28 00:00:00,LABORABLE
28,1,2020,18,704,691,1395,2020-01-28 17:00:00,2020-01-28 00:00:00,LABORABLE
28,1,2020,19,642,755,1397,2020-01-28 18:00:00,2020-01-28 00:00:00,LABORABLE
28,1,2020,20,631,746,1377,2020-01-28 19:00:00,2020-01-28 00:00:00,LABORABLE
28,1,2020,21,584,753,1337,2020-01-28 20:00:00,2020-01-28 00:00:00,LABORABLE
28,1,2020,22,520,571,1091,2020-01-28 21:00:00,2020-01-28 00:00:00,LABORABLE
28,1,2020,23,396,422,818,2020-01-28 22:00:00,2020-01-28 00:00:00,LABORABLE
28,1,2020,24,270,272,542,2020-01-28 23:00:00,2020-01-28 00:00:00,LABORABLE
29,1,2020,1,175,234,409,2020-01-29 00:00:00,2020-01-29 00:00:00,LABORABLE
29,1,2020,2,112,167,279,2020-01-29 01:00:00,2020-01-29 00:00:00,LABORABLE
29,1,2020,3,77,123,200,2020-01-29 02:00:00,2020-01-29 00:00:00,LABORABLE
29,1,2020,4,81,96,177,2020-01-29 03:00:00,2020-01-29 00:00:00,LABORABLE
29,1,2020,5,95,91,186,2020-01-29 04:00:00,2020-01-29 00:00:00,LABORABLE
29,1,2020,6,108,156,264,2020-01-29 05:00:00,2020-01-29 00:00:00,LABORABLE
29,1,2020,7,278,426,704,2020-01-29 06:00:00,2020-01-29 00:00:00,LABORABLE
29,1,2020,8,679,562,1241,2020-01-29 07:00:00,2020-01-29 00:00:00,LABORABLE
29,1,2020,9,676,682,1358,2020-01-29 08:00:00,2020-01-29 00:00:00,LABORABLE
29,1,2020,10,662,659,1321,2020-01-29 09:00:00,2020-01-29 00:00:00,LABORABLE
29,1,2020,11,551,665,1216,2020-01-29 10:00:00,2020-01-29 00:00:00,LABORABLE
29,1,2020,12,521,645,1166,2020-01-29 11:00:00,2020-01-29 00:00:00,LABORABLE
29,1,2020,13,421,843,1264,2020-01-29 12:00:00,2020-01-29 00:00:00,LABORABLE
29,1,2020,14,579,691,1270,2020-01-29 13:00:00,2020-01-29 00:00:00,LABORABLE
29,1,2020,15,623,601,1224,2020-01-29 14:00:00,2020-01-29 00:00:00,LABORABLE
29,1,2020,16,642,609,1251,2020-01-29 15:00:00,2020-01-29 00:00:00,LABORABLE
29,1,2020,17,658,732,1390,2020-01-29 16:00:00,2020-01-29 00:00:00,LABORABLE
29,1,2020,18,692,702,1394,2020-01-29 17:00:00,2020-01-29 00:00:00,LABORABLE
29,1,2020,19,694,708,1402,2020-01-29 18:00:00,2020-01-29 00:00:00,LABORABLE
29,1,2020,20,656,735,1391,2020-01-29 19:00:00,2020-01-29 00:00:00,LABORABLE
29,1,2020,21,644,710,1354,2020-01-29 20:00:00,2020-01-29 00:00:00,LABORABLE
29,1,2020,22,500,578,1078,2020-01-29 21:00:00,2020-01-29 00:00:00,LABORABLE
29,1,2020,23,398,419,817,2020-01-29 22:00:00,2020-01-29 00:00:00,LABORABLE
29,1,2020,24,262,275,537,2020-01-29 23:00:00,2020-01-29 00:00:00,LABORABLE
30,1,2020,1,203,244,447,2020-01-30 00:00:00,2020-01-30 00:00:00,LABORABLE
30,1,2020,2,112,168,280,2020-01-30 01:00:00,2020-01-30 00:00:00,LABORABLE
30,1,2020,3,86,148,234,2020-01-30 02:00:00,2020-01-30 00:00:00,LABORABLE
30,1,2020,4,80,136,216,2020-01-30 03:00:00,2020-01-30 00:00:00,LABORABLE
30,1,2020,5,93,103,196,2020-01-30 04:00:00,2020-01-30 00:00:00,LABORABLE
30,1,2020,6,118,152,270,2020-01-30 05:00:00,2020-01-30 00:00:00,LABORABLE
30,1,2020,7,295,424,719,2020-01-30 06:00:00,2020-01-30 00:00:00,LABORABLE
30,1,2020,8,670,614,1284,2020-01-30 07:00:00,2020-01-30 00:00:00,LABORABLE
30,1,2020,9,689,704,1393,2020-01-30 08:00:00,2020-01-30 00:00:00,LABORABLE
30,1,2020,10,667,719,1386,2020-01-30 09:00:00,2020-01-30 00:00:00,LABORABLE
30,1,2020,11,587,667,1254,2020-01-30 10:00:00,2020-01-30 00:00:00,LABORABLE
30,1,2020,12,422,809,1231,2020-01-30 11:00:00,2020-01-30 00:00:00,LABORABLE
30,1,2020,13,565,640,1205,2020-01-30 12:00:00,2020-01-30 00:00:00,LABORABLE
30,1,2020,14,632,751,1383,2020-01-30 13:00:00,2020-01-30 00:00:00,LABORABLE
30,1,2020,15,633,674,1307,2020-01-30 14:00:00,2020-01-30 00:00:00,LABORABLE
30,1,2020,16,627,650,1277,2020-01-30 15:00:00,2020-01-30 00:00:00,LABORABLE
30,1,2020,17,647,716,1363,2020-01-30 16:00:00,2020-01-30 00:00:00,LABORABLE
30,1,2020,18,721,745,1466,2020-01-30 17:00:00,2020-01-30 00:00:00,LABORABLE
30,1,2020,19,728,742,1470,2020-01-30 18:00:00,2020-01-30 00:00:00,LABORABLE
30,1,2020,20,623,780,1403,2020-01-30 19:00:00,2020-01-30 00:00:00,LABORABLE
30,1,2020,21,632,709,1341,2020-01-30 20:00:00,2020-01-30 00:00:00,LABORABLE
30,1,2020,22,545,607,1152,2020-01-30 21:00:00,2020-01-30 00:00:00,LABORABLE
30,1,2020,23,443,458,901,2020-01-30 22:00:00,2020-01-30 00:00:00,LABORABLE
30,1,2020,24,282,318,600,2020-01-30 23:00:00,2020-01-30 00:00:00,LABORABLE
31,1,2020,1,188,306,494,2020-01-31 00:00:00,2020-01-31 00:00:00,LABORABLE
31,1,2020,2,118,278,396,2020-01-31 01:00:00,2020-01-31 00:00:00,LABORABLE
31,1,2020,3,90,207,297,2020-01-31 02:00:00,2020-01-31 00:00:00,LABORABLE
31,1,2020,4,81,112,193,2020-01-31 03:00:00,2020-01-31 00:00:00,LABORABLE
31,1,2020,5,103,120,223,2020-01-31 04:00:00,2020-01-31 00:00:00,LABORABLE
31,1,2020,6,122,168,290,2020-01-31 05:00:00,2020-01-31 00:00:00,LABORABLE
31,1,2020,7,239,319,558,2020-01-31 06:00:00,2020-01-31 00:00:00,LABORABLE
31,1,2020,8,378,535,913,2020-01-31 07:00:00,2020-01-31 00:00:00,LABORABLE
31,1,2020,9,665,668,1333,2020-01-31 08:00:00,2020-01-31 00:00:00,LABORABLE
31,1,2020,10,645,704,1349,2020-01-31 09:00:00,2020-01-31 00:00:00,LABORABLE
31,1,2020,11,586,625,1211,2020-01-31 10:00:00,2020-01-31 00:00:00,LABORABLE
31,1,2020,12,615,700,1315,2020-01-31 11:00:00,2020-01-31 00:00:00,LABORABLE
31,1,2020,13,662,734,1396,2020-01-31 12:00:00,2020-01-31 00:00:00,LABORABLE
31,1,2020,14,655,751,1406,2020-01-31 13:00:00,2020-01-31 00:00:00,LABORABLE
31,1,2020,15,661,722,1383,2020-01-31 14:00:00,2020-01-31 00:00:00,LABORABLE
31,1,2020,16,680,729,1409,2020-01-31 15:00:00,2020-01-31 00:00:00,LABORABLE
31,1,2020,17,670,718,1388,2020-01-31 16:00:00,2020-01-31 00:00:00,LABORABLE
31,1,2020,18,689,767,1456,2020-01-31 17:00:00,2020-01-31 00:00:00,LABORABLE
31,1,2020,19,698,822,1520,2020-01-31 18:00:00,2020-01-31 00:00:00,LABORABLE
31,1,2020,20,686,777,1463,2020-01-31 19:00:00,2020-01-31 00:00:00,LABORABLE
31,1,2020,21,666,782,1448,2020-01-31 20:00:00,2020-01-31 00:00:00,LABORABLE
31,1,2020,22,687,693,1380,2020-01-31 21:00:00,2020-01-31 00:00:00,LABORABLE
31,1,2020,23,554,594,1148,2020-01-31 22:00:00,2020-01-31 00:00:00,LABORABLE
31,1,2020,24,412,502,914,2020-01-31 23:00:00,2020-01-31 00:00:00,LABORABLE
1,2,2020,1,357,415,772,2020-02-01 00:00:00,2020-01-02 00:00:00,LABORABLE
1,2,2020,2,267,374,641,2020-02-01 01:00:00,2020-01-02 00:00:00,LABORABLE
1,2,2020,3,172,329,501,2020-02-01 02:00:00,2020-01-02 00:00:00,LABORABLE
1,2,2020,4,168,244,412,2020-02-01 03:00:00,2020-01-02 00:00:00,LABORABLE
1,2,2020,5,149,231,380,2020-02-01 04:00:00,2020-01-02 00:00:00,LABORABLE
1,2,2020,6,156,215,371,2020-02-01 05:00:00,2020-01-02 00:00:00,LABORABLE
1,2,2020,7,221,252,473,2020-02-01 06:00:00,2020-01-02 00:00:00,LABORABLE
1,2,2020,8,306,319,625,2020-02-01 07:00:00,2020-01-02 00:00:00,LABORABLE
1,2,2020,9,337,385,722,2020-02-01 08:00:00,2020-01-02 00:00:00,LABORABLE
1,2,2020,10,471,520,991,2020-02-01 09:00:00,2020-01-02 00:00:00,LABORABLE
1,2,2020,11,568,643,1211,2020-02-01 10:00:00,2020-01-02 00:00:00,LABORABLE
1,2,2020,12,612,692,1304,2020-02-01 11:00:00,2020-01-02 00:00:00,LABORABLE
1,2,2020,13,655,753,1408,2020-02-01 12:00:00,2020-01-02 00:00:00,LABORABLE
1,2,2020,14,744,764,1508,2020-02-01 13:00:00,2020-01-02 00:00:00,LABORABLE
1,2,2020,15,682,746,1428,2020-02-01 14:00:00,2020-01-02 00:00:00,LABORABLE
1,2,2020,16,558,704,1262,2020-02-01 15:00:00,2020-01-02 00:00:00,LABORABLE
1,2,2020,17,525,645,1170,2020-02-01 16:00:00,2020-01-02 00:00:00,LABORABLE
1,2,2020,18,526,667,1193,2020-02-01 17:00:00,2020-01-02 00:00:00,LABORABLE
1,2,2020,19,705,710,1415,2020-02-01 18:00:00,2020-01-02 00:00:00,LABORABLE
1,2,2020,20,689,761,1450,2020-02-01 19:00:00,2020-01-02 00:00:00,LABORABLE
1,2,2020,21,632,684,1316,2020-02-01 20:00:00,2020-01-02 00:00:00,LABORABLE
1,2,2020,22,537,646,1183,2020-02-01 21:00:00,2020-01-02 00:00:00,LABORABLE
1,2,2020,23,491,562,1053,2020-02-01 22:00:00,2020-01-02 00:00:00,LABORABLE
1,2,2020,24,391,469,860,2020-02-01 23:00:00,2020-01-02 00:00:00,LABORABLE
2,2,2020,1,396,449,845,2020-02-02 00:00:00,2020-02-02 00:00:00,LABORABLE
2,2,2020,2,320,421,741,2020-02-02 01:00:00,2020-02-02 00:00:00,LABORABLE
2,2,2020,3,249,343,592,2020-02-02 02:00:00,2020-02-02 00:00:00,LABORABLE
2,2,2020,4,173,291,464,2020-02-02 03:00:00,2020-02-02 00:00:00,LABORABLE
2,2,2020,5,146,283,429,2020-02-02 04:00:00,2020-02-02 00:00:00,LABORABLE
2,2,2020,6,146,266,412,2020-02-02 05:00:00,2020-02-02 00:00:00,LABORABLE
2,2,2020,7,182,287,469,2020-02-02 06:00:00,2020-02-02 00:00:00,LABORABLE
2,2,2020,8,184,222,406,2020-02-02 07:00:00,2020-02-02 00:00:00,LABORABLE
2,2,2020,9,199,269,468,2020-02-02 08:00:00,2020-02-02 00:00:00,LABORABLE
2,2,2020,10,341,381,722,2020-02-02 09:00:00,2020-02-02 00:00:00,LABORABLE
2,2,2020,11,460,433,893,2020-02-02 10:00:00,2020-02-02 00:00:00,LABORABLE
2,2,2020,12,473,530,1003,2020-02-02 11:00:00,2020-02-02 00:00:00,LABORABLE
2,2,2020,13,559,617,1176,2020-02-02 12:00:00,2020-02-02 00:00:00,LABORABLE
2,2,2020,14,615,621,1236,2020-02-02 13:00:00,2020-02-02 00:00:00,LABORABLE
2,2,2020,15,594,660,1254,2020-02-02 14:00:00,2020-02-02 00:00:00,LABORABLE
2,2,2020,16,511,616,1127,2020-02-02 15:00:00,2020-02-02 00:00:00,LABORABLE
2,2,2020,17,518,647,1165,2020-02-02 16:00:00,2020-02-02 00:00:00,LABORABLE
2,2,2020,18,568,730,1298,2020-02-02 17:00:00,2020-02-02 00:00:00,LABORABLE
2,2,2020,19,586,701,1287,2020-02-02 18:00:00,2020-02-02 00:00:00,LABORABLE
2,2,2020,20,566,697,1263,2020-02-02 19:00:00,2020-02-02 00:00:00,LABORABLE
2,2,2020,21,524,624,1148,2020-02-02 20:00:00,2020-02-02 00:00:00,LABORABLE
2,2,2020,22,484,563,1047,2020-02-02 21:00:00,2020-02-02 00:00:00,LABORABLE
2,2,2020,23,396,402,798,2020-02-02 22:00:00,2020-02-02 00:00:00,LABORABLE
2,2,2020,24,253,343,596,2020-02-02 23:00:00,2020-02-02 00:00:00,LABORABLE
3,2,2020,1,172,241,413,2020-02-03 00:00:00,2020-03-02 00:00:00,LABORABLE
3,2,2020,2,154,197,351,2020-02-03 01:00:00,2020-03-02 00:00:00,LABORABLE
3,2,2020,3,95,149,244,2020-02-03 02:00:00,2020-03-02 00:00:00,LABORABLE
3,2,2020,4,74,117,191,2020-02-03 03:00:00,2020-03-02 00:00:00,LABORABLE
3,2,2020,5,96,124,220,2020-02-03 04:00:00,2020-03-02 00:00:00,LABORABLE
3,2,2020,6,201,181,382,2020-02-03 05:00:00,2020-03-02 00:00:00,LABORABLE
3,2,2020,7,466,432,898,2020-02-03 06:00:00,2020-03-02 00:00:00,LABORABLE
3,2,2020,8,653,570,1223,2020-02-03 07:00:00,2020-03-02 00:00:00,LABORABLE
3,2,2020,9,716,672,1388,2020-02-03 08:00:00,2020-03-02 00:00:00,LABORABLE
3,2,2020,10,636,636,1272,2020-02-03 09:00:00,2020-03-02 00:00:00,LABORABLE
3,2,2020,11,578,624,1202,2020-02-03 10:00:00,2020-03-02 00:00:00,LABORABLE
3,2,2020,12,551,687,1238,2020-02-03 11:00:00,2020-03-02 00:00:00,LABORABLE
3,2,2020,13,581,758,1339,2020-02-03 12:00:00,2020-03-02 00:00:00,LABORABLE
3,2,2020,14,594,700,1294,2020-02-03 13:00:00,2020-03-02 00:00:00,LABORABLE
3,2,2020,15,662,683,1345,2020-02-03 14:00:00,2020-03-02 00:00:00,LABORABLE
3,2,2020,16,628,651,1279,2020-02-03 15:00:00,2020-03-02 00:00:00,LABORABLE
3,2,2020,17,669,747,1416,2020-02-03 16:00:00,2020-03-02 00:00:00,LABORABLE
3,2,2020,18,635,722,1357,2020-02-03 17:00:00,2020-03-02 00:00:00,LABORABLE
3,2,2020,19,643,753,1396,2020-02-03 18:00:00,2020-03-02 00:00:00,LABORABLE
3,2,2020,20,604,657,1261,2020-02-03 19:00:00,2020-03-02 00:00:00,LABORABLE
3,2,2020,21,605,726,1331,2020-02-03 20:00:00,2020-03-02 00:00:00,LABORABLE
3,2,2020,22,532,588,1120,2020-02-03 21:00:00,2020-03-02 00:00:00,LABORABLE
3,2,2020,23,377,402,779,2020-02-03 22:00:00,2020-03-02 00:00:00,LABORABLE
3,2,2020,24,220,300,520,2020-02-03 23:00:00,2020-03-02 00:00:00,LABORABLE
4,2,2020,1,167,203,370,2020-02-04 00:00:00,2020-04-02 00:00:00,LABORABLE
4,2,2020,2,90,134,224,2020-02-04 01:00:00,2020-04-02 00:00:00,LABORABLE
4,2,2020,3,66,123,189,2020-02-04 02:00:00,2020-04-02 00:00:00,LABORABLE
4,2,2020,4,50,94,144,2020-02-04 03:00:00,2020-04-02 00:00:00,LABORABLE
4,2,2020,5,100,99,199,2020-02-04 04:00:00,2020-04-02 00:00:00,LABORABLE
4,2,2020,6,179,153,332,2020-02-04 05:00:00,2020-04-02 00:00:00,LABORABLE
4,2,2020,7,445,405,850,2020-02-04 06:00:00,2020-04-02 00:00:00,LABORABLE
4,2,2020,8,647,587,1234,2020-02-04 07:00:00,2020-04-02 00:00:00,LABORABLE
4,2,2020,9,701,638,1339,2020-02-04 08:00:00,2020-04-02 00:00:00,LABORABLE
4,2,2020,10,613,670,1283,2020-02-04 09:00:00,2020-04-02 00:00:00,LABORABLE
4,2,2020,11,519,660,1179,2020-02-04 10:00:00,2020-04-02 00:00:00,LABORABLE
4,2,2020,12,605,694,1299,2020-02-04 11:00:00,2020-04-02 00:00:00,LABORABLE
4,2,2020,13,607,699,1306,2020-02-04 12:00:00,2020-04-02 00:00:00,LABORABLE
4,2,2020,14,513,639,1152,2020-02-04 13:00:00,2020-04-02 00:00:00,LABORABLE
4,2,2020,15,625,692,1317,2020-02-04 14:00:00,2020-04-02 00:00:00,LABORABLE
4,2,2020,16,648,645,1293,2020-02-04 15:00:00,2020-04-02 00:00:00,LABORABLE
4,2,2020,17,640,729,1369,2020-02-04 16:00:00,2020-04-02 00:00:00,LABORABLE
4,2,2020,18,686,736,1422,2020-02-04 17:00:00,2020-04-02 00:00:00,LABORABLE
4,2,2020,19,666,756,1422,2020-02-04 18:00:00,2020-04-02 00:00:00,LABORABLE
4,2,2020,20,631,763,1394,2020-02-04 19:00:00,2020-04-02 00:00:00,LABORABLE
4,2,2020,21,603,721,1324,2020-02-04 20:00:00,2020-04-02 00:00:00,LABORABLE
4,2,2020,22,522,585,1107,2020-02-04 21:00:00,2020-04-02 00:00:00,LABORABLE
4,2,2020,23,408,422,830,2020-02-04 22:00:00,2020-04-02 00:00:00,LABORABLE
4,2,2020,24,224,289,513,2020-02-04 23:00:00,2020-04-02 00:00:00,LABORABLE
5,2,2020,1,193,221,414,2020-02-05 00:00:00,2020-05-02 00:00:00,LABORABLE
5,2,2020,2,126,150,276,2020-02-05 01:00:00,2020-05-02 00:00:00,LABORABLE
5,2,2020,3,87,135,222,2020-02-05 02:00:00,2020-05-02 00:00:00,LABORABLE
5,2,2020,4,62,112,174,2020-02-05 03:00:00,2020-05-02 00:00:00,LABORABLE
5,2,2020,5,102,104,206,2020-02-05 04:00:00,2020-05-02 00:00:00,LABORABLE
5,2,2020,6,185,162,347,2020-02-05 05:00:00,2020-05-02 00:00:00,LABORABLE
5,2,2020,7,423,403,826,2020-02-05 06:00:00,2020-05-02 00:00:00,LABORABLE
5,2,2020,8,666,596,1262,2020-02-05 07:00:00,2020-05-02 00:00:00,LABORABLE
5,2,2020,9,727,664,1391,2020-02-05 08:00:00,2020-05-02 00:00:00,LABORABLE
5,2,2020,10,640,701,1341,2020-02-05 09:00:00,2020-05-02 00:00:00,LABORABLE
5,2,2020,11,498,630,1128,2020-02-05 10:00:00,2020-05-02 00:00:00,LABORABLE
5,2,2020,12,408,621,1029,2020-02-05 11:00:00,2020-05-02 00:00:00,LABORABLE
5,2,2020,13,617,714,1331,2020-02-05 12:00:00,2020-05-02 00:00:00,LABORABLE
5,2,2020,14,602,724,1326,2020-02-05 13:00:00,2020-05-02 00:00:00,LABORABLE
5,2,2020,15,641,664,1305,2020-02-05 14:00:00,2020-05-02 00:00:00,LABORABLE
5,2,2020,16,616,672,1288,2020-02-05 15:00:00,2020-05-02 00:00:00,LABORABLE
5,2,2020,17,673,662,1335,2020-02-05 16:00:00,2020-05-02 00:00:00,LABORABLE
5,2,2020,18,698,729,1427,2020-02-05 17:00:00,2020-05-02 00:00:00,LABORABLE
5,2,2020,19,703,670,1373,2020-02-05 18:00:00,2020-05-02 00:00:00,LABORABLE
5,2,2020,20,639,804,1443,2020-02-05 19:00:00,2020-05-02 00:00:00,LABORABLE
5,2,2020,21,664,724,1388,2020-02-05 20:00:00,2020-05-02 00:00:00,LABORABLE
5,2,2020,22,527,580,1107,2020-02-05 21:00:00,2020-05-02 00:00:00,LABORABLE
5,2,2020,23,373,435,808,2020-02-05 22:00:00,2020-05-02 00:00:00,LABORABLE
5,2,2020,24,352,284,636,2020-02-05 23:00:00,2020-05-02 00:00:00,LABORABLE
6,2,2020,1,178,263,441,2020-02-06 00:00:00,2020-06-02 00:00:00,LABORABLE
6,2,2020,2,141,182,323,2020-02-06 01:00:00,2020-06-02 00:00:00,LABORABLE
6,2,2020,3,74,127,201,2020-02-06 02:00:00,2020-06-02 00:00:00,LABORABLE
6,2,2020,4,85,109,194,2020-02-06 03:00:00,2020-06-02 00:00:00,LABORABLE
6,2,2020,5,101,119,220,2020-02-06 04:00:00,2020-06-02 00:00:00,LABORABLE
6,2,2020,6,170,140,310,2020-02-06 05:00:00,2020-06-02 00:00:00,LABORABLE
6,2,2020,7,447,422,869,2020-02-06 06:00:00,2020-06-02 00:00:00,LABORABLE
6,2,2020,8,648,617,1265,2020-02-06 07:00:00,2020-06-02 00:00:00,LABORABLE
6,2,2020,9,710,682,1392,2020-02-06 08:00:00,2020-06-02 00:00:00,LABORABLE
6,2,2020,10,656,703,1359,2020-02-06 09:00:00,2020-06-02 00:00:00,LABORABLE
6,2,2020,11,594,641,1235,2020-02-06 10:00:00,2020-06-02 00:00:00,LABORABLE
6,2,2020,12,587,723,1310,2020-02-06 11:00:00,2020-06-02 00:00:00,LABORABLE
6,2,2020,13,613,711,1324,2020-02-06 12:00:00,2020-06-02 00:00:00,LABORABLE
6,2,2020,14,656,709,1365,2020-02-06 13:00:00,2020-06-02 00:00:00,LABORABLE
6,2,2020,15,584,719,1303,2020-02-06 14:00:00,2020-06-02 00:00:00,LABORABLE
6,2,2020,16,650,657,1307,2020-02-06 15:00:00,2020-06-02 00:00:00,LABORABLE
6,2,2020,17,652,738,1390,2020-02-06 16:00:00,2020-06-02 00:00:00,LABORABLE
6,2,2020,18,633,780,1413,2020-02-06 17:00:00,2020-06-02 00:00:00,LABORABLE
6,2,2020,19,694,805,1499,2020-02-06 18:00:00,2020-06-02 00:00:00,LABORABLE
6,2,2020,20,652,731,1383,2020-02-06 19:00:00,2020-06-02 00:00:00,LABORABLE
6,2,2020,21,637,695,1332,2020-02-06 20:00:00,2020-06-02 00:00:00,LABORABLE
6,2,2020,22,581,586,1167,2020-02-06 21:00:00,2020-06-02 00:00:00,LABORABLE
6,2,2020,23,412,460,872,2020-02-06 22:00:00,2020-06-02 00:00:00,LABORABLE
6,2,2020,24,276,325,601,2020-02-06 23:00:00,2020-06-02 00:00:00,LABORABLE
7,2,2020,1,204,268,472,2020-02-07 00:00:00,2020-07-02 00:00:00,LABORABLE
7,2,2020,2,126,168,294,2020-02-07 01:00:00,2020-07-02 00:00:00,LABORABLE
7,2,2020,3,93,167,260,2020-02-07 02:00:00,2020-07-02 00:00:00,LABORABLE
7,2,2020,4,84,140,224,2020-02-07 03:00:00,2020-07-02 00:00:00,LABORABLE
7,2,2020,5,108,133,241,2020-02-07 04:00:00,2020-07-02 00:00:00,LABORABLE
7,2,2020,6,190,158,348,2020-02-07 05:00:00,2020-07-02 00:00:00,LABORABLE
7,2,2020,7,435,417,852,2020-02-07 06:00:00,2020-07-02 00:00:00,LABORABLE
7,2,2020,8,661,590,1251,2020-02-07 07:00:00,2020-07-02 00:00:00,LABORABLE
7,2,2020,9,704,666,1370,2020-02-07 08:00:00,2020-07-02 00:00:00,LABORABLE
7,2,2020,10,648,717,1365,2020-02-07 09:00:00,2020-07-02 00:00:00,LABORABLE
7,2,2020,11,581,665,1246,2020-02-07 10:00:00,2020-07-02 00:00:00,LABORABLE
7,2,2020,12,598,657,1255,2020-02-07 11:00:00,2020-07-02 00:00:00,LABORABLE
7,2,2020,13,628,709,1337,2020-02-07 12:00:00,2020-07-02 00:00:00,LABORABLE
7,2,2020,14,656,699,1355,2020-02-07 13:00:00,2020-07-02 00:00:00,LABORABLE
7,2,2020,15,656,720,1376,2020-02-07 14:00:00,2020-07-02 00:00:00,LABORABLE
7,2,2020,16,659,710,1369,2020-02-07 15:00:00,2020-07-02 00:00:00,LABORABLE
7,2,2020,17,629,669,1298,2020-02-07 16:00:00,2020-07-02 00:00:00,LABORABLE
7,2,2020,18,727,740,1467,2020-02-07 17:00:00,2020-07-02 00:00:00,LABORABLE
7,2,2020,19,670,779,1449,2020-02-07 18:00:00,2020-07-02 00:00:00,LABORABLE
7,2,2020,20,674,787,1461,2020-02-07 19:00:00,2020-07-02 00:00:00,LABORABLE
7,2,2020,21,679,806,1485,2020-02-07 20:00:00,2020-07-02 00:00:00,LABORABLE
7,2,2020,22,672,661,1333,2020-02-07 21:00:00,2020-07-02 00:00:00,LABORABLE
7,2,2020,23,500,534,1034,2020-02-07 22:00:00,2020-07-02 00:00:00,LABORABLE
7,2,2020,24,387,511,898,2020-02-07 23:00:00,2020-07-02 00:00:00,LABORABLE
8,2,2020,1,342,330,672,2020-02-08 00:00:00,2020-08-02 00:00:00,LABORABLE
8,2,2020,2,236,335,571,2020-02-08 01:00:00,2020-08-02 00:00:00,LABORABLE
8,2,2020,3,179,291,470,2020-02-08 02:00:00,2020-08-02 00:00:00,LABORABLE
8,2,2020,4,150,228,378,2020-02-08 03:00:00,2020-08-02 00:00:00,LABORABLE
8,2,2020,5,135,200,335,2020-02-08 04:00:00,2020-08-02 00:00:00,LABORABLE
8,2,2020,6,156,230,386,2020-02-08 05:00:00,2020-08-02 00:00:00,LABORABLE
8,2,2020,7,236,275,511,2020-02-08 06:00:00,2020-08-02 00:00:00,LABORABLE
8,2,2020,8,297,296,593,2020-02-08 07:00:00,2020-08-02 00:00:00,LABORABLE
8,2,2020,9,358,385,743,2020-02-08 08:00:00,2020-08-02 00:00:00,LABORABLE
8,2,2020,10,481,493,974,2020-02-08 09:00:00,2020-08-02 00:00:00,LABORABLE
8,2,2020,11,522,562,1084,2020-02-08 10:00:00,2020-08-02 00:00:00,LABORABLE
8,2,2020,12,632,678,1310,2020-02-08 11:00:00,2020-08-02 00:00:00,LABORABLE
8,2,2020,13,662,693,1355,2020-02-08 12:00:00,2020-08-02 00:00:00,LABORABLE
8,2,2020,14,699,750,1449,2020-02-08 13:00:00,2020-08-02 00:00:00,LABORABLE
8,2,2020,15,593,750,1343,2020-02-08 14:00:00,2020-08-02 00:00:00,LABORABLE
8,2,2020,16,530,679,1209,2020-02-08 15:00:00,2020-08-02 00:00:00,LABORABLE
8,2,2020,17,557,667,1224,2020-02-08 16:00:00,2020-08-02 00:00:00,LABORABLE
8,2,2020,18,557,669,1226,2020-02-08 17:00:00,2020-08-02 00:00:00,LABORABLE
8,2,2020,19,693,689,1382,2020-02-08 18:00:00,2020-08-02 00:00:00,LABORABLE
8,2,2020,20,630,714,1344,2020-02-08 19:00:00,2020-08-02 00:00:00,LABORABLE
8,2,2020,21,582,676,1258,2020-02-08 20:00:00,2020-08-02 00:00:00,LABORABLE
8,2,2020,22,561,642,1203,2020-02-08 21:00:00,2020-08-02 00:00:00,LABORABLE
8,2,2020,23,515,544,1059,2020-02-08 22:00:00,2020-08-02 00:00:00,LABORABLE
8,2,2020,24,440,445,885,2020-02-08 23:00:00,2020-08-02 00:00:00,LABORABLE
9,2,2020,1,358,470,828,2020-02-09 00:00:00,2020-09-02 00:00:00,LABORABLE
9,2,2020,2,322,400,722,2020-02-09 01:00:00,2020-09-02 00:00:00,LABORABLE
9,2,2020,3,250,317,567,2020-02-09 02:00:00,2020-09-02 00:00:00,LABORABLE
9,2,2020,4,194,300,494,2020-02-09 03:00:00,2020-09-02 00:00:00,LABORABLE
9,2,2020,5,151,261,412,2020-02-09 04:00:00,2020-09-02 00:00:00,LABORABLE
9,2,2020,6,173,246,419,2020-02-09 05:00:00,2020-09-02 00:00:00,LABORABLE
9,2,2020,7,201,186,387,2020-02-09 06:00:00,2020-09-02 00:00:00,LABORABLE
9,2,2020,8,184,117,301,2020-02-09 07:00:00,2020-09-02 00:00:00,LABORABLE
9,2,2020,9,210,205,415,2020-02-09 08:00:00,2020-09-02 00:00:00,LABORABLE
9,2,2020,10,337,381,718,2020-02-09 09:00:00,2020-09-02 00:00:00,LABORABLE
9,2,2020,11,393,423,816,2020-02-09 10:00:00,2020-09-02 00:00:00,LABORABLE
9,2,2020,12,515,588,1103,2020-02-09 11:00:00,2020-09-02 00:00:00,LABORABLE
9,2,2020,13,547,555,1102,2020-02-09 12:00:00,2020-09-02 00:00:00,LABORABLE
9,2,2020,14,562,655,1217,2020-02-09 13:00:00,2020-09-02 00:00:00,LABORABLE
9,2,2020,15,590,714,1304,2020-02-09 14:00:00,2020-09-02 00:00:00,LABORABLE
9,2,2020,16,474,608,1082,2020-02-09 15:00:00,2020-09-02 00:00:00,LABORABLE
9,2,2020,17,471,633,1104,2020-02-09 16:00:00,2020-09-02 00:00:00,LABORABLE
9,2,2020,18,550,621,1171,2020-02-09 17:00:00,2020-09-02 00:00:00,LABORABLE
9,2,2020,19,620,652,1272,2020-02-09 18:00:00,2020-09-02 00:00:00,LABORABLE
9,2,2020,20,561,686,1247,2020-02-09 19:00:00,2020-09-02 00:00:00,LABORABLE
9,2,2020,21,514,636,1150,2020-02-09 20:00:00,2020-09-02 00:00:00,LABORABLE
9,2,2020,22,487,506,993,2020-02-09 21:00:00,2020-09-02 00:00:00,LABORABLE
9,2,2020,23,378,435,813,2020-02-09 22:00:00,2020-09-02 00:00:00,LABORABLE
9,2,2020,24,255,294,549,2020-02-09 23:00:00,2020-09-02 00:00:00,LABORABLE
10,2,2020,1,198,247,445,2020-02-10 00:00:00,2020-10-02 00:00:00,LABORABLE
10,2,2020,2,103,201,304,2020-02-10 01:00:00,2020-10-02 00:00:00,LABORABLE
10,2,2020,3,100,168,268,2020-02-10 02:00:00,2020-10-02 00:00:00,LABORABLE
10,2,2020,4,77,136,213,2020-02-10 03:00:00,2020-10-02 00:00:00,LABORABLE
10,2,2020,5,104,120,224,2020-02-10 04:00:00,2020-10-02 00:00:00,LABORABLE
10,2,2020,6,182,188,370,2020-02-10 05:00:00,2020-10-02 00:00:00,LABORABLE
10,2,2020,7,452,461,913,2020-02-10 06:00:00,2020-10-02 00:00:00,LABORABLE
10,2,2020,8,663,582,1245,2020-02-10 07:00:00,2020-10-02 00:00:00,LABORABLE
10,2,2020,9,703,677,1380,2020-02-10 08:00:00,2020-10-02 00:00:00,LABORABLE
10,2,2020,10,645,706,1351,2020-02-10 09:00:00,2020-10-02 00:00:00,LABORABLE
10,2,2020,11,526,635,1161,2020-02-10 10:00:00,2020-10-02 00:00:00,LABORABLE
10,2,2020,12,597,706,1303,2020-02-10 11:00:00,2020-10-02 00:00:00,LABORABLE
10,2,2020,13,611,688,1299,2020-02-10 12:00:00,2020-10-02 00:00:00,LABORABLE
10,2,2020,14,629,768,1397,2020-02-10 13:00:00,2020-10-02 00:00:00,LABORABLE
10,2,2020,15,640,736,1376,2020-02-10 14:00:00,2020-10-02 00:00:00,LABORABLE
10,2,2020,16,704,663,1367,2020-02-10 15:00:00,2020-10-02 00:00:00,LABORABLE
10,2,2020,17,616,673,1289,2020-02-10 16:00:00,2020-10-02 00:00:00,LABORABLE
10,2,2020,18,688,684,1372,2020-02-10 17:00:00,2020-10-02 00:00:00,LABORABLE
10,2,2020,19,680,701,1381,2020-02-10 18:00:00,2020-10-02 00:00:00,LABORABLE
10,2,2020,20,636,759,1395,2020-02-10 19:00:00,2020-10-02 00:00:00,LABORABLE
10,2,2020,21,621,714,1335,2020-02-10 20:00:00,2020-10-02 00:00:00,LABORABLE
10,2,2020,22,485,514,999,2020-02-10 21:00:00,2020-10-02 00:00:00,LABORABLE
10,2,2020,23,382,383,765,2020-02-10 22:00:00,2020-10-02 00:00:00,LABORABLE
10,2,2020,24,220,279,499,2020-02-10 23:00:00,2020-10-02 00:00:00,LABORABLE
11,2,2020,1,152,244,396,2020-02-11 00:00:00,2020-11-02 00:00:00,LABORABLE
11,2,2020,2,105,140,245,2020-02-11 01:00:00,2020-11-02 00:00:00,LABORABLE
11,2,2020,3,68,115,183,2020-02-11 02:00:00,2020-11-02 00:00:00,LABORABLE
11,2,2020,4,76,95,171,2020-02-11 03:00:00,2020-11-02 00:00:00,LABORABLE
11,2,2020,5,92,88,180,2020-02-11 04:00:00,2020-11-02 00:00:00,LABORABLE
11,2,2020,6,178,165,343,2020-02-11 05:00:00,2020-11-02 00:00:00,LABORABLE
11,2,2020,7,414,409,823,2020-02-11 06:00:00,2020-11-02 00:00:00,LABORABLE
11,2,2020,8,637,615,1252,2020-02-11 07:00:00,2020-11-02 00:00:00,LABORABLE
11,2,2020,9,710,723,1433,2020-02-11 08:00:00,2020-11-02 00:00:00,LABORABLE
11,2,2020,10,635,685,1320,2020-02-11 09:00:00,2020-11-02 00:00:00,LABORABLE
11,2,2020,11,551,651,1202,2020-02-11 10:00:00,2020-11-02 00:00:00,LABORABLE
11,2,2020,12,553,683,1236,2020-02-11 11:00:00,2020-11-02 00:00:00,LABORABLE
11,2,2020,13,541,721,1262,2020-02-11 12:00:00,2020-11-02 00:00:00,LABORABLE
11,2,2020,14,676,704,1380,2020-02-11 13:00:00,2020-11-02 00:00:00,LABORABLE
11,2,2020,15,621,711,1332,2020-02-11 14:00:00,2020-11-02 00:00:00,LABORABLE
11,2,2020,16,640,626,1266,2020-02-11 15:00:00,2020-11-02 00:00:00,LABORABLE
11,2,2020,17,630,714,1344,2020-02-11 16:00:00,2020-11-02 00:00:00,LABORABLE
11,2,2020,18,673,746,1419,2020-02-11 17:00:00,2020-11-02 00:00:00,LABORABLE
11,2,2020,19,673,743,1416,2020-02-11 18:00:00,2020-11-02 00:00:00,LABORABLE
11,2,2020,20,648,752,1400,2020-02-11 19:00:00,2020-11-02 00:00:00,LABORABLE
11,2,2020,21,590,665,1255,2020-02-11 20:00:00,2020-11-02 00:00:00,LABORABLE
11,2,2020,22,457,547,1004,2020-02-11 21:00:00,2020-11-02 00:00:00,LABORABLE
11,2,2020,23,385,420,805,2020-02-11 22:00:00,2020-11-02 00:00:00,LABORABLE
11,2,2020,24,259,275,534,2020-02-11 23:00:00,2020-11-02 00:00:00,LABORABLE
12,2,2020,1,174,235,409,2020-02-12 00:00:00,2020-12-02 00:00:00,LABORABLE
12,2,2020,2,118,144,262,2020-02-12 01:00:00,2020-12-02 00:00:00,LABORABLE
12,2,2020,3,71,113,184,2020-02-12 02:00:00,2020-12-02 00:00:00,LABORABLE
12,2,2020,4,76,88,164,2020-02-12 03:00:00,2020-12-02 00:00:00,LABORABLE
12,2,2020,5,94,87,181,2020-02-12 04:00:00,2020-12-02 00:00:00,LABORABLE
12,2,2020,6,175,150,325,2020-02-12 05:00:00,2020-12-02 00:00:00,LABORABLE
12,2,2020,7,419,416,835,2020-02-12 06:00:00,2020-12-02 00:00:00,LABORABLE
12,2,2020,8,638,596,1234,2020-02-12 07:00:00,2020-12-02 00:00:00,LABORABLE
12,2,2020,9,724,691,1415,2020-02-12 08:00:00,2020-12-02 00:00:00,LABORABLE
12,2,2020,10,625,712,1337,2020-02-12 09:00:00,2020-12-02 00:00:00,LABORABLE
12,2,2020,11,521,615,1136,2020-02-12 10:00:00,2020-12-02 00:00:00,LABORABLE
12,2,2020,12,590,646,1236,2020-02-12 11:00:00,2020-12-02 00:00:00,LABORABLE
12,2,2020,13,617,723,1340,2020-02-12 12:00:00,2020-12-02 00:00:00,LABORABLE
12,2,2020,14,475,669,1144,2020-02-12 13:00:00,2020-12-02 00:00:00,LABORABLE
12,2,2020,15,624,649,1273,2020-02-12 14:00:00,2020-12-02 00:00:00,LABORABLE
12,2,2020,16,618,659,1277,2020-02-12 15:00:00,2020-12-02 00:00:00,LABORABLE
12,2,2020,17,613,689,1302,2020-02-12 16:00:00,2020-12-02 00:00:00,LABORABLE
12,2,2020,18,692,737,1429,2020-02-12 17:00:00,2020-12-02 00:00:00,LABORABLE
12,2,2020,19,672,735,1407,2020-02-12 18:00:00,2020-12-02 00:00:00,LABORABLE
12,2,2020,20,628,714,1342,2020-02-12 19:00:00,2020-12-02 00:00:00,LABORABLE
12,2,2020,21,609,699,1308,2020-02-12 20:00:00,2020-12-02 00:00:00,LABORABLE
12,2,2020,22,483,584,1067,2020-02-12 21:00:00,2020-12-02 00:00:00,LABORABLE
12,2,2020,23,402,431,833,2020-02-12 22:00:00,2020-12-02 00:00:00,LABORABLE
12,2,2020,24,267,307,574,2020-02-12 23:00:00,2020-12-02 00:00:00,LABORABLE
13,2,2020,1,189,247,436,2020-02-13 00:00:00,2020-02-13 00:00:00,LABORABLE
13,2,2020,2,137,153,290,2020-02-13 01:00:00,2020-02-13 00:00:00,LABORABLE
13,2,2020,3,89,172,261,2020-02-13 02:00:00,2020-02-13 00:00:00,LABORABLE
13,2,2020,4,89,117,206,2020-02-13 03:00:00,2020-02-13 00:00:00,LABORABLE
13,2,2020,5,97,100,197,2020-02-13 04:00:00,2020-02-13 00:00:00,LABORABLE
13,2,2020,6,176,172,348,2020-02-13 05:00:00,2020-02-13 00:00:00,LABORABLE
13,2,2020,7,430,417,847,2020-02-13 06:00:00,2020-02-13 00:00:00,LABORABLE
13,2,2020,8,666,592,1258,2020-02-13 07:00:00,2020-02-13 00:00:00,LABORABLE
13,2,2020,9,722,718,1440,2020-02-13 08:00:00,2020-02-13 00:00:00,LABORABLE
13,2,2020,10,659,637,1296,2020-02-13 09:00:00,2020-02-13 00:00:00,LABORABLE
13,2,2020,11,604,684,1288,2020-02-13 10:00:00,2020-02-13 00:00:00,LABORABLE
13,2,2020,12,633,693,1326,2020-02-13 11:00:00,2020-02-13 00:00:00,LABORABLE
13,2,2020,13,632,693,1325,2020-02-13 12:00:00,2020-02-13 00:00:00,LABORABLE
13,2,2020,14,696,686,1382,2020-02-13 13:00:00,2020-02-13 00:00:00,LABORABLE
13,2,2020,15,637,697,1334,2020-02-13 14:00:00,2020-02-13 00:00:00,LABORABLE
13,2,2020,16,666,675,1341,2020-02-13 15:00:00,2020-02-13 00:00:00,LABORABLE
13,2,2020,17,672,691,1363,2020-02-13 16:00:00,2020-02-13 00:00:00,LABORABLE
13,2,2020,18,629,751,1380,2020-02-13 17:00:00,2020-02-13 00:00:00,LABORABLE
13,2,2020,19,709,772,1481,2020-02-13 18:00:00,2020-02-13 00:00:00,LABORABLE
13,2,2020,20,698,743,1441,2020-02-13 19:00:00,2020-02-13 00:00:00,LABORABLE
13,2,2020,21,620,727,1347,2020-02-13 20:00:00,2020-02-13 00:00:00,LABORABLE
13,2,2020,22,579,647,1226,2020-02-13 21:00:00,2020-02-13 00:00:00,LABORABLE
13,2,2020,23,433,463,896,2020-02-13 22:00:00,2020-02-13 00:00:00,LABORABLE
13,2,2020,24,311,363,674,2020-02-13 23:00:00,2020-02-13 00:00:00,LABORABLE
14,2,2020,1,201,301,502,2020-02-14 00:00:00,2020-02-14 00:00:00,LABORABLE
14,2,2020,2,141,193,334,2020-02-14 01:00:00,2020-02-14 00:00:00,LABORABLE
14,2,2020,3,95,177,272,2020-02-14 02:00:00,2020-02-14 00:00:00,LABORABLE
14,2,2020,4,93,165,258,2020-02-14 03:00:00,2020-02-14 00:00:00,LABORABLE
14,2,2020,5,105,128,233,2020-02-14 04:00:00,2020-02-14 00:00:00,LABORABLE
14,2,2020,6,202,187,389,2020-02-14 05:00:00,2020-02-14 00:00:00,LABORABLE
14,2,2020,7,460,448,908,2020-02-14 06:00:00,2020-02-14 00:00:00,LABORABLE
14,2,2020,8,653,603,1256,2020-02-14 07:00:00,2020-02-14 00:00:00,LABORABLE
14,2,2020,9,690,688,1378,2020-02-14 08:00:00,2020-02-14 00:00:00,LABORABLE
14,2,2020,10,633,690,1323,2020-02-14 09:00:00,2020-02-14 00:00:00,LABORABLE
14,2,2020,11,542,661,1203,2020-02-14 10:00:00,2020-02-14 00:00:00,LABORABLE
14,2,2020,12,633,678,1311,2020-02-14 11:00:00,2020-02-14 00:00:00,LABORABLE
14,2,2020,13,498,633,1131,2020-02-14 12:00:00,2020-02-14 00:00:00,LABORABLE
14,2,2020,14,668,720,1388,2020-02-14 13:00:00,2020-02-14 00:00:00,LABORABLE
14,2,2020,15,738,731,1469,2020-02-14 14:00:00,2020-02-14 00:00:00,LABORABLE
14,2,2020,16,663,720,1383,2020-02-14 15:00:00,2020-02-14 00:00:00,LABORABLE
14,2,2020,17,687,731,1418,2020-02-14 16:00:00,2020-02-14 00:00:00,LABORABLE
14,2,2020,18,710,755,1465,2020-02-14 17:00:00,2020-02-14 00:00:00,LABORABLE
14,2,2020,19,658,770,1428,2020-02-14 18:00:00,2020-02-14 00:00:00,LABORABLE
14,2,2020,20,713,802,1515,2020-02-14 19:00:00,2020-02-14 00:00:00,LABORABLE
14,2,2020,21,667,832,1499,2020-02-14 20:00:00,2020-02-14 00:00:00,LABORABLE
14,2,2020,22,658,714,1372,2020-02-14 21:00:00,2020-02-14 00:00:00,LABORABLE
14,2,2020,23,532,588,1120,2020-02-14 22:00:00,2020-02-14 00:00:00,LABORABLE
14,2,2020,24,436,557,993,2020-02-14 23:00:00,2020-02-14 00:00:00,LABORABLE
15,2,2020,1,389,490,879,2020-02-15 00:00:00,2020-02-15 00:00:00,LABORABLE
15,2,2020,2,279,432,711,2020-02-15 01:00:00,2020-02-15 00:00:00,LABORABLE
15,2,2020,3,219,324,543,2020-02-15 02:00:00,2020-02-15 00:00:00,LABORABLE
15,2,2020,4,144,297,441,2020-02-15 03:00:00,2020-02-15 00:00:00,LABORABLE
15,2,2020,5,161,232,393,2020-02-15 04:00:00,2020-02-15 00:00:00,LABORABLE
15,2,2020,6,171,256,427,2020-02-15 05:00:00,2020-02-15 00:00:00,LABORABLE
15,2,2020,7,251,282,533,2020-02-15 06:00:00,2020-02-15 00:00:00,LABORABLE
15,2,2020,8,301,283,584,2020-02-15 07:00:00,2020-02-15 00:00:00,LABORABLE
15,2,2020,9,365,372,737,2020-02-15 08:00:00,2020-02-15 00:00:00,LABORABLE
15,2,2020,10,429,486,915,2020-02-15 09:00:00,2020-02-15 00:00:00,LABORABLE
15,2,2020,11,529,555,1084,2020-02-15 10:00:00,2020-02-15 00:00:00,LABORABLE
15,2,2020,12,605,665,1270,2020-02-15 11:00:00,2020-02-15 00:00:00,LABORABLE
15,2,2020,13,709,691,1400,2020-02-15 12:00:00,2020-02-15 00:00:00,LABORABLE
15,2,2020,14,701,751,1452,2020-02-15 13:00:00,2020-02-15 00:00:00,LABORABLE
15,2,2020,15,617,731,1348,2020-02-15 14:00:00,2020-02-15 00:00:00,LABORABLE
15,2,2020,16,528,695,1223,2020-02-15 15:00:00,2020-02-15 00:00:00,LABORABLE
15,2,2020,17,536,632,1168,2020-02-15 16:00:00,2020-02-15 00:00:00,LABORABLE
15,2,2020,18,545,664,1209,2020-02-15 17:00:00,2020-02-15 00:00:00,LABORABLE
15,2,2020,19,616,736,1352,2020-02-15 18:00:00,2020-02-15 00:00:00,LABORABLE
15,2,2020,20,643,699,1342,2020-02-15 19:00:00,2020-02-15 00:00:00,LABORABLE
15,2,2020,21,615,706,1321,2020-02-15 20:00:00,2020-02-15 00:00:00,LABORABLE
15,2,2020,22,567,629,1196,2020-02-15 21:00:00,2020-02-15 00:00:00,LABORABLE
15,2,2020,23,575,625,1200,2020-02-15 22:00:00,2020-02-15 00:00:00,LABORABLE
15,2,2020,24,423,489,912,2020-02-15 23:00:00,2020-02-15 00:00:00,LABORABLE
16,2,2020,1,348,382,730,2020-02-16 00:00:00,2020-02-16 00:00:00,LABORABLE
16,2,2020,2,346,434,780,2020-02-16 01:00:00,2020-02-16 00:00:00,LABORABLE
16,2,2020,3,234,346,580,2020-02-16 02:00:00,2020-02-16 00:00:00,LABORABLE
16,2,2020,4,186,303,489,2020-02-16 03:00:00,2020-02-16 00:00:00,LABORABLE
16,2,2020,5,156,282,438,2020-02-16 04:00:00,2020-02-16 00:00:00,LABORABLE
16,2,2020,6,167,258,425,2020-02-16 05:00:00,2020-02-16 00:00:00,LABORABLE
16,2,2020,7,172,296,468,2020-02-16 06:00:00,2020-02-16 00:00:00,LABORABLE
16,2,2020,8,208,238,446,2020-02-16 07:00:00,2020-02-16 00:00:00,LABORABLE
16,2,2020,9,211,280,491,2020-02-16 08:00:00,2020-02-16 00:00:00,LABORABLE
16,2,2020,10,353,354,707,2020-02-16 09:00:00,2020-02-16 00:00:00,LABORABLE
16,2,2020,11,394,415,809,2020-02-16 10:00:00,2020-02-16 00:00:00,LABORABLE
16,2,2020,12,549,560,1109,2020-02-16 11:00:00,2020-02-16 00:00:00,LABORABLE
16,2,2020,13,535,597,1132,2020-02-16 12:00:00,2020-02-16 00:00:00,LABORABLE
16,2,2020,14,617,681,1298,2020-02-16 13:00:00,2020-02-16 00:00:00,LABORABLE
16,2,2020,15,550,688,1238,2020-02-16 14:00:00,2020-02-16 00:00:00,LABORABLE
16,2,2020,16,500,587,1087,2020-02-16 15:00:00,2020-02-16 00:00:00,LABORABLE
16,2,2020,17,499,628,1127,2020-02-16 16:00:00,2020-02-16 00:00:00,LABORABLE
16,2,2020,18,536,616,1152,2020-02-16 17:00:00,2020-02-16 00:00:00,LABORABLE
16,2,2020,19,552,680,1232,2020-02-16 18:00:00,2020-02-16 00:00:00,LABORABLE
16,2,2020,20,573,652,1225,2020-02-16 19:00:00,2020-02-16 00:00:00,LABORABLE
16,2,2020,21,517,566,1083,2020-02-16 20:00:00,2020-02-16 00:00:00,LABORABLE
16,2,2020,22,496,557,1053,2020-02-16 21:00:00,2020-02-16 00:00:00,LABORABLE
16,2,2020,23,368,382,750,2020-02-16 22:00:00,2020-02-16 00:00:00,LABORABLE
16,2,2020,24,271,307,578,2020-02-16 23:00:00,2020-02-16 00:00:00,LABORABLE
17,2,2020,1,199,210,409,2020-02-17 00:00:00,2020-02-17 00:00:00,LABORABLE
17,2,2020,2,115,188,303,2020-02-17 01:00:00,2020-02-17 00:00:00,LABORABLE
17,2,2020,3,98,145,243,2020-02-17 02:00:00,2020-02-17 00:00:00,LABORABLE
17,2,2020,4,66,99,165,2020-02-17 03:00:00,2020-02-17 00:00:00,LABORABLE
17,2,2020,5,102,122,224,2020-02-17 04:00:00,2020-02-17 00:00:00,LABORABLE
17,2,2020,6,201,176,377,2020-02-17 05:00:00,2020-02-17 00:00:00,LABORABLE
17,2,2020,7,451,430,881,2020-02-17 06:00:00,2020-02-17 00:00:00,LABORABLE
17,2,2020,8,675,620,1295,2020-02-17 07:00:00,2020-02-17 00:00:00,LABORABLE
17,2,2020,9,718,628,1346,2020-02-17 08:00:00,2020-02-17 00:00:00,LABORABLE
17,2,2020,10,648,702,1350,2020-02-17 09:00:00,2020-02-17 00:00:00,LABORABLE
17,2,2020,11,503,621,1124,2020-02-17 10:00:00,2020-02-17 00:00:00,LABORABLE
17,2,2020,12,576,642,1218,2020-02-17 11:00:00,2020-02-17 00:00:00,LABORABLE
17,2,2020,13,587,709,1296,2020-02-17 12:00:00,2020-02-17 00:00:00,LABORABLE
17,2,2020,14,565,715,1280,2020-02-17 13:00:00,2020-02-17 00:00:00,LABORABLE
17,2,2020,15,676,690,1366,2020-02-17 14:00:00,2020-02-17 00:00:00,LABORABLE
17,2,2020,16,638,649,1287,2020-02-17 15:00:00,2020-02-17 00:00:00,LABORABLE
17,2,2020,17,635,713,1348,2020-02-17 16:00:00,2020-02-17 00:00:00,LABORABLE
17,2,2020,18,686,685,1371,2020-02-17 17:00:00,2020-02-17 00:00:00,LABORABLE
17,2,2020,19,624,714,1338,2020-02-17 18:00:00,2020-02-17 00:00:00,LABORABLE
17,2,2020,20,630,690,1320,2020-02-17 19:00:00,2020-02-17 00:00:00,LABORABLE
17,2,2020,21,609,676,1285,2020-02-17 20:00:00,2020-02-17 00:00:00,LABORABLE
17,2,2020,22,491,541,1032,2020-02-17 21:00:00,2020-02-17 00:00:00,LABORABLE
17,2,2020,23,353,401,754,2020-02-17 22:00:00,2020-02-17 00:00:00,LABORABLE
17,2,2020,24,207,289,496,2020-02-17 23:00:00,2020-02-17 00:00:00,LABORABLE
18,2,2020,1,172,186,358,2020-02-18 00:00:00,2020-02-18 00:00:00,LABORABLE
18,2,2020,2,92,141,233,2020-02-18 01:00:00,2020-02-18 00:00:00,LABORABLE
18,2,2020,3,77,110,187,2020-02-18 02:00:00,2020-02-18 00:00:00,LABORABLE
18,2,2020,4,90,91,181,2020-02-18 03:00:00,2020-02-18 00:00:00,LABORABLE
18,2,2020,5,93,87,180,2020-02-18 04:00:00,2020-02-18 00:00:00,LABORABLE
18,2,2020,6,199,152,351,2020-02-18 05:00:00,2020-02-18 00:00:00,LABORABLE
18,2,2020,7,432,365,797,2020-02-18 06:00:00,2020-02-18 00:00:00,LABORABLE
18,2,2020,8,666,602,1268,2020-02-18 07:00:00,2020-02-18 00:00:00,LABORABLE
18,2,2020,9,715,664,1379,2020-02-18 08:00:00,2020-02-18 00:00:00,LABORABLE
18,2,2020,10,661,679,1340,2020-02-18 09:00:00,2020-02-18 00:00:00,LABORABLE
18,2,2020,11,556,668,1224,2020-02-18 10:00:00,2020-02-18 00:00:00,LABORABLE
18,2,2020,12,623,712,1335,2020-02-18 11:00:00,2020-02-18 00:00:00,LABORABLE
18,2,2020,13,645,688,1333,2020-02-18 12:00:00,2020-02-18 00:00:00,LABORABLE
18,2,2020,14,637,679,1316,2020-02-18 13:00:00,2020-02-18 00:00:00,LABORABLE
18,2,2020,15,637,725,1362,2020-02-18 14:00:00,2020-02-18 00:00:00,LABORABLE
18,2,2020,16,613,623,1236,2020-02-18 15:00:00,2020-02-18 00:00:00,LABORABLE
18,2,2020,17,632,690,1322,2020-02-18 16:00:00,2020-02-18 00:00:00,LABORABLE
18,2,2020,18,676,718,1394,2020-02-18 17:00:00,2020-02-18 00:00:00,LABORABLE
18,2,2020,19,656,742,1398,2020-02-18 18:00:00,2020-02-18 00:00:00,LABORABLE
18,2,2020,20,631,745,1376,2020-02-18 19:00:00,2020-02-18 00:00:00,LABORABLE
18,2,2020,21,626,703,1329,2020-02-18 20:00:00,2020-02-18 00:00:00,LABORABLE
18,2,2020,22,513,597,1110,2020-02-18 21:00:00,2020-02-18 00:00:00,LABORABLE
18,2,2020,23,355,400,755,2020-02-18 22:00:00,2020-02-18 00:00:00,LABORABLE
18,2,2020,24,274,271,545,2020-02-18 23:00:00,2020-02-18 00:00:00,LABORABLE
19,2,2020,1,207,194,401,2020-02-19 00:00:00,2020-02-19 00:00:00,LABORABLE
19,2,2020,2,89,144,233,2020-02-19 01:00:00,2020-02-19 00:00:00,LABORABLE
19,2,2020,3,78,114,192,2020-02-19 02:00:00,2020-02-19 00:00:00,LABORABLE
19,2,2020,4,76,87,163,2020-02-19 03:00:00,2020-02-19 00:00:00,LABORABLE
19,2,2020,5,95,91,186,2020-02-19 04:00:00,2020-02-19 00:00:00,LABORABLE
19,2,2020,6,189,170,359,2020-02-19 05:00:00,2020-02-19 00:00:00,LABORABLE
19,2,2020,7,441,412,853,2020-02-19 06:00:00,2020-02-19 00:00:00,LABORABLE
19,2,2020,8,657,610,1267,2020-02-19 07:00:00,2020-02-19 00:00:00,LABORABLE
19,2,2020,9,708,678,1386,2020-02-19 08:00:00,2020-02-19 00:00:00,LABORABLE
19,2,2020,10,685,694,1379,2020-02-19 09:00:00,2020-02-19 00:00:00,LABORABLE
19,2,2020,11,558,692,1250,2020-02-19 10:00:00,2020-02-19 00:00:00,LABORABLE
19,2,2020,12,561,702,1263,2020-02-19 11:00:00,2020-02-19 00:00:00,LABORABLE
19,2,2020,13,600,707,1307,2020-02-19 12:00:00,2020-02-19 00:00:00,LABORABLE
19,2,2020,14,606,646,1252,2020-02-19 13:00:00,2020-02-19 00:00:00,LABORABLE
19,2,2020,15,628,660,1288,2020-02-19 14:00:00,2020-02-19 00:00:00,LABORABLE
19,2,2020,16,635,623,1258,2020-02-19 15:00:00,2020-02-19 00:00:00,LABORABLE
19,2,2020,17,627,718,1345,2020-02-19 16:00:00,2020-02-19 00:00:00,LABORABLE
19,2,2020,18,678,695,1373,2020-02-19 17:00:00,2020-02-19 00:00:00,LABORABLE
19,2,2020,19,603,746,1349,2020-02-19 18:00:00,2020-02-19 00:00:00,LABORABLE
19,2,2020,20,636,750,1386,2020-02-19 19:00:00,2020-02-19 00:00:00,LABORABLE
19,2,2020,21,650,684,1334,2020-02-19 20:00:00,2020-02-19 00:00:00,LABORABLE
19,2,2020,22,540,574,1114,2020-02-19 21:00:00,2020-02-19 00:00:00,LABORABLE
19,2,2020,23,425,488,913,2020-02-19 22:00:00,2020-02-19 00:00:00,LABORABLE
19,2,2020,24,255,281,536,2020-02-19 23:00:00,2020-02-19 00:00:00,LABORABLE
20,2,2020,1,201,253,454,2020-02-20 00:00:00,2020-02-20 00:00:00,LABORABLE
20,2,2020,2,113,178,291,2020-02-20 01:00:00,2020-02-20 00:00:00,LABORABLE
20,2,2020,3,93,130,223,2020-02-20 02:00:00,2020-02-20 00:00:00,LABORABLE
20,2,2020,4,68,117,185,2020-02-20 03:00:00,2020-02-20 00:00:00,LABORABLE
20,2,2020,5,93,100,193,2020-02-20 04:00:00,2020-02-20 00:00:00,LABORABLE
20,2,2020,6,188,160,348,2020-02-20 05:00:00,2020-02-20 00:00:00,LABORABLE
20,2,2020,7,443,388,831,2020-02-20 06:00:00,2020-02-20 00:00:00,LABORABLE
20,2,2020,8,672,596,1268,2020-02-20 07:00:00,2020-02-20 00:00:00,LABORABLE
20,2,2020,9,713,682,1395,2020-02-20 08:00:00,2020-02-20 00:00:00,LABORABLE
20,2,2020,10,674,662,1336,2020-02-20 09:00:00,2020-02-20 00:00:00,LABORABLE
20,2,2020,11,552,680,1232,2020-02-20 10:00:00,2020-02-20 00:00:00,LABORABLE
20,2,2020,12,594,694,1288,2020-02-20 11:00:00,2020-02-20 00:00:00,LABORABLE
20,2,2020,13,692,727,1419,2020-02-20 12:00:00,2020-02-20 00:00:00,LABORABLE
20,2,2020,14,660,771,1431,2020-02-20 13:00:00,2020-02-20 00:00:00,LABORABLE
20,2,2020,15,646,677,1323,2020-02-20 14:00:00,2020-02-20 00:00:00,LABORABLE
20,2,2020,16,639,663,1302,2020-02-20 15:00:00,2020-02-20 00:00:00,LABORABLE
20,2,2020,17,658,713,1371,2020-02-20 16:00:00,2020-02-20 00:00:00,LABORABLE
20,2,2020,18,677,738,1415,2020-02-20 17:00:00,2020-02-20 00:00:00,LABORABLE
20,2,2020,19,668,750,1418,2020-02-20 18:00:00,2020-02-20 00:00:00,LABORABLE
20,2,2020,20,661,724,1385,2020-02-20 19:00:00,2020-02-20 00:00:00,LABORABLE
20,2,2020,21,624,738,1362,2020-02-20 20:00:00,2020-02-20 00:00:00,LABORABLE
20,2,2020,22,560,575,1135,2020-02-20 21:00:00,2020-02-20 00:00:00,LABORABLE
20,2,2020,23,443,505,948,2020-02-20 22:00:00,2020-02-20 00:00:00,LABORABLE
20,2,2020,24,304,343,647,2020-02-20 23:00:00,2020-02-20 00:00:00,LABORABLE
21,2,2020,1,188,285,473,2020-02-21 00:00:00,2020-02-21 00:00:00,LABORABLE
21,2,2020,2,129,213,342,2020-02-21 01:00:00,2020-02-21 00:00:00,LABORABLE
21,2,2020,3,101,157,258,2020-02-21 02:00:00,2020-02-21 00:00:00,LABORABLE
21,2,2020,4,87,136,223,2020-02-21 03:00:00,2020-02-21 00:00:00,LABORABLE
21,2,2020,5,97,138,235,2020-02-21 04:00:00,2020-02-21 00:00:00,LABORABLE
21,2,2020,6,209,190,399,2020-02-21 05:00:00,2020-02-21 00:00:00,LABORABLE
21,2,2020,7,439,422,861,2020-02-21 06:00:00,2020-02-21 00:00:00,LABORABLE
21,2,2020,8,661,572,1233,2020-02-21 07:00:00,2020-02-21 00:00:00,LABORABLE
21,2,2020,9,714,648,1362,2020-02-21 08:00:00,2020-02-21 00:00:00,LABORABLE
21,2,2020,10,657,743,1400,2020-02-21 09:00:00,2020-02-21 00:00:00,LABORABLE
21,2,2020,11,558,634,1192,2020-02-21 10:00:00,2020-02-21 00:00:00,LABORABLE
21,2,2020,12,629,699,1328,2020-02-21 11:00:00,2020-02-21 00:00:00,LABORABLE
21,2,2020,13,635,763,1398,2020-02-21 12:00:00,2020-02-21 00:00:00,LABORABLE
21,2,2020,14,677,758,1435,2020-02-21 13:00:00,2020-02-21 00:00:00,LABORABLE
21,2,2020,15,711,776,1487,2020-02-21 14:00:00,2020-02-21 00:00:00,LABORABLE
21,2,2020,16,662,686,1348,2020-02-21 15:00:00,2020-02-21 00:00:00,LABORABLE
21,2,2020,17,664,721,1385,2020-02-21 16:00:00,2020-02-21 00:00:00,LABORABLE
21,2,2020,18,706,746,1452,2020-02-21 17:00:00,2020-02-21 00:00:00,LABORABLE
21,2,2020,19,675,761,1436,2020-02-21 18:00:00,2020-02-21 00:00:00,LABORABLE
21,2,2020,20,689,760,1449,2020-02-21 19:00:00,2020-02-21 00:00:00,LABORABLE
21,2,2020,21,701,766,1467,2020-02-21 20:00:00,2020-02-21 00:00:00,LABORABLE
21,2,2020,22,647,721,1368,2020-02-21 21:00:00,2020-02-21 00:00:00,LABORABLE
21,2,2020,23,501,558,1059,2020-02-21 22:00:00,2020-02-21 00:00:00,LABORABLE
21,2,2020,24,433,495,928,2020-02-21 23:00:00,2020-02-21 00:00:00,LABORABLE
22,2,2020,1,331,400,731,2020-02-22 00:00:00,2020-02-22 00:00:00,LABORABLE
22,2,2020,2,229,311,540,2020-02-22 01:00:00,2020-02-22 00:00:00,LABORABLE
22,2,2020,3,191,289,480,2020-02-22 02:00:00,2020-02-22 00:00:00,LABORABLE
22,2,2020,4,150,238,388,2020-02-22 03:00:00,2020-02-22 00:00:00,LABORABLE
22,2,2020,5,121,206,327,2020-02-22 04:00:00,2020-02-22 00:00:00,LABORABLE
22,2,2020,6,159,254,413,2020-02-22 05:00:00,2020-02-22 00:00:00,LABORABLE
22,2,2020,7,242,284,526,2020-02-22 06:00:00,2020-02-22 00:00:00,LABORABLE
22,2,2020,8,299,320,619,2020-02-22 07:00:00,2020-02-22 00:00:00,LABORABLE
22,2,2020,9,358,373,731,2020-02-22 08:00:00,2020-02-22 00:00:00,LABORABLE
22,2,2020,10,469,503,972,2020-02-22 09:00:00,2020-02-22 00:00:00,LABORABLE
22,2,2020,11,551,549,1100,2020-02-22 10:00:00,2020-02-22 00:00:00,LABORABLE
22,2,2020,12,613,631,1244,2020-02-22 11:00:00,2020-02-22 00:00:00,LABORABLE
22,2,2020,13,632,731,1363,2020-02-22 12:00:00,2020-02-22 00:00:00,LABORABLE
22,2,2020,14,692,782,1474,2020-02-22 13:00:00,2020-02-22 00:00:00,LABORABLE
22,2,2020,15,626,772,1398,2020-02-22 14:00:00,2020-02-22 00:00:00,LABORABLE
22,2,2020,16,530,636,1166,2020-02-22 15:00:00,2020-02-22 00:00:00,LABORABLE
22,2,2020,17,566,661,1227,2020-02-22 16:00:00,2020-02-22 00:00:00,LABORABLE
22,2,2020,18,562,682,1244,2020-02-22 17:00:00,2020-02-22 00:00:00,LABORABLE
22,2,2020,19,635,724,1359,2020-02-22 18:00:00,2020-02-22 00:00:00,LABORABLE
22,2,2020,20,603,809,1412,2020-02-22 19:00:00,2020-02-22 00:00:00,LABORABLE
22,2,2020,21,625,687,1312,2020-02-22 20:00:00,2020-02-22 00:00:00,LABORABLE
22,2,2020,22,589,664,1253,2020-02-22 21:00:00,2020-02-22 00:00:00,LABORABLE
22,2,2020,23,514,522,1036,2020-02-22 22:00:00,2020-02-22 00:00:00,LABORABLE
22,2,2020,24,440,505,945,2020-02-22 23:00:00,2020-02-22 00:00:00,LABORABLE
23,2,2020,1,352,461,813,2020-02-23 00:00:00,2020-02-23 00:00:00,LABORABLE
23,2,2020,2,292,391,683,2020-02-23 01:00:00,2020-02-23 00:00:00,LABORABLE
23,2,2020,3,238,357,595,2020-02-23 02:00:00,2020-02-23 00:00:00,LABORABLE
23,2,2020,4,185,313,498,2020-02-23 03:00:00,2020-02-23 00:00:00,LABORABLE
23,2,2020,5,161,254,415,2020-02-23 04:00:00,2020-02-23 00:00:00,LABORABLE
23,2,2020,6,140,251,391,2020-02-23 05:00:00,2020-02-23 00:00:00,LABORABLE
23,2,2020,7,170,280,450,2020-02-23 06:00:00,2020-02-23 00:00:00,LABORABLE
23,2,2020,8,171,209,380,2020-02-23 07:00:00,2020-02-23 00:00:00,LABORABLE
23,2,2020,9,220,265,485,2020-02-23 08:00:00,2020-02-23 00:00:00,LABORABLE
23,2,2020,10,337,331,668,2020-02-23 09:00:00,2020-02-23 00:00:00,LABORABLE
23,2,2020,11,447,414,861,2020-02-23 10:00:00,2020-02-23 00:00:00,LABORABLE
23,2,2020,12,515,592,1107,2020-02-23 11:00:00,2020-02-23 00:00:00,LABORABLE
23,2,2020,13,580,614,1194,2020-02-23 12:00:00,2020-02-23 00:00:00,LABORABLE
23,2,2020,14,631,682,1313,2020-02-23 13:00:00,2020-02-23 00:00:00,LABORABLE
23,2,2020,15,557,631,1188,2020-02-23 14:00:00,2020-02-23 00:00:00,LABORABLE
23,2,2020,16,445,606,1051,2020-02-23 15:00:00,2020-02-23 00:00:00,LABORABLE
23,2,2020,17,448,585,1033,2020-02-23 16:00:00,2020-02-23 00:00:00,LABORABLE
23,2,2020,18,535,645,1180,2020-02-23 17:00:00,2020-02-23 00:00:00,LABORABLE
23,2,2020,19,519,642,1161,2020-02-23 18:00:00,2020-02-23 00:00:00,LABORABLE
23,2,2020,20,554,701,1255,2020-02-23 19:00:00,2020-02-23 00:00:00,LABORABLE
23,2,2020,21,543,675,1218,2020-02-23 20:00:00,2020-02-23 00:00:00,LABORABLE
23,2,2020,22,515,553,1068,2020-02-23 21:00:00,2020-02-23 00:00:00,LABORABLE
23,2,2020,23,367,404,771,2020-02-23 22:00:00,2020-02-23 00:00:00,LABORABLE
23,2,2020,24,252,297,549,2020-02-23 23:00:00,2020-02-23 00:00:00,LABORABLE
24,2,2020,1,179,265,444,2020-02-24 00:00:00,2020-02-24 00:00:00,LABORABLE
24,2,2020,2,125,198,323,2020-02-24 01:00:00,2020-02-24 00:00:00,LABORABLE
24,2,2020,3,90,168,258,2020-02-24 02:00:00,2020-02-24 00:00:00,LABORABLE
24,2,2020,4,80,119,199,2020-02-24 03:00:00,2020-02-24 00:00:00,LABORABLE
24,2,2020,5,83,111,194,2020-02-24 04:00:00,2020-02-24 00:00:00,LABORABLE
24,2,2020,6,184,178,362,2020-02-24 05:00:00,2020-02-24 00:00:00,LABORABLE
24,2,2020,7,463,405,868,2020-02-24 06:00:00,2020-02-24 00:00:00,LABORABLE
24,2,2020,8,674,585,1259,2020-02-24 07:00:00,2020-02-24 00:00:00,LABORABLE
24,2,2020,9,686,669,1355,2020-02-24 08:00:00,2020-02-24 00:00:00,LABORABLE
24,2,2020,10,654,611,1265,2020-02-24 09:00:00,2020-02-24 00:00:00,LABORABLE
24,2,2020,11,552,630,1182,2020-02-24 10:00:00,2020-02-24 00:00:00,LABORABLE
24,2,2020,12,562,645,1207,2020-02-24 11:00:00,2020-02-24 00:00:00,LABORABLE
24,2,2020,13,567,681,1248,2020-02-24 12:00:00,2020-02-24 00:00:00,LABORABLE
24,2,2020,14,610,760,1370,2020-02-24 13:00:00,2020-02-24 00:00:00,LABORABLE
24,2,2020,15,644,686,1330,2020-02-24 14:00:00,2020-02-24 00:00:00,LABORABLE
24,2,2020,16,643,678,1321,2020-02-24 15:00:00,2020-02-24 00:00:00,LABORABLE
24,2,2020,17,628,713,1341,2020-02-24 16:00:00,2020-02-24 00:00:00,LABORABLE
24,2,2020,18,644,732,1376,2020-02-24 17:00:00,2020-02-24 00:00:00,LABORABLE
24,2,2020,19,615,737,1352,2020-02-24 18:00:00,2020-02-24 00:00:00,LABORABLE
24,2,2020,20,610,764,1374,2020-02-24 19:00:00,2020-02-24 00:00:00,LABORABLE
24,2,2020,21,583,679,1262,2020-02-24 20:00:00,2020-02-24 00:00:00,LABORABLE
24,2,2020,22,506,568,1074,2020-02-24 21:00:00,2020-02-24 00:00:00,LABORABLE
24,2,2020,23,361,429,790,2020-02-24 22:00:00,2020-02-24 00:00:00,LABORABLE
24,2,2020,24,217,285,502,2020-02-24 23:00:00,2020-02-24 00:00:00,LABORABLE
25,2,2020,1,158,194,352,2020-02-25 00:00:00,2020-02-25 00:00:00,LABORABLE
25,2,2020,2,89,135,224,2020-02-25 01:00:00,2020-02-25 00:00:00,LABORABLE
25,2,2020,3,83,137,220,2020-02-25 02:00:00,2020-02-25 00:00:00,LABORABLE
25,2,2020,4,67,81,148,2020-02-25 03:00:00,2020-02-25 00:00:00,LABORABLE
25,2,2020,5,86,89,175,2020-02-25 04:00:00,2020-02-25 00:00:00,LABORABLE
25,2,2020,6,195,170,365,2020-02-25 05:00:00,2020-02-25 00:00:00,LABORABLE
25,2,2020,7,442,416,858,2020-02-25 06:00:00,2020-02-25 00:00:00,LABORABLE
25,2,2020,8,657,573,1230,2020-02-25 07:00:00,2020-02-25 00:00:00,LABORABLE
25,2,2020,9,693,717,1410,2020-02-25 08:00:00,2020-02-25 00:00:00,LABORABLE
25,2,2020,10,621,738,1359,2020-02-25 09:00:00,2020-02-25 00:00:00,LABORABLE
25,2,2020,11,476,603,1079,2020-02-25 10:00:00,2020-02-25 00:00:00,LABORABLE
25,2,2020,12,598,732,1330,2020-02-25 11:00:00,2020-02-25 00:00:00,LABORABLE
25,2,2020,13,613,732,1345,2020-02-25 12:00:00,2020-02-25 00:00:00,LABORABLE
25,2,2020,14,612,749,1361,2020-02-25 13:00:00,2020-02-25 00:00:00,LABORABLE
25,2,2020,15,599,676,1275,2020-02-25 14:00:00,2020-02-25 00:00:00,LABORABLE
25,2,2020,16,618,630,1248,2020-02-25 15:00:00,2020-02-25 00:00:00,LABORABLE
25,2,2020,17,625,763,1388,2020-02-25 16:00:00,2020-02-25 00:00:00,LABORABLE
25,2,2020,18,645,789,1434,2020-02-25 17:00:00,2020-02-25 00:00:00,LABORABLE
25,2,2020,19,657,822,1479,2020-02-25 18:00:00,2020-02-25 00:00:00,LABORABLE
25,2,2020,20,636,701,1337,2020-02-25 19:00:00,2020-02-25 00:00:00,LABORABLE
25,2,2020,21,603,742,1345,2020-02-25 20:00:00,2020-02-25 00:00:00,LABORABLE
25,2,2020,22,511,557,1068,2020-02-25 21:00:00,2020-02-25 00:00:00,LABORABLE
25,2,2020,23,335,422,757,2020-02-25 22:00:00,2020-02-25 00:00:00,LABORABLE
25,2,2020,24,245,269,514,2020-02-25 23:00:00,2020-02-25 00:00:00,LABORABLE
26,2,2020,1,155,233,388,2020-02-26 00:00:00,2020-02-26 00:00:00,LABORABLE
26,2,2020,2,97,141,238,2020-02-26 01:00:00,2020-02-26 00:00:00,LABORABLE
26,2,2020,3,80,125,205,2020-02-26 02:00:00,2020-02-26 00:00:00,LABORABLE
26,2,2020,4,88,80,168,2020-02-26 03:00:00,2020-02-26 00:00:00,LABORABLE
26,2,2020,5,94,103,197,2020-02-26 04:00:00,2020-02-26 00:00:00,LABORABLE
26,2,2020,6,182,158,340,2020-02-26 05:00:00,2020-02-26 00:00:00,LABORABLE
26,2,2020,7,435,411,846,2020-02-26 06:00:00,2020-02-26 00:00:00,LABORABLE
26,2,2020,8,657,592,1249,2020-02-26 07:00:00,2020-02-26 00:00:00,LABORABLE
26,2,2020,9,698,667,1365,2020-02-26 08:00:00,2020-02-26 00:00:00,LABORABLE
26,2,2020,10,636,680,1316,2020-02-26 09:00:00,2020-02-26 00:00:00,LABORABLE
26,2,2020,11,495,622,1117,2020-02-26 10:00:00,2020-02-26 00:00:00,LABORABLE
26,2,2020,12,582,658,1240,2020-02-26 11:00:00,2020-02-26 00:00:00,LABORABLE
26,2,2020,13,514,601,1115,2020-02-26 12:00:00,2020-02-26 00:00:00,LABORABLE
26,2,2020,14,626,739,1365,2020-02-26 13:00:00,2020-02-26 00:00:00,LABORABLE
26,2,2020,15,630,715,1345,2020-02-26 14:00:00,2020-02-26 00:00:00,LABORABLE
26,2,2020,16,670,649,1319,2020-02-26 15:00:00,2020-02-26 00:00:00,LABORABLE
26,2,2020,17,639,751,1390,2020-02-26 16:00:00,2020-02-26 00:00:00,LABORABLE
26,2,2020,18,664,797,1461,2020-02-26 17:00:00,2020-02-26 00:00:00,LABORABLE
26,2,2020,19,687,751,1438,2020-02-26 18:00:00,2020-02-26 00:00:00,LABORABLE
26,2,2020,20,665,735,1400,2020-02-26 19:00:00,2020-02-26 00:00:00,LABORABLE
26,2,2020,21,650,675,1325,2020-02-26 20:00:00,2020-02-26 00:00:00,LABORABLE
26,2,2020,22,476,582,1058,2020-02-26 21:00:00,2020-02-26 00:00:00,LABORABLE
26,2,2020,23,358,377,735,2020-02-26 22:00:00,2020-02-26 00:00:00,LABORABLE
26,2,2020,24,275,334,609,2020-02-26 23:00:00,2020-02-26 00:00:00,LABORABLE
27,2,2020,1,176,217,393,2020-02-27 00:00:00,2020-02-27 00:00:00,LABORABLE
27,2,2020,2,121,142,263,2020-02-27 01:00:00,2020-02-27 00:00:00,LABORABLE
27,2,2020,3,90,145,235,2020-02-27 02:00:00,2020-02-27 00:00:00,LABORABLE
27,2,2020,4,89,101,190,2020-02-27 03:00:00,2020-02-27 00:00:00,LABORABLE
27,2,2020,5,85,81,166,2020-02-27 04:00:00,2020-02-27 00:00:00,LABORABLE
27,2,2020,6,166,177,343,2020-02-27 05:00:00,2020-02-27 00:00:00,LABORABLE
27,2,2020,7,434,409,843,2020-02-27 06:00:00,2020-02-27 00:00:00,LABORABLE
27,2,2020,8,694,608,1302,2020-02-27 07:00:00,2020-02-27 00:00:00,LABORABLE
27,2,2020,9,684,691,1375,2020-02-27 08:00:00,2020-02-27 00:00:00,LABORABLE
27,2,2020,10,700,689,1389,2020-02-27 09:00:00,2020-02-27 00:00:00,LABORABLE
27,2,2020,11,604,672,1276,2020-02-27 10:00:00,2020-02-27 00:00:00,LABORABLE
27,2,2020,12,511,690,1201,2020-02-27 11:00:00,2020-02-27 00:00:00,LABORABLE
27,2,2020,13,596,668,1264,2020-02-27 12:00:00,2020-02-27 00:00:00,LABORABLE
27,2,2020,14,674,720,1394,2020-02-27 13:00:00,2020-02-27 00:00:00,LABORABLE
27,2,2020,15,627,675,1302,2020-02-27 14:00:00,2020-02-27 00:00:00,LABORABLE
27,2,2020,16,593,616,1209,2020-02-27 15:00:00,2020-02-27 00:00:00,LABORABLE
27,2,2020,17,680,738,1418,2020-02-27 16:00:00,2020-02-27 00:00:00,LABORABLE
27,2,2020,18,689,745,1434,2020-02-27 17:00:00,2020-02-27 00:00:00,LABORABLE
27,2,2020,19,682,792,1474,2020-02-27 18:00:00,2020-02-27 00:00:00,LABORABLE
27,2,2020,20,688,754,1442,2020-02-27 19:00:00,2020-02-27 00:00:00,LABORABLE
27,2,2020,21,691,712,1403,2020-02-27 20:00:00,2020-02-27 00:00:00,LABORABLE
27,2,2020,22,570,611,1181,2020-02-27 21:00:00,2020-02-27 00:00:00,LABORABLE
27,2,2020,23,439,497,936,2020-02-27 22:00:00,2020-02-27 00:00:00,LABORABLE
27,2,2020,24,306,377,683,2020-02-27 23:00:00,2020-02-27 00:00:00,LABORABLE
28,2,2020,1,215,280,495,2020-02-28 00:00:00,2020-02-28 00:00:00,LABORABLE
28,2,2020,2,115,203,318,2020-02-28 01:00:00,2020-02-28 00:00:00,LABORABLE
28,2,2020,3,103,148,251,2020-02-28 02:00:00,2020-02-28 00:00:00,LABORABLE
28,2,2020,4,103,126,229,2020-02-28 03:00:00,2020-02-28 00:00:00,LABORABLE
28,2,2020,5,117,121,238,2020-02-28 04:00:00,2020-02-28 00:00:00,LABORABLE
28,2,2020,6,205,176,381,2020-02-28 05:00:00,2020-02-28 00:00:00,LABORABLE
28,2,2020,7,457,401,858,2020-02-28 06:00:00,2020-02-28 00:00:00,LABORABLE
28,2,2020,8,562,553,1115,2020-02-28 07:00:00,2020-02-28 00:00:00,LABORABLE
28,2,2020,9,592,577,1169,2020-02-28 08:00:00,2020-02-28 00:00:00,LABORABLE
28,2,2020,10,589,644,1233,2020-02-28 09:00:00,2020-02-28 00:00:00,LABORABLE
28,2,2020,11,497,662,1159,2020-02-28 10:00:00,2020-02-28 00:00:00,LABORABLE
28,2,2020,12,619,683,1302,2020-02-28 11:00:00,2020-02-28 00:00:00,LABORABLE
28,2,2020,13,645,776,1421,2020-02-28 12:00:00,2020-02-28 00:00:00,LABORABLE
28,2,2020,14,658,757,1415,2020-02-28 13:00:00,2020-02-28 00:00:00,LABORABLE
28,2,2020,15,676,707,1383,2020-02-28 14:00:00,2020-02-28 00:00:00,LABORABLE
28,2,2020,16,647,693,1340,2020-02-28 15:00:00,2020-02-28 00:00:00,LABORABLE
28,2,2020,17,658,763,1421,2020-02-28 16:00:00,2020-02-28 00:00:00,LABORABLE
28,2,2020,18,674,692,1366,2020-02-28 17:00:00,2020-02-28 00:00:00,LABORABLE
28,2,2020,19,664,752,1416,2020-02-28 18:00:00,2020-02-28 00:00:00,LABORABLE
28,2,2020,20,729,847,1576,2020-02-28 19:00:00,2020-02-28 00:00:00,LABORABLE
28,2,2020,21,696,797,1493,2020-02-28 20:00:00,2020-02-28 00:00:00,LABORABLE
28,2,2020,22,658,727,1385,2020-02-28 21:00:00,2020-02-28 00:00:00,LABORABLE
28,2,2020,23,531,588,1119,2020-02-28 22:00:00,2020-02-28 00:00:00,LABORABLE
28,2,2020,24,393,433,826,2020-02-28 23:00:00,2020-02-28 00:00:00,LABORABLE
29,2,2020,1,340,435,775,2020-02-29 00:00:00,2020-02-29 00:00:00,LABORABLE
29,2,2020,2,217,342,559,2020-02-29 01:00:00,2020-02-29 00:00:00,LABORABLE
29,2,2020,3,215,294,509,2020-02-29 02:00:00,2020-02-29 00:00:00,LABORABLE
29,2,2020,4,176,220,396,2020-02-29 03:00:00,2020-02-29 00:00:00,LABORABLE
29,2,2020,5,146,170,316,2020-02-29 04:00:00,2020-02-29 00:00:00,LABORABLE
29,2,2020,6,148,215,363,2020-02-29 05:00:00,2020-02-29 00:00:00,LABORABLE
29,2,2020,7,251,283,534,2020-02-29 06:00:00,2020-02-29 00:00:00,LABORABLE
29,2,2020,8,282,326,608,2020-02-29 07:00:00,2020-02-29 00:00:00,LABORABLE
29,2,2020,9,361,406,767,2020-02-29 08:00:00,2020-02-29 00:00:00,LABORABLE
29,2,2020,10,467,525,992,2020-02-29 09:00:00,2020-02-29 00:00:00,LABORABLE
29,2,2020,11,568,572,1140,2020-02-29 10:00:00,2020-02-29 00:00:00,LABORABLE
29,2,2020,12,675,650,1325,2020-02-29 11:00:00,2020-02-29 00:00:00,LABORABLE
29,2,2020,13,664,699,1363,2020-02-29 12:00:00,2020-02-29 00:00:00,LABORABLE
29,2,2020,14,692,739,1431,2020-02-29 13:00:00,2020-02-29 00:00:00,LABORABLE
29,2,2020,15,648,758,1406,2020-02-29 14:00:00,2020-02-29 00:00:00,LABORABLE
29,2,2020,16,521,612,1133,2020-02-29 15:00:00,2020-02-29 00:00:00,LABORABLE
29,2,2020,17,553,644,1197,2020-02-29 16:00:00,2020-02-29 00:00:00,LABORABLE
29,2,2020,18,604,691,1295,2020-02-29 17:00:00,2020-02-29 00:00:00,LABORABLE
29,2,2020,19,602,686,1288,2020-02-29 18:00:00,2020-02-29 00:00:00,LABORABLE
29,2,2020,20,634,779,1413,2020-02-29 19:00:00,2020-02-29 00:00:00,LABORABLE
29,2,2020,21,604,761,1365,2020-02-29 20:00:00,2020-02-29 00:00:00,LABORABLE
29,2,2020,22,572,656,1228,2020-02-29 21:00:00,2020-02-29 00:00:00,LABORABLE
29,2,2020,23,555,579,1134,2020-02-29 22:00:00,2020-02-29 00:00:00,LABORABLE
29,2,2020,24,397,499,896,2020-02-29 23:00:00,2020-02-29 00:00:00,LABORABLE
1,3,2020,1,372,403,775,2020-03-01 00:00:00,2020-01-03 00:00:00,LABORABLE
1,3,2020,2,300,370,670,2020-03-01 01:00:00,2020-01-03 00:00:00,LABORABLE
1,3,2020,3,243,312,555,2020-03-01 02:00:00,2020-01-03 00:00:00,LABORABLE
1,3,2020,4,186,278,464,2020-03-01 03:00:00,2020-01-03 00:00:00,LABORABLE
1,3,2020,5,151,259,410,2020-03-01 04:00:00,2020-01-03 00:00:00,LABORABLE
1,3,2020,6,180,222,402,2020-03-01 05:00:00,2020-01-03 00:00:00,LABORABLE
1,3,2020,7,208,280,488,2020-03-01 06:00:00,2020-01-03 00:00:00,LABORABLE
1,3,2020,8,178,234,412,2020-03-01 07:00:00,2020-01-03 00:00:00,LABORABLE
1,3,2020,9,224,275,499,2020-03-01 08:00:00,2020-01-03 00:00:00,LABORABLE
1,3,2020,10,338,384,722,2020-03-01 09:00:00,2020-01-03 00:00:00,LABORABLE
1,3,2020,11,412,441,853,2020-03-01 10:00:00,2020-01-03 00:00:00,LABORABLE
1,3,2020,12,492,553,1045,2020-03-01 11:00:00,2020-01-03 00:00:00,LABORABLE
1,3,2020,13,550,552,1102,2020-03-01 12:00:00,2020-01-03 00:00:00,LABORABLE
1,3,2020,14,590,646,1236,2020-03-01 13:00:00,2020-01-03 00:00:00,LABORABLE
1,3,2020,15,588,645,1233,2020-03-01 14:00:00,2020-01-03 00:00:00,LABORABLE
1,3,2020,16,490,615,1105,2020-03-01 15:00:00,2020-01-03 00:00:00,LABORABLE
1,3,2020,17,482,630,1112,2020-03-01 16:00:00,2020-01-03 00:00:00,LABORABLE
1,3,2020,18,550,625,1175,2020-03-01 17:00:00,2020-01-03 00:00:00,LABORABLE
1,3,2020,19,577,724,1301,2020-03-01 18:00:00,2020-01-03 00:00:00,LABORABLE
1,3,2020,20,569,661,1230,2020-03-01 19:00:00,2020-01-03 00:00:00,LABORABLE
1,3,2020,21,530,659,1189,2020-03-01 20:00:00,2020-01-03 00:00:00,LABORABLE
1,3,2020,22,440,445,885,2020-03-01 21:00:00,2020-01-03 00:00:00,LABORABLE
1,3,2020,23,307,341,648,2020-03-01 22:00:00,2020-01-03 00:00:00,LABORABLE
1,3,2020,24,349,366,715,2020-03-01 23:00:00,2020-01-03 00:00:00,LABORABLE
2,3,2020,1,220,247,467,2020-03-02 00:00:00,2020-02-03 00:00:00,LABORABLE
2,3,2020,2,111,188,299,2020-03-02 01:00:00,2020-02-03 00:00:00,LABORABLE
2,3,2020,3,76,155,231,2020-03-02 02:00:00,2020-02-03 00:00:00,LABORABLE
2,3,2020,4,92,132,224,2020-03-02 03:00:00,2020-02-03 00:00:00,LABORABLE
2,3,2020,5,80,100,180,2020-03-02 04:00:00,2020-02-03 00:00:00,LABORABLE
2,3,2020,6,186,161,347,2020-03-02 05:00:00,2020-02-03 00:00:00,LABORABLE
2,3,2020,7,415,366,781,2020-03-02 06:00:00,2020-02-03 00:00:00,LABORABLE
2,3,2020,8,584,534,1118,2020-03-02 07:00:00,2020-02-03 00:00:00,LABORABLE
2,3,2020,9,591,573,1164,2020-03-02 08:00:00,2020-02-03 00:00:00,LABORABLE
2,3,2020,10,544,687,1231,2020-03-02 09:00:00,2020-02-03 00:00:00,LABORABLE
2,3,2020,11,529,623,1152,2020-03-02 10:00:00,2020-02-03 00:00:00,LABORABLE
2,3,2020,12,571,698,1269,2020-03-02 11:00:00,2020-02-03 00:00:00,LABORABLE
2,3,2020,13,611,704,1315,2020-03-02 12:00:00,2020-02-03 00:00:00,LABORABLE
2,3,2020,14,637,734,1371,2020-03-02 13:00:00,2020-02-03 00:00:00,LABORABLE
2,3,2020,15,641,686,1327,2020-03-02 14:00:00,2020-02-03 00:00:00,LABORABLE
2,3,2020,16,592,607,1199,2020-03-02 15:00:00,2020-02-03 00:00:00,LABORABLE
2,3,2020,17,532,592,1124,2020-03-02 16:00:00,2020-02-03 00:00:00,LABORABLE
2,3,2020,18,610,738,1348,2020-03-02 17:00:00,2020-02-03 00:00:00,LABORABLE
2,3,2020,19,676,749,1425,2020-03-02 18:00:00,2020-02-03 00:00:00,LABORABLE
2,3,2020,20,680,753,1433,2020-03-02 19:00:00,2020-02-03 00:00:00,LABORABLE
2,3,2020,21,652,738,1390,2020-03-02 20:00:00,2020-02-03 00:00:00,LABORABLE
2,3,2020,22,490,589,1079,2020-03-02 21:00:00,2020-02-03 00:00:00,LABORABLE
2,3,2020,23,414,394,808,2020-03-02 22:00:00,2020-02-03 00:00:00,LABORABLE
2,3,2020,24,232,257,489,2020-03-02 23:00:00,2020-02-03 00:00:00,LABORABLE
3,3,2020,1,152,206,358,2020-03-03 00:00:00,2020-03-03 00:00:00,LABORABLE
3,3,2020,2,85,163,248,2020-03-03 01:00:00,2020-03-03 00:00:00,LABORABLE
3,3,2020,3,93,128,221,2020-03-03 02:00:00,2020-03-03 00:00:00,LABORABLE
3,3,2020,4,58,89,147,2020-03-03 03:00:00,2020-03-03 00:00:00,LABORABLE
3,3,2020,5,94,88,182,2020-03-03 04:00:00,2020-03-03 00:00:00,LABORABLE
3,3,2020,6,126,136,262,2020-03-03 05:00:00,2020-03-03 00:00:00,LABORABLE
3,3,2020,7,441,403,844,2020-03-03 06:00:00,2020-03-03 00:00:00,LABORABLE
3,3,2020,8,612,586,1198,2020-03-03 07:00:00,2020-03-03 00:00:00,LABORABLE
3,3,2020,9,742,667,1409,2020-03-03 08:00:00,2020-03-03 00:00:00,LABORABLE
3,3,2020,10,622,751,1373,2020-03-03 09:00:00,2020-03-03 00:00:00,LABORABLE
3,3,2020,11,515,636,1151,2020-03-03 10:00:00,2020-03-03 00:00:00,LABORABLE
3,3,2020,12,598,699,1297,2020-03-03 11:00:00,2020-03-03 00:00:00,LABORABLE
3,3,2020,13,618,740,1358,2020-03-03 12:00:00,2020-03-03 00:00:00,LABORABLE
3,3,2020,14,604,736,1340,2020-03-03 13:00:00,2020-03-03 00:00:00,LABORABLE
3,3,2020,15,714,701,1415,2020-03-03 14:00:00,2020-03-03 00:00:00,LABORABLE
3,3,2020,16,698,677,1375,2020-03-03 15:00:00,2020-03-03 00:00:00,LABORABLE
3,3,2020,17,654,750,1404,2020-03-03 16:00:00,2020-03-03 00:00:00,LABORABLE
3,3,2020,18,672,720,1392,2020-03-03 17:00:00,2020-03-03 00:00:00,LABORABLE
3,3,2020,19,646,714,1360,2020-03-03 18:00:00,2020-03-03 00:00:00,LABORABLE
3,3,2020,20,627,787,1414,2020-03-03 19:00:00,2020-03-03 00:00:00,LABORABLE
3,3,2020,21,638,749,1387,2020-03-03 20:00:00,2020-03-03 00:00:00,LABORABLE
3,3,2020,22,519,604,1123,2020-03-03 21:00:00,2020-03-03 00:00:00,LABORABLE
3,3,2020,23,413,426,839,2020-03-03 22:00:00,2020-03-03 00:00:00,LABORABLE
3,3,2020,24,272,307,579,2020-03-03 23:00:00,2020-03-03 00:00:00,LABORABLE
4,3,2020,1,167,241,408,2020-03-04 00:00:00,2020-04-03 00:00:00,LABORABLE
4,3,2020,2,115,167,282,2020-03-04 01:00:00,2020-04-03 00:00:00,LABORABLE
4,3,2020,3,80,124,204,2020-03-04 02:00:00,2020-04-03 00:00:00,LABORABLE
4,3,2020,4,59,88,147,2020-03-04 03:00:00,2020-04-03 00:00:00,LABORABLE
4,3,2020,5,93,80,173,2020-03-04 04:00:00,2020-04-03 00:00:00,LABORABLE
4,3,2020,6,119,138,257,2020-03-04 05:00:00,2020-04-03 00:00:00,LABORABLE
4,3,2020,7,415,407,822,2020-03-04 06:00:00,2020-04-03 00:00:00,LABORABLE
4,3,2020,8,667,613,1280,2020-03-04 07:00:00,2020-04-03 00:00:00,LABORABLE
4,3,2020,9,712,679,1391,2020-03-04 08:00:00,2020-04-03 00:00:00,LABORABLE
4,3,2020,10,627,704,1331,2020-03-04 09:00:00,2020-04-03 00:00:00,LABORABLE
4,3,2020,11,556,620,1176,2020-03-04 10:00:00,2020-04-03 00:00:00,LABORABLE
4,3,2020,12,598,706,1304,2020-03-04 11:00:00,2020-04-03 00:00:00,LABORABLE
4,3,2020,13,568,728,1296,2020-03-04 12:00:00,2020-04-03 00:00:00,LABORABLE
4,3,2020,14,629,742,1371,2020-03-04 13:00:00,2020-04-03 00:00:00,LABORABLE
4,3,2020,15,630,698,1328,2020-03-04 14:00:00,2020-04-03 00:00:00,LABORABLE
4,3,2020,16,638,635,1273,2020-03-04 15:00:00,2020-04-03 00:00:00,LABORABLE
4,3,2020,17,669,731,1400,2020-03-04 16:00:00,2020-04-03 00:00:00,LABORABLE
4,3,2020,18,680,682,1362,2020-03-04 17:00:00,2020-04-03 00:00:00,LABORABLE
4,3,2020,19,656,767,1423,2020-03-04 18:00:00,2020-04-03 00:00:00,LABORABLE
4,3,2020,20,653,798,1451,2020-03-04 19:00:00,2020-04-03 00:00:00,LABORABLE
4,3,2020,21,679,718,1397,2020-03-04 20:00:00,2020-04-03 00:00:00,LABORABLE
4,3,2020,22,496,597,1093,2020-03-04 21:00:00,2020-04-03 00:00:00,LABORABLE
4,3,2020,23,424,443,867,2020-03-04 22:00:00,2020-04-03 00:00:00,LABORABLE
4,3,2020,24,295,313,608,2020-03-04 23:00:00,2020-04-03 00:00:00,LABORABLE
5,3,2020,1,191,265,456,2020-03-05 00:00:00,2020-05-03 00:00:00,LABORABLE
5,3,2020,2,113,174,287,2020-03-05 01:00:00,2020-05-03 00:00:00,LABORABLE
5,3,2020,3,95,143,238,2020-03-05 02:00:00,2020-05-03 00:00:00,LABORABLE
5,3,2020,4,72,92,164,2020-03-05 03:00:00,2020-05-03 00:00:00,LABORABLE
5,3,2020,5,103,92,195,2020-03-05 04:00:00,2020-05-03 00:00:00,LABORABLE
5,3,2020,6,181,149,330,2020-03-05 05:00:00,2020-05-03 00:00:00,LABORABLE
5,3,2020,7,407,415,822,2020-03-05 06:00:00,2020-05-03 00:00:00,LABORABLE
5,3,2020,8,678,619,1297,2020-03-05 07:00:00,2020-05-03 00:00:00,LABORABLE
5,3,2020,9,709,685,1394,2020-03-05 08:00:00,2020-05-03 00:00:00,LABORABLE
5,3,2020,10,678,700,1378,2020-03-05 09:00:00,2020-05-03 00:00:00,LABORABLE
5,3,2020,11,506,659,1165,2020-03-05 10:00:00,2020-05-03 00:00:00,LABORABLE
5,3,2020,12,534,681,1215,2020-03-05 11:00:00,2020-05-03 00:00:00,LABORABLE
5,3,2020,13,571,717,1288,2020-03-05 12:00:00,2020-05-03 00:00:00,LABORABLE
5,3,2020,14,610,757,1367,2020-03-05 13:00:00,2020-05-03 00:00:00,LABORABLE
5,3,2020,15,623,699,1322,2020-03-05 14:00:00,2020-05-03 00:00:00,LABORABLE
5,3,2020,16,583,643,1226,2020-03-05 15:00:00,2020-05-03 00:00:00,LABORABLE
5,3,2020,17,627,791,1418,2020-03-05 16:00:00,2020-05-03 00:00:00,LABORABLE
5,3,2020,18,662,720,1382,2020-03-05 17:00:00,2020-05-03 00:00:00,LABORABLE
5,3,2020,19,682,772,1454,2020-03-05 18:00:00,2020-05-03 00:00:00,LABORABLE
5,3,2020,20,638,777,1415,2020-03-05 19:00:00,2020-05-03 00:00:00,LABORABLE
5,3,2020,21,683,766,1449,2020-03-05 20:00:00,2020-05-03 00:00:00,LABORABLE
5,3,2020,22,579,586,1165,2020-03-05 21:00:00,2020-05-03 00:00:00,LABORABLE
5,3,2020,23,437,447,884,2020-03-05 22:00:00,2020-05-03 00:00:00,LABORABLE
5,3,2020,24,279,337,616,2020-03-05 23:00:00,2020-05-03 00:00:00,LABORABLE
6,3,2020,1,298,330,628,2020-03-06 00:00:00,2020-06-03 00:00:00,LABORABLE
6,3,2020,2,122,311,433,2020-03-06 01:00:00,2020-06-03 00:00:00,LABORABLE
6,3,2020,3,78,160,238,2020-03-06 02:00:00,2020-06-03 00:00:00,LABORABLE
6,3,2020,4,100,133,233,2020-03-06 03:00:00,2020-06-03 00:00:00,LABORABLE
6,3,2020,5,96,124,220,2020-03-06 04:00:00,2020-06-03 00:00:00,LABORABLE
6,3,2020,6,209,182,391,2020-03-06 05:00:00,2020-06-03 00:00:00,LABORABLE
6,3,2020,7,232,289,521,2020-03-06 06:00:00,2020-06-03 00:00:00,LABORABLE
6,3,2020,8,363,598,961,2020-03-06 07:00:00,2020-06-03 00:00:00,LABORABLE
6,3,2020,9,662,680,1342,2020-03-06 08:00:00,2020-06-03 00:00:00,LABORABLE
6,3,2020,10,635,740,1375,2020-03-06 09:00:00,2020-06-03 00:00:00,LABORABLE
6,3,2020,11,511,655,1166,2020-03-06 10:00:00,2020-06-03 00:00:00,LABORABLE
6,3,2020,12,463,599,1062,2020-03-06 11:00:00,2020-06-03 00:00:00,LABORABLE
6,3,2020,13,631,726,1357,2020-03-06 12:00:00,2020-06-03 00:00:00,LABORABLE
6,3,2020,14,650,773,1423,2020-03-06 13:00:00,2020-06-03 00:00:00,LABORABLE
6,3,2020,15,686,787,1473,2020-03-06 14:00:00,2020-06-03 00:00:00,LABORABLE
6,3,2020,16,642,716,1358,2020-03-06 15:00:00,2020-06-03 00:00:00,LABORABLE
6,3,2020,17,648,705,1353,2020-03-06 16:00:00,2020-06-03 00:00:00,LABORABLE
6,3,2020,18,652,765,1417,2020-03-06 17:00:00,2020-06-03 00:00:00,LABORABLE
6,3,2020,19,651,781,1432,2020-03-06 18:00:00,2020-06-03 00:00:00,LABORABLE
6,3,2020,20,676,786,1462,2020-03-06 19:00:00,2020-06-03 00:00:00,LABORABLE
6,3,2020,21,682,850,1532,2020-03-06 20:00:00,2020-06-03 00:00:00,LABORABLE
6,3,2020,22,639,733,1372,2020-03-06 21:00:00,2020-06-03 00:00:00,LABORABLE
6,3,2020,23,512,583,1095,2020-03-06 22:00:00,2020-06-03 00:00:00,LABORABLE
6,3,2020,24,362,438,800,2020-03-06 23:00:00,2020-06-03 00:00:00,LABORABLE
7,3,2020,1,307,436,743,2020-03-07 00:00:00,2020-07-03 00:00:00,LABORABLE
7,3,2020,2,248,336,584,2020-03-07 01:00:00,2020-07-03 00:00:00,LABORABLE
7,3,2020,3,199,262,461,2020-03-07 02:00:00,2020-07-03 00:00:00,LABORABLE
7,3,2020,4,157,228,385,2020-03-07 03:00:00,2020-07-03 00:00:00,LABORABLE
7,3,2020,5,118,174,292,2020-03-07 04:00:00,2020-07-03 00:00:00,LABORABLE
7,3,2020,6,163,179,342,2020-03-07 05:00:00,2020-07-03 00:00:00,LABORABLE
7,3,2020,7,207,264,471,2020-03-07 06:00:00,2020-07-03 00:00:00,LABORABLE
7,3,2020,8,284,313,597,2020-03-07 07:00:00,2020-07-03 00:00:00,LABORABLE
7,3,2020,9,335,396,731,2020-03-07 08:00:00,2020-07-03 00:00:00,LABORABLE
7,3,2020,10,454,474,928,2020-03-07 09:00:00,2020-07-03 00:00:00,LABORABLE
7,3,2020,11,539,512,1051,2020-03-07 10:00:00,2020-07-03 00:00:00,LABORABLE
7,3,2020,12,580,637,1217,2020-03-07 11:00:00,2020-07-03 00:00:00,LABORABLE
7,3,2020,13,681,765,1446,2020-03-07 12:00:00,2020-07-03 00:00:00,LABORABLE
7,3,2020,14,558,646,1204,2020-03-07 13:00:00,2020-07-03 00:00:00,LABORABLE
7,3,2020,15,630,727,1357,2020-03-07 14:00:00,2020-07-03 00:00:00,LABORABLE
7,3,2020,16,522,701,1223,2020-03-07 15:00:00,2020-07-03 00:00:00,LABORABLE
7,3,2020,17,490,670,1160,2020-03-07 16:00:00,2020-07-03 00:00:00,LABORABLE
7,3,2020,18,552,644,1196,2020-03-07 17:00:00,2020-07-03 00:00:00,LABORABLE
7,3,2020,19,608,710,1318,2020-03-07 18:00:00,2020-07-03 00:00:00,LABORABLE
7,3,2020,20,649,728,1377,2020-03-07 19:00:00,2020-07-03 00:00:00,LABORABLE
7,3,2020,21,613,727,1340,2020-03-07 20:00:00,2020-07-03 00:00:00,LABORABLE
7,3,2020,22,580,714,1294,2020-03-07 21:00:00,2020-07-03 00:00:00,LABORABLE
7,3,2020,23,494,564,1058,2020-03-07 22:00:00,2020-07-03 00:00:00,LABORABLE
7,3,2020,24,406,467,873,2020-03-07 23:00:00,2020-07-03 00:00:00,LABORABLE
8,3,2020,1,453,470,923,2020-03-08 00:00:00,2020-08-03 00:00:00,LABORABLE
8,3,2020,2,353,390,743,2020-03-08 01:00:00,2020-08-03 00:00:00,LABORABLE
8,3,2020,3,277,365,642,2020-03-08 02:00:00,2020-08-03 00:00:00,LABORABLE
8,3,2020,4,224,283,507,2020-03-08 03:00:00,2020-08-03 00:00:00,LABORABLE
8,3,2020,5,154,293,447,2020-03-08 04:00:00,2020-08-03 00:00:00,LABORABLE
8,3,2020,6,156,259,415,2020-03-08 05:00:00,2020-08-03 00:00:00,LABORABLE
8,3,2020,7,194,281,475,2020-03-08 06:00:00,2020-08-03 00:00:00,LABORABLE
8,3,2020,8,191,269,460,2020-03-08 07:00:00,2020-08-03 00:00:00,LABORABLE
8,3,2020,9,231,234,465,2020-03-08 08:00:00,2020-08-03 00:00:00,LABORABLE
8,3,2020,10,338,387,725,2020-03-08 09:00:00,2020-08-03 00:00:00,LABORABLE
8,3,2020,11,419,475,894,2020-03-08 10:00:00,2020-08-03 00:00:00,LABORABLE
8,3,2020,12,547,574,1121,2020-03-08 11:00:00,2020-08-03 00:00:00,LABORABLE
8,3,2020,13,537,589,1126,2020-03-08 12:00:00,2020-08-03 00:00:00,LABORABLE
8,3,2020,14,575,692,1267,2020-03-08 13:00:00,2020-08-03 00:00:00,LABORABLE
8,3,2020,15,636,627,1263,2020-03-08 14:00:00,2020-08-03 00:00:00,LABORABLE
8,3,2020,16,507,643,1150,2020-03-08 15:00:00,2020-08-03 00:00:00,LABORABLE
8,3,2020,17,469,543,1012,2020-03-08 16:00:00,2020-08-03 00:00:00,LABORABLE
8,3,2020,18,498,680,1178,2020-03-08 17:00:00,2020-08-03 00:00:00,LABORABLE
8,3,2020,19,526,652,1178,2020-03-08 18:00:00,2020-08-03 00:00:00,LABORABLE
8,3,2020,20,561,659,1220,2020-03-08 19:00:00,2020-08-03 00:00:00,LABORABLE
8,3,2020,21,480,676,1156,2020-03-08 20:00:00,2020-08-03 00:00:00,LABORABLE
8,3,2020,22,514,525,1039,2020-03-08 21:00:00,2020-08-03 00:00:00,LABORABLE
8,3,2020,23,335,388,723,2020-03-08 22:00:00,2020-08-03 00:00:00,LABORABLE
8,3,2020,24,293,303,596,2020-03-08 23:00:00,2020-08-03 00:00:00,LABORABLE
9,3,2020,1,180,252,432,2020-03-09 00:00:00,2020-09-03 00:00:00,LABORABLE
9,3,2020,2,113,176,289,2020-03-09 01:00:00,2020-09-03 00:00:00,LABORABLE
9,3,2020,3,91,154,245,2020-03-09 02:00:00,2020-09-03 00:00:00,LABORABLE
9,3,2020,4,82,107,189,2020-03-09 03:00:00,2020-09-03 00:00:00,LABORABLE
9,3,2020,5,73,117,190,2020-03-09 04:00:00,2020-09-03 00:00:00,LABORABLE
9,3,2020,6,127,159,286,2020-03-09 05:00:00,2020-09-03 00:00:00,LABORABLE
9,3,2020,7,421,428,849,2020-03-09 06:00:00,2020-09-03 00:00:00,LABORABLE
9,3,2020,8,693,615,1308,2020-03-09 07:00:00,2020-09-03 00:00:00,LABORABLE
9,3,2020,9,680,720,1400,2020-03-09 08:00:00,2020-09-03 00:00:00,LABORABLE
9,3,2020,10,607,658,1265,2020-03-09 09:00:00,2020-09-03 00:00:00,LABORABLE
9,3,2020,11,532,606,1138,2020-03-09 10:00:00,2020-09-03 00:00:00,LABORABLE
9,3,2020,12,546,644,1190,2020-03-09 11:00:00,2020-09-03 00:00:00,LABORABLE
9,3,2020,13,586,733,1319,2020-03-09 12:00:00,2020-09-03 00:00:00,LABORABLE
9,3,2020,14,548,780,1328,2020-03-09 13:00:00,2020-09-03 00:00:00,LABORABLE
9,3,2020,15,623,688,1311,2020-03-09 14:00:00,2020-09-03 00:00:00,LABORABLE
9,3,2020,16,624,672,1296,2020-03-09 15:00:00,2020-09-03 00:00:00,LABORABLE
9,3,2020,17,642,696,1338,2020-03-09 16:00:00,2020-09-03 00:00:00,LABORABLE
9,3,2020,18,642,702,1344,2020-03-09 17:00:00,2020-09-03 00:00:00,LABORABLE
9,3,2020,19,609,682,1291,2020-03-09 18:00:00,2020-09-03 00:00:00,LABORABLE
9,3,2020,20,586,800,1386,2020-03-09 19:00:00,2020-09-03 00:00:00,LABORABLE
9,3,2020,21,575,711,1286,2020-03-09 20:00:00,2020-09-03 00:00:00,LABORABLE
9,3,2020,22,455,597,1052,2020-03-09 21:00:00,2020-09-03 00:00:00,LABORABLE
9,3,2020,23,349,409,758,2020-03-09 22:00:00,2020-09-03 00:00:00,LABORABLE
9,3,2020,24,219,282,501,2020-03-09 23:00:00,2020-09-03 00:00:00,LABORABLE
10,3,2020,1,147,212,359,2020-03-10 00:00:00,2020-10-03 00:00:00,LABORABLE
10,3,2020,2,95,137,232,2020-03-10 01:00:00,2020-10-03 00:00:00,LABORABLE
10,3,2020,3,85,128,213,2020-03-10 02:00:00,2020-10-03 00:00:00,LABORABLE
10,3,2020,4,72,88,160,2020-03-10 03:00:00,2020-10-03 00:00:00,LABORABLE
10,3,2020,5,70,100,170,2020-03-10 04:00:00,2020-10-03 00:00:00,LABORABLE
10,3,2020,6,173,147,320,2020-03-10 05:00:00,2020-10-03 00:00:00,LABORABLE
10,3,2020,7,432,353,785,2020-03-10 06:00:00,2020-10-03 00:00:00,LABORABLE
10,3,2020,8,663,586,1249,2020-03-10 07:00:00,2020-10-03 00:00:00,LABORABLE
10,3,2020,9,686,689,1375,2020-03-10 08:00:00,2020-10-03 00:00:00,LABORABLE
10,3,2020,10,618,624,1242,2020-03-10 09:00:00,2020-10-03 00:00:00,LABORABLE
10,3,2020,11,531,604,1135,2020-03-10 10:00:00,2020-10-03 00:00:00,LABORABLE
10,3,2020,12,569,712,1281,2020-03-10 11:00:00,2020-10-03 00:00:00,LABORABLE
10,3,2020,13,625,768,1393,2020-03-10 12:00:00,2020-10-03 00:00:00,LABORABLE
10,3,2020,14,638,747,1385,2020-03-10 13:00:00,2020-10-03 00:00:00,LABORABLE
10,3,2020,15,599,692,1291,2020-03-10 14:00:00,2020-10-03 00:00:00,LABORABLE
10,3,2020,16,615,705,1320,2020-03-10 15:00:00,2020-10-03 00:00:00,LABORABLE
10,3,2020,17,615,764,1379,2020-03-10 16:00:00,2020-10-03 00:00:00,LABORABLE
10,3,2020,18,636,804,1440,2020-03-10 17:00:00,2020-10-03 00:00:00,LABORABLE
10,3,2020,19,641,699,1340,2020-03-10 18:00:00,2020-10-03 00:00:00,LABORABLE
10,3,2020,20,658,767,1425,2020-03-10 19:00:00,2020-10-03 00:00:00,LABORABLE
10,3,2020,21,640,782,1422,2020-03-10 20:00:00,2020-10-03 00:00:00,LABORABLE
10,3,2020,22,500,584,1084,2020-03-10 21:00:00,2020-10-03 00:00:00,LABORABLE
10,3,2020,23,379,441,820,2020-03-10 22:00:00,2020-10-03 00:00:00,LABORABLE
10,3,2020,24,224,321,545,2020-03-10 23:00:00,2020-10-03 00:00:00,LABORABLE
11,3,2020,1,179,262,441,2020-03-11 00:00:00,2020-11-03 00:00:00,LABORABLE
11,3,2020,2,123,176,299,2020-03-11 01:00:00,2020-11-03 00:00:00,LABORABLE
11,3,2020,3,74,114,188,2020-03-11 02:00:00,2020-11-03 00:00:00,LABORABLE
11,3,2020,4,82,89,171,2020-03-11 03:00:00,2020-11-03 00:00:00,LABORABLE
11,3,2020,5,97,84,181,2020-03-11 04:00:00,2020-11-03 00:00:00,LABORABLE
11,3,2020,6,119,181,300,2020-03-11 05:00:00,2020-11-03 00:00:00,LABORABLE
11,3,2020,7,400,374,774,2020-03-11 06:00:00,2020-11-03 00:00:00,LABORABLE
11,3,2020,8,653,582,1235,2020-03-11 07:00:00,2020-11-03 00:00:00,LABORABLE
11,3,2020,9,626,603,1229,2020-03-11 08:00:00,2020-11-03 00:00:00,LABORABLE
11,3,2020,10,517,629,1146,2020-03-11 09:00:00,2020-11-03 00:00:00,LABORABLE
11,3,2020,11,562,666,1228,2020-03-11 10:00:00,2020-11-03 00:00:00,LABORABLE
11,3,2020,12,441,582,1023,2020-03-11 11:00:00,2020-11-03 00:00:00,LABORABLE
11,3,2020,13,555,729,1284,2020-03-11 12:00:00,2020-11-03 00:00:00,LABORABLE
11,3,2020,14,595,740,1335,2020-03-11 13:00:00,2020-11-03 00:00:00,LABORABLE
11,3,2020,15,608,704,1312,2020-03-11 14:00:00,2020-11-03 00:00:00,LABORABLE
11,3,2020,16,583,612,1195,2020-03-11 15:00:00,2020-11-03 00:00:00,LABORABLE
11,3,2020,17,543,690,1233,2020-03-11 16:00:00,2020-11-03 00:00:00,LABORABLE
11,3,2020,18,637,760,1397,2020-03-11 17:00:00,2020-11-03 00:00:00,LABORABLE
11,3,2020,19,661,769,1430,2020-03-11 18:00:00,2020-11-03 00:00:00,LABORABLE
11,3,2020,20,591,707,1298,2020-03-11 19:00:00,2020-11-03 00:00:00,LABORABLE
11,3,2020,21,583,679,1262,2020-03-11 20:00:00,2020-11-03 00:00:00,LABORABLE
11,3,2020,22,609,560,1169,2020-03-11 21:00:00,2020-11-03 00:00:00,LABORABLE
11,3,2020,23,342,448,790,2020-03-11 22:00:00,2020-11-03 00:00:00,LABORABLE
11,3,2020,24,230,295,525,2020-03-11 23:00:00,2020-11-03 00:00:00,LABORABLE
12,3,2020,1,179,272,451,2020-03-12 00:00:00,2020-12-03 00:00:00,LABORABLE
12,3,2020,2,124,178,302,2020-03-12 01:00:00,2020-12-03 00:00:00,LABORABLE
12,3,2020,3,90,124,214,2020-03-12 02:00:00,2020-12-03 00:00:00,LABORABLE
12,3,2020,4,85,97,182,2020-03-12 03:00:00,2020-12-03 00:00:00,LABORABLE
12,3,2020,5,92,83,175,2020-03-12 04:00:00,2020-12-03 00:00:00,LABORABLE
12,3,2020,6,177,164,341,2020-03-12 05:00:00,2020-12-03 00:00:00,LABORABLE
12,3,2020,7,398,394,792,2020-03-12 06:00:00,2020-12-03 00:00:00,LABORABLE
12,3,2020,8,648,531,1179,2020-03-12 07:00:00,2020-12-03 00:00:00,LABORABLE
12,3,2020,9,621,598,1219,2020-03-12 08:00:00,2020-12-03 00:00:00,LABORABLE
12,3,2020,10,519,627,1146,2020-03-12 09:00:00,2020-12-03 00:00:00,LABORABLE
12,3,2020,11,407,576,983,2020-03-12 10:00:00,2020-12-03 00:00:00,LABORABLE
12,3,2020,12,582,638,1220,2020-03-12 11:00:00,2020-12-03 00:00:00,LABORABLE
12,3,2020,13,628,746,1374,2020-03-12 12:00:00,2020-12-03 00:00:00,LABORABLE
12,3,2020,14,623,751,1374,2020-03-12 13:00:00,2020-12-03 00:00:00,LABORABLE
12,3,2020,15,606,690,1296,2020-03-12 14:00:00,2020-12-03 00:00:00,LABORABLE
12,3,2020,16,528,648,1176,2020-03-12 15:00:00,2020-12-03 00:00:00,LABORABLE
12,3,2020,17,545,631,1176,2020-03-12 16:00:00,2020-12-03 00:00:00,LABORABLE
12,3,2020,18,621,700,1321,2020-03-12 17:00:00,2020-12-03 00:00:00,LABORABLE
12,3,2020,19,649,725,1374,2020-03-12 18:00:00,2020-12-03 00:00:00,LABORABLE
12,3,2020,20,587,766,1353,2020-03-12 19:00:00,2020-12-03 00:00:00,LABORABLE
12,3,2020,21,534,725,1259,2020-03-12 20:00:00,2020-12-03 00:00:00,LABORABLE
12,3,2020,22,663,659,1322,2020-03-12 21:00:00,2020-12-03 00:00:00,LABORABLE
12,3,2020,23,351,483,834,2020-03-12 22:00:00,2020-12-03 00:00:00,LABORABLE
12,3,2020,24,387,405,792,2020-03-12 23:00:00,2020-12-03 00:00:00,LABORABLE
13,3,2020,1,298,383,681,2020-03-13 00:00:00,2020-03-13 00:00:00,LABORABLE
13,3,2020,2,217,311,528,2020-03-13 01:00:00,2020-03-13 00:00:00,LABORABLE
13,3,2020,3,79,234,313,2020-03-13 02:00:00,2020-03-13 00:00:00,LABORABLE
13,3,2020,4,81,148,229,2020-03-13 03:00:00,2020-03-13 00:00:00,LABORABLE
13,3,2020,5,99,101,200,2020-03-13 04:00:00,2020-03-13 00:00:00,LABORABLE
13,3,2020,6,194,158,352,2020-03-13 05:00:00,2020-03-13 00:00:00,LABORABLE
13,3,2020,7,232,359,591,2020-03-13 06:00:00,2020-03-13 00:00:00,LABORABLE
13,3,2020,8,363,512,875,2020-03-13 07:00:00,2020-03-13 00:00:00,LABORABLE
13,3,2020,9,554,536,1090,2020-03-13 08:00:00,2020-03-13 00:00:00,LABORABLE
13,3,2020,10,525,647,1172,2020-03-13 09:00:00,2020-03-13 00:00:00,LABORABLE
13,3,2020,11,514,634,1148,2020-03-13 10:00:00,2020-03-13 00:00:00,LABORABLE
13,3,2020,12,563,725,1288,2020-03-13 11:00:00,2020-03-13 00:00:00,LABORABLE
13,3,2020,13,583,699,1282,2020-03-13 12:00:00,2020-03-13 00:00:00,LABORABLE
13,3,2020,14,601,741,1342,2020-03-13 13:00:00,2020-03-13 00:00:00,LABORABLE
13,3,2020,15,569,646,1215,2020-03-13 14:00:00,2020-03-13 00:00:00,LABORABLE
13,3,2020,16,592,657,1249,2020-03-13 15:00:00,2020-03-13 00:00:00,LABORABLE
13,3,2020,17,543,657,1200,2020-03-13 16:00:00,2020-03-13 00:00:00,LABORABLE
13,3,2020,18,562,743,1305,2020-03-13 17:00:00,2020-03-13 00:00:00,LABORABLE
13,3,2020,19,639,825,1464,2020-03-13 18:00:00,2020-03-13 00:00:00,LABORABLE
13,3,2020,20,575,827,1402,2020-03-13 19:00:00,2020-03-13 00:00:00,LABORABLE
13,3,2020,21,566,733,1299,2020-03-13 20:00:00,2020-03-13 00:00:00,LABORABLE
13,3,2020,22,491,551,1042,2020-03-13 21:00:00,2020-03-13 00:00:00,LABORABLE
13,3,2020,23,604,520,1124,2020-03-13 22:00:00,2020-03-13 00:00:00,LABORABLE
13,3,2020,24,462,441,903,2020-03-13 23:00:00,2020-03-13 00:00:00,LABORABLE
14,3,2020,1,180,237,417,2020-03-14 00:00:00,2020-03-14 00:00:00,LABORABLE
14,3,2020,2,110,188,298,2020-03-14 01:00:00,2020-03-14 00:00:00,LABORABLE
14,3,2020,3,64,127,191,2020-03-14 02:00:00,2020-03-14 00:00:00,LABORABLE
14,3,2020,4,65,78,143,2020-03-14 03:00:00,2020-03-14 00:00:00,LABORABLE
14,3,2020,5,68,87,155,2020-03-14 04:00:00,2020-03-14 00:00:00,LABORABLE
14,3,2020,6,86,97,183,2020-03-14 05:00:00,2020-03-14 00:00:00,LABORABLE
14,3,2020,7,152,128,280,2020-03-14 06:00:00,2020-03-14 00:00:00,LABORABLE
14,3,2020,8,194,185,379,2020-03-14 07:00:00,2020-03-14 00:00:00,LABORABLE
14,3,2020,9,221,275,496,2020-03-14 08:00:00,2020-03-14 00:00:00,LABORABLE
14,3,2020,10,248,330,578,2020-03-14 09:00:00,2020-03-14 00:00:00,LABORABLE
14,3,2020,11,317,412,729,2020-03-14 10:00:00,2020-03-14 00:00:00,LABORABLE
14,3,2020,12,332,469,801,2020-03-14 11:00:00,2020-03-14 00:00:00,LABORABLE
14,3,2020,13,400,532,932,2020-03-14 12:00:00,2020-03-14 00:00:00,LABORABLE
14,3,2020,14,392,501,893,2020-03-14 13:00:00,2020-03-14 00:00:00,LABORABLE
14,3,2020,15,389,442,831,2020-03-14 14:00:00,2020-03-14 00:00:00,LABORABLE
14,3,2020,16,282,384,666,2020-03-14 15:00:00,2020-03-14 00:00:00,LABORABLE
14,3,2020,17,235,324,559,2020-03-14 16:00:00,2020-03-14 00:00:00,LABORABLE
14,3,2020,18,235,326,561,2020-03-14 17:00:00,2020-03-14 00:00:00,LABORABLE
14,3,2020,19,264,368,632,2020-03-14 18:00:00,2020-03-14 00:00:00,LABORABLE
14,3,2020,20,286,381,667,2020-03-14 19:00:00,2020-03-14 00:00:00,LABORABLE
14,3,2020,21,253,336,589,2020-03-14 20:00:00,2020-03-14 00:00:00,LABORABLE
14,3,2020,22,195,273,468,2020-03-14 21:00:00,2020-03-14 00:00:00,LABORABLE
14,3,2020,23,196,237,433,2020-03-14 22:00:00,2020-03-14 00:00:00,LABORABLE
14,3,2020,24,94,132,226,2020-03-14 23:00:00,2020-03-14 00:00:00,LABORABLE
15,3,2020,1,85,97,182,2020-03-15 00:00:00,2020-03-15 00:00:00,LABORABLE
15,3,2020,2,47,70,117,2020-03-15 01:00:00,2020-03-15 00:00:00,LABORABLE
15,3,2020,3,34,53,87,2020-03-15 02:00:00,2020-03-15 00:00:00,LABORABLE
15,3,2020,4,29,47,76,2020-03-15 03:00:00,2020-03-15 00:00:00,LABORABLE
15,3,2020,5,22,34,56,2020-03-15 04:00:00,2020-03-15 00:00:00,LABORABLE
15,3,2020,6,45,46,91,2020-03-15 05:00:00,2020-03-15 00:00:00,LABORABLE
15,3,2020,7,69,84,153,2020-03-15 06:00:00,2020-03-15 00:00:00,LABORABLE
15,3,2020,8,86,82,168,2020-03-15 07:00:00,2020-03-15 00:00:00,LABORABLE
15,3,2020,9,89,127,216,2020-03-15 08:00:00,2020-03-15 00:00:00,LABORABLE
15,3,2020,10,133,175,308,2020-03-15 09:00:00,2020-03-15 00:00:00,LABORABLE
15,3,2020,11,143,260,403,2020-03-15 10:00:00,2020-03-15 00:00:00,LABORABLE
15,3,2020,12,199,268,467,2020-03-15 11:00:00,2020-03-15 00:00:00,LABORABLE
15,3,2020,13,214,320,534,2020-03-15 12:00:00,2020-03-15 00:00:00,LABORABLE
15,3,2020,14,223,332,555,2020-03-15 13:00:00,2020-03-15 00:00:00,LABORABLE
15,3,2020,15,212,284,496,2020-03-15 14:00:00,2020-03-15 00:00:00,LABORABLE
15,3,2020,16,206,273,479,2020-03-15 15:00:00,2020-03-15 00:00:00,LABORABLE
15,3,2020,17,120,206,326,2020-03-15 16:00:00,2020-03-15 00:00:00,LABORABLE
15,3,2020,18,149,217,366,2020-03-15 17:00:00,2020-03-15 00:00:00,LABORABLE
15,3,2020,19,147,222,369,2020-03-15 18:00:00,2020-03-15 00:00:00,LABORABLE
15,3,2020,20,165,218,383,2020-03-15 19:00:00,2020-03-15 00:00:00,LABORABLE
15,3,2020,21,140,217,357,2020-03-15 20:00:00,2020-03-15 00:00:00,LABORABLE
15,3,2020,22,141,180,321,2020-03-15 21:00:00,2020-03-15 00:00:00,LABORABLE
15,3,2020,23,101,128,229,2020-03-15 22:00:00,2020-03-15 00:00:00,LABORABLE
15,3,2020,24,53,68,121,2020-03-15 23:00:00,2020-03-15 00:00:00,LABORABLE
16,3,2020,1,29,41,70,2020-03-16 00:00:00,2020-03-16 00:00:00,LABORABLE
16,3,2020,2,28,40,68,2020-03-16 01:00:00,2020-03-16 00:00:00,LABORABLE
16,3,2020,3,27,38,65,2020-03-16 02:00:00,2020-03-16 00:00:00,LABORABLE
16,3,2020,4,17,25,42,2020-03-16 03:00:00,2020-03-16 00:00:00,LABORABLE
16,3,2020,5,44,36,80,2020-03-16 04:00:00,2020-03-16 00:00:00,LABORABLE
16,3,2020,6,119,69,188,2020-03-16 05:00:00,2020-03-16 00:00:00,LABORABLE
16,3,2020,7,270,245,515,2020-03-16 06:00:00,2020-03-16 00:00:00,LABORABLE
16,3,2020,8,432,366,798,2020-03-16 07:00:00,2020-03-16 00:00:00,LABORABLE
16,3,2020,9,364,348,712,2020-03-16 08:00:00,2020-03-16 00:00:00,LABORABLE
16,3,2020,10,296,348,644,2020-03-16 09:00:00,2020-03-16 00:00:00,LABORABLE
16,3,2020,11,256,404,660,2020-03-16 10:00:00,2020-03-16 00:00:00,LABORABLE
16,3,2020,12,282,462,744,2020-03-16 11:00:00,2020-03-16 00:00:00,LABORABLE
16,3,2020,13,318,374,692,2020-03-16 12:00:00,2020-03-16 00:00:00,LABORABLE
16,3,2020,14,308,433,741,2020-03-16 13:00:00,2020-03-16 00:00:00,LABORABLE
16,3,2020,15,339,322,661,2020-03-16 14:00:00,2020-03-16 00:00:00,LABORABLE
16,3,2020,16,324,276,600,2020-03-16 15:00:00,2020-03-16 00:00:00,LABORABLE
16,3,2020,17,202,266,468,2020-03-16 16:00:00,2020-03-16 00:00:00,LABORABLE
16,3,2020,18,227,336,563,2020-03-16 17:00:00,2020-03-16 00:00:00,LABORABLE
16,3,2020,19,219,282,501,2020-03-16 18:00:00,2020-03-16 00:00:00,LABORABLE
16,3,2020,20,221,271,492,2020-03-16 19:00:00,2020-03-16 00:00:00,LABORABLE
16,3,2020,21,193,236,429,2020-03-16 20:00:00,2020-03-16 00:00:00,LABORABLE
16,3,2020,22,156,164,320,2020-03-16 21:00:00,2020-03-16 00:00:00,LABORABLE
16,3,2020,23,108,88,196,2020-03-16 22:00:00,2020-03-16 00:00:00,LABORABLE
16,3,2020,24,52,84,136,2020-03-16 23:00:00,2020-03-16 00:00:00,LABORABLE
17,3,2020,1,30,46,76,2020-03-17 00:00:00,2020-03-17 00:00:00,LABORABLE
17,3,2020,2,25,29,54,2020-03-17 01:00:00,2020-03-17 00:00:00,LABORABLE
17,3,2020,3,31,36,67,2020-03-17 02:00:00,2020-03-17 00:00:00,LABORABLE
17,3,2020,4,38,31,69,2020-03-17 03:00:00,2020-03-17 00:00:00,LABORABLE
17,3,2020,5,45,45,90,2020-03-17 04:00:00,2020-03-17 00:00:00,LABORABLE
17,3,2020,6,123,73,196,2020-03-17 05:00:00,2020-03-17 00:00:00,LABORABLE
17,3,2020,7,265,200,465,2020-03-17 06:00:00,2020-03-17 00:00:00,LABORABLE
17,3,2020,8,372,291,663,2020-03-17 07:00:00,2020-03-17 00:00:00,LABORABLE
17,3,2020,9,298,303,601,2020-03-17 08:00:00,2020-03-17 00:00:00,LABORABLE
17,3,2020,10,249,327,576,2020-03-17 09:00:00,2020-03-17 00:00:00,LABORABLE
17,3,2020,11,219,308,527,2020-03-17 10:00:00,2020-03-17 00:00:00,LABORABLE
17,3,2020,12,259,345,604,2020-03-17 11:00:00,2020-03-17 00:00:00,LABORABLE
17,3,2020,13,250,309,559,2020-03-17 12:00:00,2020-03-17 00:00:00,LABORABLE
17,3,2020,14,277,340,617,2020-03-17 13:00:00,2020-03-17 00:00:00,LABORABLE
17,3,2020,15,310,274,584,2020-03-17 14:00:00,2020-03-17 00:00:00,LABORABLE
17,3,2020,16,251,295,546,2020-03-17 15:00:00,2020-03-17 00:00:00,LABORABLE
17,3,2020,17,187,229,416,2020-03-17 16:00:00,2020-03-17 00:00:00,LABORABLE
17,3,2020,18,205,239,444,2020-03-17 17:00:00,2020-03-17 00:00:00,LABORABLE
17,3,2020,19,194,260,454,2020-03-17 18:00:00,2020-03-17 00:00:00,LABORABLE
17,3,2020,20,175,225,400,2020-03-17 19:00:00,2020-03-17 00:00:00,LABORABLE
17,3,2020,21,175,177,352,2020-03-17 20:00:00,2020-03-17 00:00:00,LABORABLE
17,3,2020,22,120,134,254,2020-03-17 21:00:00,2020-03-17 00:00:00,LABORABLE
17,3,2020,23,108,105,213,2020-03-17 22:00:00,2020-03-17 00:00:00,LABORABLE
17,3,2020,24,46,51,97,2020-03-17 23:00:00,2020-03-17 00:00:00,LABORABLE
18,3,2020,1,35,45,80,2020-03-18 00:00:00,2020-03-18 00:00:00,LABORABLE
18,3,2020,2,22,17,39,2020-03-18 01:00:00,2020-03-18 00:00:00,LABORABLE
18,3,2020,3,25,33,58,2020-03-18 02:00:00,2020-03-18 00:00:00,LABORABLE
18,3,2020,4,28,29,57,2020-03-18 03:00:00,2020-03-18 00:00:00,LABORABLE
18,3,2020,5,42,29,71,2020-03-18 04:00:00,2020-03-18 00:00:00,LABORABLE
18,3,2020,6,102,59,161,2020-03-18 05:00:00,2020-03-18 00:00:00,LABORABLE
18,3,2020,7,261,202,463,2020-03-18 06:00:00,2020-03-18 00:00:00,LABORABLE
18,3,2020,8,352,272,624,2020-03-18 07:00:00,2020-03-18 00:00:00,LABORABLE
18,3,2020,9,308,297,605,2020-03-18 08:00:00,2020-03-18 00:00:00,LABORABLE
18,3,2020,10,224,259,483,2020-03-18 09:00:00,2020-03-18 00:00:00,LABORABLE
18,3,2020,11,206,257,463,2020-03-18 10:00:00,2020-03-18 00:00:00,LABORABLE
18,3,2020,12,226,322,548,2020-03-18 11:00:00,2020-03-18 00:00:00,LABORABLE
18,3,2020,13,211,358,569,2020-03-18 12:00:00,2020-03-18 00:00:00,LABORABLE
18,3,2020,14,255,288,543,2020-03-18 13:00:00,2020-03-18 00:00:00,LABORABLE
18,3,2020,15,299,277,576,2020-03-18 14:00:00,2020-03-18 00:00:00,LABORABLE
18,3,2020,16,245,294,539,2020-03-18 15:00:00,2020-03-18 00:00:00,LABORABLE
18,3,2020,17,193,188,381,2020-03-18 16:00:00,2020-03-18 00:00:00,LABORABLE
18,3,2020,18,193,226,419,2020-03-18 17:00:00,2020-03-18 00:00:00,LABORABLE
18,3,2020,19,201,249,450,2020-03-18 18:00:00,2020-03-18 00:00:00,LABORABLE
18,3,2020,20,182,170,352,2020-03-18 19:00:00,2020-03-18 00:00:00,LABORABLE
18,3,2020,21,167,180,347,2020-03-18 20:00:00,2020-03-18 00:00:00,LABORABLE
18,3,2020,22,135,138,273,2020-03-18 21:00:00,2020-03-18 00:00:00,LABORABLE
18,3,2020,23,103,85,188,2020-03-18 22:00:00,2020-03-18 00:00:00,LABORABLE
18,3,2020,24,66,64,130,2020-03-18 23:00:00,2020-03-18 00:00:00,LABORABLE
19,3,2020,1,22,39,61,2020-03-19 00:00:00,2020-03-19 00:00:00,LABORABLE
19,3,2020,2,16,23,39,2020-03-19 01:00:00,2020-03-19 00:00:00,LABORABLE
19,3,2020,3,23,28,51,2020-03-19 02:00:00,2020-03-19 00:00:00,LABORABLE
19,3,2020,4,19,28,47,2020-03-19 03:00:00,2020-03-19 00:00:00,LABORABLE
19,3,2020,5,34,43,77,2020-03-19 04:00:00,2020-03-19 00:00:00,LABORABLE
19,3,2020,6,91,61,152,2020-03-19 05:00:00,2020-03-19 00:00:00,LABORABLE
19,3,2020,7,248,185,433,2020-03-19 06:00:00,2020-03-19 00:00:00,LABORABLE
19,3,2020,8,342,266,608,2020-03-19 07:00:00,2020-03-19 00:00:00,LABORABLE
19,3,2020,9,264,303,567,2020-03-19 08:00:00,2020-03-19 00:00:00,LABORABLE
19,3,2020,10,200,228,428,2020-03-19 09:00:00,2020-03-19 00:00:00,LABORABLE
19,3,2020,11,202,250,452,2020-03-19 10:00:00,2020-03-19 00:00:00,LABORABLE
19,3,2020,12,225,306,531,2020-03-19 11:00:00,2020-03-19 00:00:00,LABORABLE
19,3,2020,13,203,239,442,2020-03-19 12:00:00,2020-03-19 00:00:00,LABORABLE
19,3,2020,14,252,286,538,2020-03-19 13:00:00,2020-03-19 00:00:00,LABORABLE
19,3,2020,15,241,269,510,2020-03-19 14:00:00,2020-03-19 00:00:00,LABORABLE
19,3,2020,16,203,227,430,2020-03-19 15:00:00,2020-03-19 00:00:00,LABORABLE
19,3,2020,17,182,180,362,2020-03-19 16:00:00,2020-03-19 00:00:00,LABORABLE
19,3,2020,18,173,201,374,2020-03-19 17:00:00,2020-03-19 00:00:00,LABORABLE
19,3,2020,19,189,199,388,2020-03-19 18:00:00,2020-03-19 00:00:00,LABORABLE
19,3,2020,20,155,171,326,2020-03-19 19:00:00,2020-03-19 00:00:00,LABORABLE
19,3,2020,21,141,117,258,2020-03-19 20:00:00,2020-03-19 00:00:00,LABORABLE
19,3,2020,22,107,132,239,2020-03-19 21:00:00,2020-03-19 00:00:00,LABORABLE
19,3,2020,23,88,90,178,2020-03-19 22:00:00,2020-03-19 00:00:00,LABORABLE
19,3,2020,24,49,67,116,2020-03-19 23:00:00,2020-03-19 00:00:00,LABORABLE
20,3,2020,1,20,35,55,2020-03-20 00:00:00,2020-03-20 00:00:00,LABORABLE
20,3,2020,2,24,26,50,2020-03-20 01:00:00,2020-03-20 00:00:00,LABORABLE
20,3,2020,3,25,28,53,2020-03-20 02:00:00,2020-03-20 00:00:00,LABORABLE
20,3,2020,4,25,25,50,2020-03-20 03:00:00,2020-03-20 00:00:00,LABORABLE
20,3,2020,5,30,35,65,2020-03-20 04:00:00,2020-03-20 00:00:00,LABORABLE
20,3,2020,6,86,47,133,2020-03-20 05:00:00,2020-03-20 00:00:00,LABORABLE
20,3,2020,7,236,175,411,2020-03-20 06:00:00,2020-03-20 00:00:00,LABORABLE
20,3,2020,8,343,234,577,2020-03-20 07:00:00,2020-03-20 00:00:00,LABORABLE
20,3,2020,9,168,148,316,2020-03-20 08:00:00,2020-03-20 00:00:00,LABORABLE
20,3,2020,10,177,253,430,2020-03-20 09:00:00,2020-03-20 00:00:00,LABORABLE
20,3,2020,11,198,202,400,2020-03-20 10:00:00,2020-03-20 00:00:00,LABORABLE
20,3,2020,12,185,259,444,2020-03-20 11:00:00,2020-03-20 00:00:00,LABORABLE
20,3,2020,13,195,270,465,2020-03-20 12:00:00,2020-03-20 00:00:00,LABORABLE
20,3,2020,14,244,297,541,2020-03-20 13:00:00,2020-03-20 00:00:00,LABORABLE
20,3,2020,15,265,285,550,2020-03-20 14:00:00,2020-03-20 00:00:00,LABORABLE
20,3,2020,16,203,251,454,2020-03-20 15:00:00,2020-03-20 00:00:00,LABORABLE
20,3,2020,17,181,208,389,2020-03-20 16:00:00,2020-03-20 00:00:00,LABORABLE
20,3,2020,18,160,177,337,2020-03-20 17:00:00,2020-03-20 00:00:00,LABORABLE
20,3,2020,19,172,193,365,2020-03-20 18:00:00,2020-03-20 00:00:00,LABORABLE
20,3,2020,20,133,144,277,2020-03-20 19:00:00,2020-03-20 00:00:00,LABORABLE
20,3,2020,21,124,138,262,2020-03-20 20:00:00,2020-03-20 00:00:00,LABORABLE
20,3,2020,22,97,120,217,2020-03-20 21:00:00,2020-03-20 00:00:00,LABORABLE
20,3,2020,23,73,86,159,2020-03-20 22:00:00,2020-03-20 00:00:00,LABORABLE
20,3,2020,24,53,63,116,2020-03-20 23:00:00,2020-03-20 00:00:00,LABORABLE
21,3,2020,1,27,31,58,2020-03-21 00:00:00,2020-03-21 00:00:00,LABORABLE
21,3,2020,2,18,36,54,2020-03-21 01:00:00,2020-03-21 00:00:00,LABORABLE
21,3,2020,3,23,34,57,2020-03-21 02:00:00,2020-03-21 00:00:00,LABORABLE
21,3,2020,4,28,29,57,2020-03-21 03:00:00,2020-03-21 00:00:00,LABORABLE
21,3,2020,5,31,25,56,2020-03-21 04:00:00,2020-03-21 00:00:00,LABORABLE
21,3,2020,6,34,35,69,2020-03-21 05:00:00,2020-03-21 00:00:00,LABORABLE
21,3,2020,7,84,66,150,2020-03-21 06:00:00,2020-03-21 00:00:00,LABORABLE
21,3,2020,8,90,83,173,2020-03-21 07:00:00,2020-03-21 00:00:00,LABORABLE
21,3,2020,9,93,104,197,2020-03-21 08:00:00,2020-03-21 00:00:00,LABORABLE
21,3,2020,10,102,140,242,2020-03-21 09:00:00,2020-03-21 00:00:00,LABORABLE
21,3,2020,11,106,123,229,2020-03-21 10:00:00,2020-03-21 00:00:00,LABORABLE
21,3,2020,12,120,169,289,2020-03-21 11:00:00,2020-03-21 00:00:00,LABORABLE
21,3,2020,13,169,177,346,2020-03-21 12:00:00,2020-03-21 00:00:00,LABORABLE
21,3,2020,14,150,194,344,2020-03-21 13:00:00,2020-03-21 00:00:00,LABORABLE
21,3,2020,15,140,173,313,2020-03-21 14:00:00,2020-03-21 00:00:00,LABORABLE
21,3,2020,16,118,144,262,2020-03-21 15:00:00,2020-03-21 00:00:00,LABORABLE
21,3,2020,17,80,110,190,2020-03-21 16:00:00,2020-03-21 00:00:00,LABORABLE
21,3,2020,18,95,114,209,2020-03-21 17:00:00,2020-03-21 00:00:00,LABORABLE
21,3,2020,19,77,129,206,2020-03-21 18:00:00,2020-03-21 00:00:00,LABORABLE
21,3,2020,20,92,117,209,2020-03-21 19:00:00,2020-03-21 00:00:00,LABORABLE
21,3,2020,21,89,92,181,2020-03-21 20:00:00,2020-03-21 00:00:00,LABORABLE
21,3,2020,22,69,101,170,2020-03-21 21:00:00,2020-03-21 00:00:00,LABORABLE
21,3,2020,23,74,64,138,2020-03-21 22:00:00,2020-03-21 00:00:00,LABORABLE
21,3,2020,24,37,40,77,2020-03-21 23:00:00,2020-03-21 00:00:00,LABORABLE
22,3,2020,1,29,30,59,2020-03-22 00:00:00,2020-03-22 00:00:00,LABORABLE
22,3,2020,2,8,36,44,2020-03-22 01:00:00,2020-03-22 00:00:00,LABORABLE
22,3,2020,3,21,29,50,2020-03-22 02:00:00,2020-03-22 00:00:00,LABORABLE
22,3,2020,4,12,32,44,2020-03-22 03:00:00,2020-03-22 00:00:00,LABORABLE
22,3,2020,5,10,19,29,2020-03-22 04:00:00,2020-03-22 00:00:00,LABORABLE
22,3,2020,6,17,30,47,2020-03-22 05:00:00,2020-03-22 00:00:00,LABORABLE
22,3,2020,7,40,27,67,2020-03-22 06:00:00,2020-03-22 00:00:00,LABORABLE
22,3,2020,8,58,50,108,2020-03-22 07:00:00,2020-03-22 00:00:00,LABORABLE
22,3,2020,9,47,85,132,2020-03-22 08:00:00,2020-03-22 00:00:00,LABORABLE
22,3,2020,10,51,72,123,2020-03-22 09:00:00,2020-03-22 00:00:00,LABORABLE
22,3,2020,11,53,92,145,2020-03-22 10:00:00,2020-03-22 00:00:00,LABORABLE
22,3,2020,12,78,102,180,2020-03-22 11:00:00,2020-03-22 00:00:00,LABORABLE
22,3,2020,13,76,110,186,2020-03-22 12:00:00,2020-03-22 00:00:00,LABORABLE
22,3,2020,14,88,133,221,2020-03-22 13:00:00,2020-03-22 00:00:00,LABORABLE
22,3,2020,15,86,135,221,2020-03-22 14:00:00,2020-03-22 00:00:00,LABORABLE
22,3,2020,16,91,102,193,2020-03-22 15:00:00,2020-03-22 00:00:00,LABORABLE
22,3,2020,17,64,89,153,2020-03-22 16:00:00,2020-03-22 00:00:00,LABORABLE
22,3,2020,18,72,88,160,2020-03-22 17:00:00,2020-03-22 00:00:00,LABORABLE
22,3,2020,19,67,100,167,2020-03-22 18:00:00,2020-03-22 00:00:00,LABORABLE
22,3,2020,20,62,95,157,2020-03-22 19:00:00,2020-03-22 00:00:00,LABORABLE
22,3,2020,21,74,103,177,2020-03-22 20:00:00,2020-03-22 00:00:00,LABORABLE
22,3,2020,22,56,79,135,2020-03-22 21:00:00,2020-03-22 00:00:00,LABORABLE
22,3,2020,23,62,71,133,2020-03-22 22:00:00,2020-03-22 00:00:00,LABORABLE
22,3,2020,24,29,44,73,2020-03-22 23:00:00,2020-03-22 00:00:00,LABORABLE
23,3,2020,1,24,33,57,2020-03-23 00:00:00,2020-03-23 00:00:00,LABORABLE
23,3,2020,2,13,18,31,2020-03-23 01:00:00,2020-03-23 00:00:00,LABORABLE
23,3,2020,3,28,38,66,2020-03-23 02:00:00,2020-03-23 00:00:00,LABORABLE
23,3,2020,4,16,18,34,2020-03-23 03:00:00,2020-03-23 00:00:00,LABORABLE
23,3,2020,5,29,27,56,2020-03-23 04:00:00,2020-03-23 00:00:00,LABORABLE
23,3,2020,6,91,46,137,2020-03-23 05:00:00,2020-03-23 00:00:00,LABORABLE
23,3,2020,7,255,160,415,2020-03-23 06:00:00,2020-03-23 00:00:00,LABORABLE
23,3,2020,8,313,230,543,2020-03-23 07:00:00,2020-03-23 00:00:00,LABORABLE
23,3,2020,9,233,220,453,2020-03-23 08:00:00,2020-03-23 00:00:00,LABORABLE
23,3,2020,10,176,220,396,2020-03-23 09:00:00,2020-03-23 00:00:00,LABORABLE
23,3,2020,11,178,194,372,2020-03-23 10:00:00,2020-03-23 00:00:00,LABORABLE
23,3,2020,12,189,238,427,2020-03-23 11:00:00,2020-03-23 00:00:00,LABORABLE
23,3,2020,13,206,229,435,2020-03-23 12:00:00,2020-03-23 00:00:00,LABORABLE
23,3,2020,14,211,261,472,2020-03-23 13:00:00,2020-03-23 00:00:00,LABORABLE
23,3,2020,15,253,254,507,2020-03-23 14:00:00,2020-03-23 00:00:00,LABORABLE
23,3,2020,16,212,210,422,2020-03-23 15:00:00,2020-03-23 00:00:00,LABORABLE
23,3,2020,17,127,181,308,2020-03-23 16:00:00,2020-03-23 00:00:00,LABORABLE
23,3,2020,18,140,199,339,2020-03-23 17:00:00,2020-03-23 00:00:00,LABORABLE
23,3,2020,19,135,157,292,2020-03-23 18:00:00,2020-03-23 00:00:00,LABORABLE
23,3,2020,20,144,153,297,2020-03-23 19:00:00,2020-03-23 00:00:00,LABORABLE
23,3,2020,21,150,119,269,2020-03-23 20:00:00,2020-03-23 00:00:00,LABORABLE
23,3,2020,22,87,101,188,2020-03-23 21:00:00,2020-03-23 00:00:00,LABORABLE
23,3,2020,23,81,63,144,2020-03-23 22:00:00,2020-03-23 00:00:00,LABORABLE
23,3,2020,24,52,54,106,2020-03-23 23:00:00,2020-03-23 00:00:00,LABORABLE
24,3,2020,1,29,40,69,2020-03-24 00:00:00,2020-03-24 00:00:00,LABORABLE
24,3,2020,2,15,32,47,2020-03-24 01:00:00,2020-03-24 00:00:00,LABORABLE
24,3,2020,3,30,36,66,2020-03-24 02:00:00,2020-03-24 00:00:00,LABORABLE
24,3,2020,4,31,26,57,2020-03-24 03:00:00,2020-03-24 00:00:00,LABORABLE
24,3,2020,5,40,44,84,2020-03-24 04:00:00,2020-03-24 00:00:00,LABORABLE
24,3,2020,6,91,66,157,2020-03-24 05:00:00,2020-03-24 00:00:00,LABORABLE
24,3,2020,7,251,163,414,2020-03-24 06:00:00,2020-03-24 00:00:00,LABORABLE
24,3,2020,8,275,217,492,2020-03-24 07:00:00,2020-03-24 00:00:00,LABORABLE
24,3,2020,9,244,207,451,2020-03-24 08:00:00,2020-03-24 00:00:00,LABORABLE
24,3,2020,10,161,194,355,2020-03-24 09:00:00,2020-03-24 00:00:00,LABORABLE
24,3,2020,11,163,210,373,2020-03-24 10:00:00,2020-03-24 00:00:00,LABORABLE
24,3,2020,12,189,237,426,2020-03-24 11:00:00,2020-03-24 00:00:00,LABORABLE
24,3,2020,13,190,226,416,2020-03-24 12:00:00,2020-03-24 00:00:00,LABORABLE
24,3,2020,14,192,248,440,2020-03-24 13:00:00,2020-03-24 00:00:00,LABORABLE
24,3,2020,15,258,229,487,2020-03-24 14:00:00,2020-03-24 00:00:00,LABORABLE
24,3,2020,16,189,207,396,2020-03-24 15:00:00,2020-03-24 00:00:00,LABORABLE
24,3,2020,17,165,183,348,2020-03-24 16:00:00,2020-03-24 00:00:00,LABORABLE
24,3,2020,18,156,176,332,2020-03-24 17:00:00,2020-03-24 00:00:00,LABORABLE
24,3,2020,19,123,147,270,2020-03-24 18:00:00,2020-03-24 00:00:00,LABORABLE
24,3,2020,20,140,136,276,2020-03-24 19:00:00,2020-03-24 00:00:00,LABORABLE
24,3,2020,21,137,116,253,2020-03-24 20:00:00,2020-03-24 00:00:00,LABORABLE
24,3,2020,22,92,112,204,2020-03-24 21:00:00,2020-03-24 00:00:00,LABORABLE
24,3,2020,23,77,63,140,2020-03-24 22:00:00,2020-03-24 00:00:00,LABORABLE
24,3,2020,24,45,58,103,2020-03-24 23:00:00,2020-03-24 00:00:00,LABORABLE
25,3,2020,1,24,21,45,2020-03-25 00:00:00,2020-03-25 00:00:00,LABORABLE
25,3,2020,2,17,30,47,2020-03-25 01:00:00,2020-03-25 00:00:00,LABORABLE
25,3,2020,3,25,23,48,2020-03-25 02:00:00,2020-03-25 00:00:00,LABORABLE
25,3,2020,4,22,19,41,2020-03-25 03:00:00,2020-03-25 00:00:00,LABORABLE
25,3,2020,5,30,18,48,2020-03-25 04:00:00,2020-03-25 00:00:00,LABORABLE
25,3,2020,6,82,44,126,2020-03-25 05:00:00,2020-03-25 00:00:00,LABORABLE
25,3,2020,7,267,144,411,2020-03-25 06:00:00,2020-03-25 00:00:00,LABORABLE
25,3,2020,8,288,208,496,2020-03-25 07:00:00,2020-03-25 00:00:00,LABORABLE
25,3,2020,9,232,235,467,2020-03-25 08:00:00,2020-03-25 00:00:00,LABORABLE
25,3,2020,10,166,210,376,2020-03-25 09:00:00,2020-03-25 00:00:00,LABORABLE
25,3,2020,11,154,176,330,2020-03-25 10:00:00,2020-03-25 00:00:00,LABORABLE
25,3,2020,12,173,232,405,2020-03-25 11:00:00,2020-03-25 00:00:00,LABORABLE
25,3,2020,13,168,224,392,2020-03-25 12:00:00,2020-03-25 00:00:00,LABORABLE
25,3,2020,14,223,218,441,2020-03-25 13:00:00,2020-03-25 00:00:00,LABORABLE
25,3,2020,15,247,260,507,2020-03-25 14:00:00,2020-03-25 00:00:00,LABORABLE
25,3,2020,16,184,187,371,2020-03-25 15:00:00,2020-03-25 00:00:00,LABORABLE
25,3,2020,17,132,153,285,2020-03-25 16:00:00,2020-03-25 00:00:00,LABORABLE
25,3,2020,18,128,258,386,2020-03-25 17:00:00,2020-03-25 00:00:00,LABORABLE
25,3,2020,19,133,176,309,2020-03-25 18:00:00,2020-03-25 00:00:00,LABORABLE
25,3,2020,20,127,140,267,2020-03-25 19:00:00,2020-03-25 00:00:00,LABORABLE
25,3,2020,21,121,118,239,2020-03-25 20:00:00,2020-03-25 00:00:00,LABORABLE
25,3,2020,22,88,95,183,2020-03-25 21:00:00,2020-03-25 00:00:00,LABORABLE
25,3,2020,23,80,84,164,2020-03-25 22:00:00,2020-03-25 00:00:00,LABORABLE
25,3,2020,24,40,61,101,2020-03-25 23:00:00,2020-03-25 00:00:00,LABORABLE
26,3,2020,1,44,36,80,2020-03-26 00:00:00,2020-03-26 00:00:00,LABORABLE
26,3,2020,2,19,22,41,2020-03-26 01:00:00,2020-03-26 00:00:00,LABORABLE
26,3,2020,3,15,33,48,2020-03-26 02:00:00,2020-03-26 00:00:00,LABORABLE
26,3,2020,4,28,18,46,2020-03-26 03:00:00,2020-03-26 00:00:00,LABORABLE
26,3,2020,5,30,23,53,2020-03-26 04:00:00,2020-03-26 00:00:00,LABORABLE
26,3,2020,6,99,51,150,2020-03-26 05:00:00,2020-03-26 00:00:00,LABORABLE
26,3,2020,7,241,158,399,2020-03-26 06:00:00,2020-03-26 00:00:00,LABORABLE
26,3,2020,8,280,224,504,2020-03-26 07:00:00,2020-03-26 00:00:00,LABORABLE
26,3,2020,9,206,200,406,2020-03-26 08:00:00,2020-03-26 00:00:00,LABORABLE
26,3,2020,10,158,197,355,2020-03-26 09:00:00,2020-03-26 00:00:00,LABORABLE
26,3,2020,11,162,205,367,2020-03-26 10:00:00,2020-03-26 00:00:00,LABORABLE
26,3,2020,12,191,227,418,2020-03-26 11:00:00,2020-03-26 00:00:00,LABORABLE
26,3,2020,13,162,242,404,2020-03-26 12:00:00,2020-03-26 00:00:00,LABORABLE
26,3,2020,14,179,201,380,2020-03-26 13:00:00,2020-03-26 00:00:00,LABORABLE
26,3,2020,15,232,265,497,2020-03-26 14:00:00,2020-03-26 00:00:00,LABORABLE
26,3,2020,16,169,233,402,2020-03-26 15:00:00,2020-03-26 00:00:00,LABORABLE
26,3,2020,17,134,197,331,2020-03-26 16:00:00,2020-03-26 00:00:00,LABORABLE
26,3,2020,18,119,163,282,2020-03-26 17:00:00,2020-03-26 00:00:00,LABORABLE
26,3,2020,19,139,162,301,2020-03-26 18:00:00,2020-03-26 00:00:00,LABORABLE
26,3,2020,20,134,141,275,2020-03-26 19:00:00,2020-03-26 00:00:00,LABORABLE
26,3,2020,21,123,126,249,2020-03-26 20:00:00,2020-03-26 00:00:00,LABORABLE
26,3,2020,22,94,93,187,2020-03-26 21:00:00,2020-03-26 00:00:00,LABORABLE
26,3,2020,23,72,74,146,2020-03-26 22:00:00,2020-03-26 00:00:00,LABORABLE
26,3,2020,24,45,53,98,2020-03-26 23:00:00,2020-03-26 00:00:00,LABORABLE
27,3,2020,1,15,12,27,2020-03-27 00:00:00,2020-03-27 00:00:00,LABORABLE
27,3,2020,2,0,0,0,2020-03-27 01:00:00,2020-03-27 00:00:00,LABORABLE
27,3,2020,3,0,0,0,2020-03-27 02:00:00,2020-03-27 00:00:00,LABORABLE
27,3,2020,4,0,0,0,2020-03-27 03:00:00,2020-03-27 00:00:00,LABORABLE
27,3,2020,5,0,0,0,2020-03-27 04:00:00,2020-03-27 00:00:00,LABORABLE
27,3,2020,6,0,0,0,2020-03-27 05:00:00,2020-03-27 00:00:00,LABORABLE
27,3,2020,7,0,0,0,2020-03-27 06:00:00,2020-03-27 00:00:00,LABORABLE
27,3,2020,8,11,9,20,2020-03-27 07:00:00,2020-03-27 00:00:00,LABORABLE
27,3,2020,9,186,214,400,2020-03-27 08:00:00,2020-03-27 00:00:00,LABORABLE
27,3,2020,10,168,213,381,2020-03-27 09:00:00,2020-03-27 00:00:00,LABORABLE
27,3,2020,11,145,213,358,2020-03-27 10:00:00,2020-03-27 00:00:00,LABORABLE
27,3,2020,12,176,199,375,2020-03-27 11:00:00,2020-03-27 00:00:00,LABORABLE
27,3,2020,13,204,250,454,2020-03-27 12:00:00,2020-03-27 00:00:00,LABORABLE
27,3,2020,14,222,243,465,2020-03-27 13:00:00,2020-03-27 00:00:00,LABORABLE
27,3,2020,15,249,277,526,2020-03-27 14:00:00,2020-03-27 00:00:00,LABORABLE
27,3,2020,16,200,222,422,2020-03-27 15:00:00,2020-03-27 00:00:00,LABORABLE
27,3,2020,17,137,167,304,2020-03-27 16:00:00,2020-03-27 00:00:00,LABORABLE
27,3,2020,18,151,168,319,2020-03-27 17:00:00,2020-03-27 00:00:00,LABORABLE
27,3,2020,19,120,182,302,2020-03-27 18:00:00,2020-03-27 00:00:00,LABORABLE
27,3,2020,20,131,158,289,2020-03-27 19:00:00,2020-03-27 00:00:00,LABORABLE
27,3,2020,21,134,142,276,2020-03-27 20:00:00,2020-03-27 00:00:00,LABORABLE
27,3,2020,22,99,100,199,2020-03-27 21:00:00,2020-03-27 00:00:00,LABORABLE
27,3,2020,23,77,97,174,2020-03-27 22:00:00,2020-03-27 00:00:00,LABORABLE
27,3,2020,24,45,59,104,2020-03-27 23:00:00,2020-03-27 00:00:00,LABORABLE
28,3,2020,1,36,28,64,2020-03-28 00:00:00,2020-03-28 00:00:00,LABORABLE
28,3,2020,2,16,30,46,2020-03-28 01:00:00,2020-03-28 00:00:00,LABORABLE
28,3,2020,3,27,24,51,2020-03-28 02:00:00,2020-03-28 00:00:00,LABORABLE
28,3,2020,4,19,20,39,2020-03-28 03:00:00,2020-03-28 00:00:00,LABORABLE
28,3,2020,5,28,23,51,2020-03-28 04:00:00,2020-03-28 00:00:00,LABORABLE
28,3,2020,6,35,31,66,2020-03-28 05:00:00,2020-03-28 00:00:00,LABORABLE
28,3,2020,7,97,60,157,2020-03-28 06:00:00,2020-03-28 00:00:00,LABORABLE
28,3,2020,8,110,100,210,2020-03-28 07:00:00,2020-03-28 00:00:00,LABORABLE
28,3,2020,9,97,104,201,2020-03-28 08:00:00,2020-03-28 00:00:00,LABORABLE
28,3,2020,10,87,131,218,2020-03-28 09:00:00,2020-03-28 00:00:00,LABORABLE
28,3,2020,11,109,134,243,2020-03-28 10:00:00,2020-03-28 00:00:00,LABORABLE
28,3,2020,12,135,163,298,2020-03-28 11:00:00,2020-03-28 00:00:00,LABORABLE
28,3,2020,13,145,171,316,2020-03-28 12:00:00,2020-03-28 00:00:00,LABORABLE
28,3,2020,14,146,167,313,2020-03-28 13:00:00,2020-03-28 00:00:00,LABORABLE
28,3,2020,15,131,190,321,2020-03-28 14:00:00,2020-03-28 00:00:00,LABORABLE
28,3,2020,16,117,116,233,2020-03-28 15:00:00,2020-03-28 00:00:00,LABORABLE
28,3,2020,17,107,133,240,2020-03-28 16:00:00,2020-03-28 00:00:00,LABORABLE
28,3,2020,18,93,118,211,2020-03-28 17:00:00,2020-03-28 00:00:00,LABORABLE
28,3,2020,19,75,119,194,2020-03-28 18:00:00,2020-03-28 00:00:00,LABORABLE
28,3,2020,20,83,111,194,2020-03-28 19:00:00,2020-03-28 00:00:00,LABORABLE
28,3,2020,21,93,118,211,2020-03-28 20:00:00,2020-03-28 00:00:00,LABORABLE
28,3,2020,22,82,91,173,2020-03-28 21:00:00,2020-03-28 00:00:00,LABORABLE
28,3,2020,23,72,64,136,2020-03-28 22:00:00,2020-03-28 00:00:00,LABORABLE
28,3,2020,24,34,52,86,2020-03-28 23:00:00,2020-03-28 00:00:00,LABORABLE
29,3,2020,1,24,30,54,2020-03-29 00:00:00,2020-03-29 00:00:00,LABORABLE
29,3,2020,2,16,32,48,2020-03-29 01:00:00,2020-03-29 00:00:00,LABORABLE
29,3,2020,3,0,0,0,2020-03-29 02:00:00,2020-03-29 00:00:00,LABORABLE
29,3,2020,4,15,39,54,2020-03-29 03:00:00,2020-03-29 00:00:00,LABORABLE
29,3,2020,5,18,27,45,2020-03-29 04:00:00,2020-03-29 00:00:00,LABORABLE
29,3,2020,6,17,25,42,2020-03-29 05:00:00,2020-03-29 00:00:00,LABORABLE
29,3,2020,7,58,39,97,2020-03-29 06:00:00,2020-03-29 00:00:00,LABORABLE
29,3,2020,8,58,57,115,2020-03-29 07:00:00,2020-03-29 00:00:00,LABORABLE
29,3,2020,9,64,52,116,2020-03-29 08:00:00,2020-03-29 00:00:00,LABORABLE
29,3,2020,10,61,75,136,2020-03-29 09:00:00,2020-03-29 00:00:00,LABORABLE
29,3,2020,11,55,85,140,2020-03-29 10:00:00,2020-03-29 00:00:00,LABORABLE
29,3,2020,12,77,111,188,2020-03-29 11:00:00,2020-03-29 00:00:00,LABORABLE
29,3,2020,13,84,119,203,2020-03-29 12:00:00,2020-03-29 00:00:00,LABORABLE
29,3,2020,14,94,131,225,2020-03-29 13:00:00,2020-03-29 00:00:00,LABORABLE
29,3,2020,15,104,133,237,2020-03-29 14:00:00,2020-03-29 00:00:00,LABORABLE
29,3,2020,16,103,120,223,2020-03-29 15:00:00,2020-03-29 00:00:00,LABORABLE
29,3,2020,17,64,109,173,2020-03-29 16:00:00,2020-03-29 00:00:00,LABORABLE
29,3,2020,18,78,98,176,2020-03-29 17:00:00,2020-03-29 00:00:00,LABORABLE
29,3,2020,19,78,114,192,2020-03-29 18:00:00,2020-03-29 00:00:00,LABORABLE
29,3,2020,20,72,109,181,2020-03-29 19:00:00,2020-03-29 00:00:00,LABORABLE
29,3,2020,21,75,103,178,2020-03-29 20:00:00,2020-03-29 00:00:00,LABORABLE
29,3,2020,22,86,100,186,2020-03-29 21:00:00,2020-03-29 00:00:00,LABORABLE
29,3,2020,23,68,77,145,2020-03-29 22:00:00,2020-03-29 00:00:00,LABORABLE
29,3,2020,24,33,56,89,2020-03-29 23:00:00,2020-03-29 00:00:00,LABORABLE
30,3,2020,1,23,36,59,2020-03-30 00:00:00,2020-03-30 00:00:00,LABORABLE
30,3,2020,2,14,25,39,2020-03-30 01:00:00,2020-03-30 00:00:00,LABORABLE
30,3,2020,3,14,18,32,2020-03-30 02:00:00,2020-03-30 00:00:00,LABORABLE
30,3,2020,4,12,10,22,2020-03-30 03:00:00,2020-03-30 00:00:00,LABORABLE
30,3,2020,5,22,29,51,2020-03-30 04:00:00,2020-03-30 00:00:00,LABORABLE
30,3,2020,6,67,36,103,2020-03-30 05:00:00,2020-03-30 00:00:00,LABORABLE
30,3,2020,7,145,103,248,2020-03-30 06:00:00,2020-03-30 00:00:00,LABORABLE
30,3,2020,8,204,154,358,2020-03-30 07:00:00,2020-03-30 00:00:00,LABORABLE
30,3,2020,9,154,164,318,2020-03-30 08:00:00,2020-03-30 00:00:00,LABORABLE
30,3,2020,10,119,173,292,2020-03-30 09:00:00,2020-03-30 00:00:00,LABORABLE
30,3,2020,11,152,182,334,2020-03-30 10:00:00,2020-03-30 00:00:00,LABORABLE
30,3,2020,12,167,193,360,2020-03-30 11:00:00,2020-03-30 00:00:00,LABORABLE
30,3,2020,13,168,226,394,2020-03-30 12:00:00,2020-03-30 00:00:00,LABORABLE
30,3,2020,14,181,255,436,2020-03-30 13:00:00,2020-03-30 00:00:00,LABORABLE
30,3,2020,15,233,210,443,2020-03-30 14:00:00,2020-03-30 00:00:00,LABORABLE
30,3,2020,16,180,198,378,2020-03-30 15:00:00,2020-03-30 00:00:00,LABORABLE
30,3,2020,17,128,174,302,2020-03-30 16:00:00,2020-03-30 00:00:00,LABORABLE
30,3,2020,18,116,147,263,2020-03-30 17:00:00,2020-03-30 00:00:00,LABORABLE
30,3,2020,19,110,132,242,2020-03-30 18:00:00,2020-03-30 00:00:00,LABORABLE
30,3,2020,20,115,149,264,2020-03-30 19:00:00,2020-03-30 00:00:00,LABORABLE
30,3,2020,21,102,119,221,2020-03-30 20:00:00,2020-03-30 00:00:00,LABORABLE
30,3,2020,22,94,107,201,2020-03-30 21:00:00,2020-03-30 00:00:00,LABORABLE
30,3,2020,23,63,71,134,2020-03-30 22:00:00,2020-03-30 00:00:00,LABORABLE
30,3,2020,24,38,49,87,2020-03-30 23:00:00,2020-03-30 00:00:00,LABORABLE
31,3,2020,1,19,28,47,2020-03-31 00:00:00,2020-03-31 00:00:00,LABORABLE
31,3,2020,2,18,20,38,2020-03-31 01:00:00,2020-03-31 00:00:00,LABORABLE
31,3,2020,3,16,29,45,2020-03-31 02:00:00,2020-03-31 00:00:00,LABORABLE
31,3,2020,4,28,11,39,2020-03-31 03:00:00,2020-03-31 00:00:00,LABORABLE
31,3,2020,5,36,23,59,2020-03-31 04:00:00,2020-03-31 00:00:00,LABORABLE
31,3,2020,6,79,43,122,2020-03-31 05:00:00,2020-03-31 00:00:00,LABORABLE
31,3,2020,7,138,119,257,2020-03-31 06:00:00,2020-03-31 00:00:00,LABORABLE
31,3,2020,8,205,144,349,2020-03-31 07:00:00,2020-03-31 00:00:00,LABORABLE
31,3,2020,9,151,162,313,2020-03-31 08:00:00,2020-03-31 00:00:00,LABORABLE
31,3,2020,10,115,128,243,2020-03-31 09:00:00,2020-03-31 00:00:00,LABORABLE
31,3,2020,11,132,161,293,2020-03-31 10:00:00,2020-03-31 00:00:00,LABORABLE
31,3,2020,12,132,189,321,2020-03-31 11:00:00,2020-03-31 00:00:00,LABORABLE
31,3,2020,13,150,192,342,2020-03-31 12:00:00,2020-03-31 00:00:00,LABORABLE
31,3,2020,14,172,196,368,2020-03-31 13:00:00,2020-03-31 00:00:00,LABORABLE
31,3,2020,15,178,202,380,2020-03-31 14:00:00,2020-03-31 00:00:00,LABORABLE
31,3,2020,16,186,230,416,2020-03-31 15:00:00,2020-03-31 00:00:00,LABORABLE
31,3,2020,17,122,143,265,2020-03-31 16:00:00,2020-03-31 00:00:00,LABORABLE
31,3,2020,18,109,161,270,2020-03-31 17:00:00,2020-03-31 00:00:00,LABORABLE
31,3,2020,19,96,138,234,2020-03-31 18:00:00,2020-03-31 00:00:00,LABORABLE
31,3,2020,20,101,126,227,2020-03-31 19:00:00,2020-03-31 00:00:00,LABORABLE
31,3,2020,21,112,119,231,2020-03-31 20:00:00,2020-03-31 00:00:00,LABORABLE
31,3,2020,22,93,103,196,2020-03-31 21:00:00,2020-03-31 00:00:00,LABORABLE
31,3,2020,23,67,71,138,2020-03-31 22:00:00,2020-03-31 00:00:00,LABORABLE
31,3,2020,24,42,46,88,2020-03-31 23:00:00,2020-03-31 00:00:00,LABORABLE
1,4,2020,1,24,30,54,2020-04-01 00:00:00,2020-01-04 00:00:00,LABORABLE
1,4,2020,2,15,14,29,2020-04-01 01:00:00,2020-01-04 00:00:00,LABORABLE
1,4,2020,3,22,20,42,2020-04-01 02:00:00,2020-01-04 00:00:00,LABORABLE
1,4,2020,4,25,19,44,2020-04-01 03:00:00,2020-01-04 00:00:00,LABORABLE
1,4,2020,5,30,24,54,2020-04-01 04:00:00,2020-01-04 00:00:00,LABORABLE
1,4,2020,6,75,45,120,2020-04-01 05:00:00,2020-01-04 00:00:00,LABORABLE
1,4,2020,7,143,102,245,2020-04-01 06:00:00,2020-01-04 00:00:00,LABORABLE
1,4,2020,8,186,146,332,2020-04-01 07:00:00,2020-01-04 00:00:00,LABORABLE
1,4,2020,9,167,157,324,2020-04-01 08:00:00,2020-01-04 00:00:00,LABORABLE
1,4,2020,10,129,184,313,2020-04-01 09:00:00,2020-01-04 00:00:00,LABORABLE
1,4,2020,11,131,179,310,2020-04-01 10:00:00,2020-01-04 00:00:00,LABORABLE
1,4,2020,12,157,193,350,2020-04-01 11:00:00,2020-01-04 00:00:00,LABORABLE
1,4,2020,13,159,231,390,2020-04-01 12:00:00,2020-01-04 00:00:00,LABORABLE
1,4,2020,14,182,222,404,2020-04-01 13:00:00,2020-01-04 00:00:00,LABORABLE
1,4,2020,15,194,215,409,2020-04-01 14:00:00,2020-01-04 00:00:00,LABORABLE
1,4,2020,16,181,197,378,2020-04-01 15:00:00,2020-01-04 00:00:00,LABORABLE
1,4,2020,17,132,189,321,2020-04-01 16:00:00,2020-01-04 00:00:00,LABORABLE
1,4,2020,18,117,152,269,2020-04-01 17:00:00,2020-01-04 00:00:00,LABORABLE
1,4,2020,19,101,128,229,2020-04-01 18:00:00,2020-01-04 00:00:00,LABORABLE
1,4,2020,20,120,130,250,2020-04-01 19:00:00,2020-01-04 00:00:00,LABORABLE
1,4,2020,21,92,123,215,2020-04-01 20:00:00,2020-01-04 00:00:00,LABORABLE
1,4,2020,22,92,114,206,2020-04-01 21:00:00,2020-01-04 00:00:00,LABORABLE
1,4,2020,23,67,83,150,2020-04-01 22:00:00,2020-01-04 00:00:00,LABORABLE
1,4,2020,24,49,46,95,2020-04-01 23:00:00,2020-01-04 00:00:00,LABORABLE
2,4,2020,1,28,30,58,2020-04-02 00:00:00,2020-02-04 00:00:00,LABORABLE
2,4,2020,2,13,24,37,2020-04-02 01:00:00,2020-02-04 00:00:00,LABORABLE
2,4,2020,3,19,27,46,2020-04-02 02:00:00,2020-02-04 00:00:00,LABORABLE
2,4,2020,4,19,16,35,2020-04-02 03:00:00,2020-02-04 00:00:00,LABORABLE
2,4,2020,5,34,42,76,2020-04-02 04:00:00,2020-02-04 00:00:00,LABORABLE
2,4,2020,6,74,40,114,2020-04-02 05:00:00,2020-02-04 00:00:00,LABORABLE
2,4,2020,7,140,103,243,2020-04-02 06:00:00,2020-02-04 00:00:00,LABORABLE
2,4,2020,8,205,151,356,2020-04-02 07:00:00,2020-02-04 00:00:00,LABORABLE
2,4,2020,9,154,151,305,2020-04-02 08:00:00,2020-02-04 00:00:00,LABORABLE
2,4,2020,10,147,178,325,2020-04-02 09:00:00,2020-02-04 00:00:00,LABORABLE
2,4,2020,11,110,169,279,2020-04-02 10:00:00,2020-02-04 00:00:00,LABORABLE
2,4,2020,12,97,155,252,2020-04-02 11:00:00,2020-02-04 00:00:00,LABORABLE
2,4,2020,13,178,178,356,2020-04-02 12:00:00,2020-02-04 00:00:00,LABORABLE
2,4,2020,14,173,225,398,2020-04-02 13:00:00,2020-02-04 00:00:00,LABORABLE
2,4,2020,15,220,230,450,2020-04-02 14:00:00,2020-02-04 00:00:00,LABORABLE
2,4,2020,16,168,212,380,2020-04-02 15:00:00,2020-02-04 00:00:00,LABORABLE
2,4,2020,17,143,172,315,2020-04-02 16:00:00,2020-02-04 00:00:00,LABORABLE
2,4,2020,18,126,157,283,2020-04-02 17:00:00,2020-02-04 00:00:00,LABORABLE
2,4,2020,19,118,141,259,2020-04-02 18:00:00,2020-02-04 00:00:00,LABORABLE
2,4,2020,20,121,147,268,2020-04-02 19:00:00,2020-02-04 00:00:00,LABORABLE
2,4,2020,21,96,129,225,2020-04-02 20:00:00,2020-02-04 00:00:00,LABORABLE
2,4,2020,22,103,106,209,2020-04-02 21:00:00,2020-02-04 00:00:00,LABORABLE
2,4,2020,23,74,67,141,2020-04-02 22:00:00,2020-02-04 00:00:00,LABORABLE
2,4,2020,24,40,52,92,2020-04-02 23:00:00,2020-02-04 00:00:00,LABORABLE
3,4,2020,1,21,27,48,2020-04-03 00:00:00,2020-03-04 00:00:00,LABORABLE
3,4,2020,2,18,31,49,2020-04-03 01:00:00,2020-03-04 00:00:00,LABORABLE
3,4,2020,3,18,16,34,2020-04-03 02:00:00,2020-03-04 00:00:00,LABORABLE
3,4,2020,4,24,31,55,2020-04-03 03:00:00,2020-03-04 00:00:00,LABORABLE
3,4,2020,5,39,36,75,2020-04-03 04:00:00,2020-03-04 00:00:00,LABORABLE
3,4,2020,6,66,44,110,2020-04-03 05:00:00,2020-03-04 00:00:00,LABORABLE
3,4,2020,7,134,96,230,2020-04-03 06:00:00,2020-03-04 00:00:00,LABORABLE
3,4,2020,8,208,149,357,2020-04-03 07:00:00,2020-03-04 00:00:00,LABORABLE
3,4,2020,9,162,164,326,2020-04-03 08:00:00,2020-03-04 00:00:00,LABORABLE
3,4,2020,10,122,185,307,2020-04-03 09:00:00,2020-03-04 00:00:00,LABORABLE
3,4,2020,11,91,105,196,2020-04-03 10:00:00,2020-03-04 00:00:00,LABORABLE
3,4,2020,12,151,212,363,2020-04-03 11:00:00,2020-03-04 00:00:00,LABORABLE
3,4,2020,13,177,226,403,2020-04-03 12:00:00,2020-03-04 00:00:00,LABORABLE
3,4,2020,14,199,274,473,2020-04-03 13:00:00,2020-03-04 00:00:00,LABORABLE
3,4,2020,15,230,231,461,2020-04-03 14:00:00,2020-03-04 00:00:00,LABORABLE
3,4,2020,16,182,197,379,2020-04-03 15:00:00,2020-03-04 00:00:00,LABORABLE
3,4,2020,17,142,159,301,2020-04-03 16:00:00,2020-03-04 00:00:00,LABORABLE
3,4,2020,18,141,151,292,2020-04-03 17:00:00,2020-03-04 00:00:00,LABORABLE
3,4,2020,19,96,158,254,2020-04-03 18:00:00,2020-03-04 00:00:00,LABORABLE
3,4,2020,20,118,152,270,2020-04-03 19:00:00,2020-03-04 00:00:00,LABORABLE
3,4,2020,21,121,133,254,2020-04-03 20:00:00,2020-03-04 00:00:00,LABORABLE
3,4,2020,22,93,108,201,2020-04-03 21:00:00,2020-03-04 00:00:00,LABORABLE
3,4,2020,23,75,90,165,2020-04-03 22:00:00,2020-03-04 00:00:00,LABORABLE
3,4,2020,24,43,51,94,2020-04-03 23:00:00,2020-03-04 00:00:00,LABORABLE
4,4,2020,1,28,48,76,2020-04-04 00:00:00,2020-04-04 00:00:00,LABORABLE
4,4,2020,2,21,23,44,2020-04-04 01:00:00,2020-04-04 00:00:00,LABORABLE
4,4,2020,3,23,24,47,2020-04-04 02:00:00,2020-04-04 00:00:00,LABORABLE
4,4,2020,4,27,23,50,2020-04-04 03:00:00,2020-04-04 00:00:00,LABORABLE
4,4,2020,5,27,20,47,2020-04-04 04:00:00,2020-04-04 00:00:00,LABORABLE
4,4,2020,6,42,35,77,2020-04-04 05:00:00,2020-04-04 00:00:00,LABORABLE
4,4,2020,7,75,62,137,2020-04-04 06:00:00,2020-04-04 00:00:00,LABORABLE
4,4,2020,8,92,92,184,2020-04-04 07:00:00,2020-04-04 00:00:00,LABORABLE
4,4,2020,9,83,104,187,2020-04-04 08:00:00,2020-04-04 00:00:00,LABORABLE
4,4,2020,10,85,154,239,2020-04-04 09:00:00,2020-04-04 00:00:00,LABORABLE
4,4,2020,11,84,139,223,2020-04-04 10:00:00,2020-04-04 00:00:00,LABORABLE
4,4,2020,12,102,167,269,2020-04-04 11:00:00,2020-04-04 00:00:00,LABORABLE
4,4,2020,13,131,173,304,2020-04-04 12:00:00,2020-04-04 00:00:00,LABORABLE
4,4,2020,14,138,186,324,2020-04-04 13:00:00,2020-04-04 00:00:00,LABORABLE
4,4,2020,15,150,181,331,2020-04-04 14:00:00,2020-04-04 00:00:00,LABORABLE
4,4,2020,16,131,153,284,2020-04-04 15:00:00,2020-04-04 00:00:00,LABORABLE
4,4,2020,17,88,138,226,2020-04-04 16:00:00,2020-04-04 00:00:00,LABORABLE
4,4,2020,18,82,104,186,2020-04-04 17:00:00,2020-04-04 00:00:00,LABORABLE
4,4,2020,19,88,121,209,2020-04-04 18:00:00,2020-04-04 00:00:00,LABORABLE
4,4,2020,20,81,97,178,2020-04-04 19:00:00,2020-04-04 00:00:00,LABORABLE
4,4,2020,21,84,79,163,2020-04-04 20:00:00,2020-04-04 00:00:00,LABORABLE
4,4,2020,22,68,92,160,2020-04-04 21:00:00,2020-04-04 00:00:00,LABORABLE
4,4,2020,23,59,67,126,2020-04-04 22:00:00,2020-04-04 00:00:00,LABORABLE
4,4,2020,24,32,64,96,2020-04-04 23:00:00,2020-04-04 00:00:00,LABORABLE
5,4,2020,1,23,35,58,2020-04-05 00:00:00,2020-05-04 00:00:00,LABORABLE
5,4,2020,2,9,25,34,2020-04-05 01:00:00,2020-05-04 00:00:00,LABORABLE
5,4,2020,3,27,35,62,2020-04-05 02:00:00,2020-05-04 00:00:00,LABORABLE
5,4,2020,4,9,33,42,2020-04-05 03:00:00,2020-05-04 00:00:00,LABORABLE
5,4,2020,5,10,28,38,2020-04-05 04:00:00,2020-05-04 00:00:00,LABORABLE
5,4,2020,6,21,31,52,2020-04-05 05:00:00,2020-05-04 00:00:00,LABORABLE
5,4,2020,7,42,32,74,2020-04-05 06:00:00,2020-05-04 00:00:00,LABORABLE
5,4,2020,8,61,59,120,2020-04-05 07:00:00,2020-05-04 00:00:00,LABORABLE
5,4,2020,9,50,66,116,2020-04-05 08:00:00,2020-05-04 00:00:00,LABORABLE
5,4,2020,10,44,84,128,2020-04-05 09:00:00,2020-05-04 00:00:00,LABORABLE
5,4,2020,11,46,89,135,2020-04-05 10:00:00,2020-05-04 00:00:00,LABORABLE
5,4,2020,12,68,96,164,2020-04-05 11:00:00,2020-05-04 00:00:00,LABORABLE
5,4,2020,13,68,96,164,2020-04-05 12:00:00,2020-05-04 00:00:00,LABORABLE
5,4,2020,14,81,140,221,2020-04-05 13:00:00,2020-05-04 00:00:00,LABORABLE
5,4,2020,15,88,116,204,2020-04-05 14:00:00,2020-05-04 00:00:00,LABORABLE
5,4,2020,16,82,94,176,2020-04-05 15:00:00,2020-05-04 00:00:00,LABORABLE
5,4,2020,17,61,85,146,2020-04-05 16:00:00,2020-05-04 00:00:00,LABORABLE
5,4,2020,18,63,94,157,2020-04-05 17:00:00,2020-05-04 00:00:00,LABORABLE
5,4,2020,19,68,106,174,2020-04-05 18:00:00,2020-05-04 00:00:00,LABORABLE
5,4,2020,20,81,92,173,2020-04-05 19:00:00,2020-05-04 00:00:00,LABORABLE
5,4,2020,21,58,80,138,2020-04-05 20:00:00,2020-05-04 00:00:00,LABORABLE
5,4,2020,22,62,79,141,2020-04-05 21:00:00,2020-05-04 00:00:00,LABORABLE
5,4,2020,23,54,79,133,2020-04-05 22:00:00,2020-05-04 00:00:00,LABORABLE
5,4,2020,24,40,56,96,2020-04-05 23:00:00,2020-05-04 00:00:00,LABORABLE
6,4,2020,1,24,31,55,2020-04-06 00:00:00,2020-06-04 00:00:00,LABORABLE
6,4,2020,2,15,30,45,2020-04-06 01:00:00,2020-06-04 00:00:00,LABORABLE
6,4,2020,3,22,23,45,2020-04-06 02:00:00,2020-06-04 00:00:00,LABORABLE
6,4,2020,4,12,17,29,2020-04-06 03:00:00,2020-06-04 00:00:00,LABORABLE
6,4,2020,5,26,29,55,2020-04-06 04:00:00,2020-06-04 00:00:00,LABORABLE
6,4,2020,6,67,38,105,2020-04-06 05:00:00,2020-06-04 00:00:00,LABORABLE
6,4,2020,7,144,127,271,2020-04-06 06:00:00,2020-06-04 00:00:00,LABORABLE
6,4,2020,8,223,154,377,2020-04-06 07:00:00,2020-06-04 00:00:00,LABORABLE
6,4,2020,9,171,149,320,2020-04-06 08:00:00,2020-06-04 00:00:00,LABORABLE
6,4,2020,10,128,178,306,2020-04-06 09:00:00,2020-06-04 00:00:00,LABORABLE
6,4,2020,11,147,169,316,2020-04-06 10:00:00,2020-06-04 00:00:00,LABORABLE
6,4,2020,12,165,243,408,2020-04-06 11:00:00,2020-06-04 00:00:00,LABORABLE
6,4,2020,13,175,221,396,2020-04-06 12:00:00,2020-06-04 00:00:00,LABORABLE
6,4,2020,14,189,240,429,2020-04-06 13:00:00,2020-06-04 00:00:00,LABORABLE
6,4,2020,15,224,220,444,2020-04-06 14:00:00,2020-06-04 00:00:00,LABORABLE
6,4,2020,16,174,205,379,2020-04-06 15:00:00,2020-06-04 00:00:00,LABORABLE
6,4,2020,17,146,192,338,2020-04-06 16:00:00,2020-06-04 00:00:00,LABORABLE
6,4,2020,18,116,166,282,2020-04-06 17:00:00,2020-06-04 00:00:00,LABORABLE
6,4,2020,19,115,154,269,2020-04-06 18:00:00,2020-06-04 00:00:00,LABORABLE
6,4,2020,20,105,147,252,2020-04-06 19:00:00,2020-06-04 00:00:00,LABORABLE
6,4,2020,21,123,120,243,2020-04-06 20:00:00,2020-06-04 00:00:00,LABORABLE
6,4,2020,22,88,114,202,2020-04-06 21:00:00,2020-06-04 00:00:00,LABORABLE
6,4,2020,23,64,86,150,2020-04-06 22:00:00,2020-06-04 00:00:00,LABORABLE
6,4,2020,24,37,54,91,2020-04-06 23:00:00,2020-06-04 00:00:00,LABORABLE
7,4,2020,1,25,30,55,2020-04-07 00:00:00,2020-07-04 00:00:00,LABORABLE
7,4,2020,2,16,31,47,2020-04-07 01:00:00,2020-07-04 00:00:00,LABORABLE
7,4,2020,3,15,32,47,2020-04-07 02:00:00,2020-07-04 00:00:00,LABORABLE
7,4,2020,4,23,31,54,2020-04-07 03:00:00,2020-07-04 00:00:00,LABORABLE
7,4,2020,5,40,34,74,2020-04-07 04:00:00,2020-07-04 00:00:00,LABORABLE
7,4,2020,6,59,48,107,2020-04-07 05:00:00,2020-07-04 00:00:00,LABORABLE
7,4,2020,7,125,98,223,2020-04-07 06:00:00,2020-07-04 00:00:00,LABORABLE
7,4,2020,8,228,169,397,2020-04-07 07:00:00,2020-07-04 00:00:00,LABORABLE
7,4,2020,9,155,176,331,2020-04-07 08:00:00,2020-07-04 00:00:00,LABORABLE
7,4,2020,10,138,178,316,2020-04-07 09:00:00,2020-07-04 00:00:00,LABORABLE
7,4,2020,11,131,206,337,2020-04-07 10:00:00,2020-07-04 00:00:00,LABORABLE
7,4,2020,12,185,210,395,2020-04-07 11:00:00,2020-07-04 00:00:00,LABORABLE
7,4,2020,13,190,250,440,2020-04-07 12:00:00,2020-07-04 00:00:00,LABORABLE
7,4,2020,14,222,274,496,2020-04-07 13:00:00,2020-07-04 00:00:00,LABORABLE
7,4,2020,15,241,252,493,2020-04-07 14:00:00,2020-07-04 00:00:00,LABORABLE
7,4,2020,16,188,232,420,2020-04-07 15:00:00,2020-07-04 00:00:00,LABORABLE
7,4,2020,17,138,197,335,2020-04-07 16:00:00,2020-07-04 00:00:00,LABORABLE
7,4,2020,18,128,154,282,2020-04-07 17:00:00,2020-07-04 00:00:00,LABORABLE
7,4,2020,19,123,172,295,2020-04-07 18:00:00,2020-07-04 00:00:00,LABORABLE
7,4,2020,20,116,144,260,2020-04-07 19:00:00,2020-07-04 00:00:00,LABORABLE
7,4,2020,21,123,122,245,2020-04-07 20:00:00,2020-07-04 00:00:00,LABORABLE
7,4,2020,22,98,118,216,2020-04-07 21:00:00,2020-07-04 00:00:00,LABORABLE
7,4,2020,23,65,60,125,2020-04-07 22:00:00,2020-07-04 00:00:00,LABORABLE
7,4,2020,24,47,54,101,2020-04-07 23:00:00,2020-07-04 00:00:00,LABORABLE
8,4,2020,1,35,33,68,2020-04-08 00:00:00,2020-08-04 00:00:00,LABORABLE
8,4,2020,2,30,29,59,2020-04-08 01:00:00,2020-08-04 00:00:00,LABORABLE
8,4,2020,3,24,32,56,2020-04-08 02:00:00,2020-08-04 00:00:00,LABORABLE
8,4,2020,4,26,24,50,2020-04-08 03:00:00,2020-08-04 00:00:00,LABORABLE
8,4,2020,5,45,18,63,2020-04-08 04:00:00,2020-08-04 00:00:00,LABORABLE
8,4,2020,6,64,46,110,2020-04-08 05:00:00,2020-08-04 00:00:00,LABORABLE
8,4,2020,7,130,111,241,2020-04-08 06:00:00,2020-08-04 00:00:00,LABORABLE
8,4,2020,8,219,152,371,2020-04-08 07:00:00,2020-08-04 00:00:00,LABORABLE
8,4,2020,9,178,194,372,2020-04-08 08:00:00,2020-08-04 00:00:00,LABORABLE
8,4,2020,10,122,171,293,2020-04-08 09:00:00,2020-08-04 00:00:00,LABORABLE
8,4,2020,11,150,230,380,2020-04-08 10:00:00,2020-08-04 00:00:00,LABORABLE
8,4,2020,12,167,231,398,2020-04-08 11:00:00,2020-08-04 00:00:00,LABORABLE
8,4,2020,13,168,248,416,2020-04-08 12:00:00,2020-08-04 00:00:00,LABORABLE
8,4,2020,14,233,253,486,2020-04-08 13:00:00,2020-08-04 00:00:00,LABORABLE
8,4,2020,15,242,269,511,2020-04-08 14:00:00,2020-08-04 00:00:00,LABORABLE
8,4,2020,16,192,224,416,2020-04-08 15:00:00,2020-08-04 00:00:00,LABORABLE
8,4,2020,17,162,220,382,2020-04-08 16:00:00,2020-08-04 00:00:00,LABORABLE
8,4,2020,18,131,192,323,2020-04-08 17:00:00,2020-08-04 00:00:00,LABORABLE
8,4,2020,19,140,179,319,2020-04-08 18:00:00,2020-08-04 00:00:00,LABORABLE
8,4,2020,20,131,174,305,2020-04-08 19:00:00,2020-08-04 00:00:00,LABORABLE
8,4,2020,21,129,154,283,2020-04-08 20:00:00,2020-08-04 00:00:00,LABORABLE
8,4,2020,22,103,146,249,2020-04-08 21:00:00,2020-08-04 00:00:00,LABORABLE
8,4,2020,23,80,72,152,2020-04-08 22:00:00,2020-08-04 00:00:00,LABORABLE
8,4,2020,24,29,49,78,2020-04-08 23:00:00,2020-08-04 00:00:00,LABORABLE
9,4,2020,1,24,39,63,2020-04-09 00:00:00,2020-09-04 00:00:00,FESTIVO
9,4,2020,2,17,25,42,2020-04-09 01:00:00,2020-09-04 00:00:00,FESTIVO
9,4,2020,3,25,23,48,2020-04-09 02:00:00,2020-09-04 00:00:00,FESTIVO
9,4,2020,4,13,24,37,2020-04-09 03:00:00,2020-09-04 00:00:00,FESTIVO
9,4,2020,5,23,16,39,2020-04-09 04:00:00,2020-09-04 00:00:00,FESTIVO
9,4,2020,6,26,32,58,2020-04-09 05:00:00,2020-09-04 00:00:00,FESTIVO
9,4,2020,7,62,44,106,2020-04-09 06:00:00,2020-09-04 00:00:00,FESTIVO
9,4,2020,8,83,85,168,2020-04-09 07:00:00,2020-09-04 00:00:00,FESTIVO
9,4,2020,9,66,79,145,2020-04-09 08:00:00,2020-09-04 00:00:00,FESTIVO
9,4,2020,10,62,106,168,2020-04-09 09:00:00,2020-09-04 00:00:00,FESTIVO
9,4,2020,11,80,111,191,2020-04-09 10:00:00,2020-09-04 00:00:00,FESTIVO
9,4,2020,12,69,139,208,2020-04-09 11:00:00,2020-09-04 00:00:00,FESTIVO
9,4,2020,13,100,158,258,2020-04-09 12:00:00,2020-09-04 00:00:00,FESTIVO
9,4,2020,14,120,163,283,2020-04-09 13:00:00,2020-09-04 00:00:00,FESTIVO
9,4,2020,15,127,155,282,2020-04-09 14:00:00,2020-09-04 00:00:00,FESTIVO
9,4,2020,16,93,126,219,2020-04-09 15:00:00,2020-09-04 00:00:00,FESTIVO
9,4,2020,17,77,114,191,2020-04-09 16:00:00,2020-09-04 00:00:00,FESTIVO
9,4,2020,18,54,127,181,2020-04-09 17:00:00,2020-09-04 00:00:00,FESTIVO
9,4,2020,19,67,145,212,2020-04-09 18:00:00,2020-09-04 00:00:00,FESTIVO
9,4,2020,20,76,111,187,2020-04-09 19:00:00,2020-09-04 00:00:00,FESTIVO
9,4,2020,21,66,85,151,2020-04-09 20:00:00,2020-09-04 00:00:00,FESTIVO
9,4,2020,22,62,75,137,2020-04-09 21:00:00,2020-09-04 00:00:00,FESTIVO
9,4,2020,23,50,59,109,2020-04-09 22:00:00,2020-09-04 00:00:00,FESTIVO
9,4,2020,24,34,39,73,2020-04-09 23:00:00,2020-09-04 00:00:00,FESTIVO
10,4,2020,1,23,39,62,2020-04-10 00:00:00,2020-10-04 00:00:00,FESTIVO
10,4,2020,2,15,451,466,2020-04-10 01:00:00,2020-10-04 00:00:00,FESTIVO
10,4,2020,3,18,719,737,2020-04-10 02:00:00,2020-10-04 00:00:00,FESTIVO
10,4,2020,4,10,340,350,2020-04-10 03:00:00,2020-10-04 00:00:00,FESTIVO
10,4,2020,5,12,234,246,2020-04-10 04:00:00,2020-10-04 00:00:00,FESTIVO
10,4,2020,6,24,25,49,2020-04-10 05:00:00,2020-10-04 00:00:00,FESTIVO
10,4,2020,7,61,40,101,2020-04-10 06:00:00,2020-10-04 00:00:00,FESTIVO
10,4,2020,8,87,71,158,2020-04-10 07:00:00,2020-10-04 00:00:00,FESTIVO
10,4,2020,9,58,66,124,2020-04-10 08:00:00,2020-10-04 00:00:00,FESTIVO
10,4,2020,10,54,110,164,2020-04-10 09:00:00,2020-10-04 00:00:00,FESTIVO
10,4,2020,11,69,102,171,2020-04-10 10:00:00,2020-10-04 00:00:00,FESTIVO
10,4,2020,12,73,102,175,2020-04-10 11:00:00,2020-10-04 00:00:00,FESTIVO
10,4,2020,13,81,113,194,2020-04-10 12:00:00,2020-10-04 00:00:00,FESTIVO
10,4,2020,14,97,151,248,2020-04-10 13:00:00,2020-10-04 00:00:00,FESTIVO
10,4,2020,15,138,146,284,2020-04-10 14:00:00,2020-10-04 00:00:00,FESTIVO
10,4,2020,16,84,146,230,2020-04-10 15:00:00,2020-10-04 00:00:00,FESTIVO
10,4,2020,17,72,122,194,2020-04-10 16:00:00,2020-10-04 00:00:00,FESTIVO
10,4,2020,18,54,106,160,2020-04-10 17:00:00,2020-10-04 00:00:00,FESTIVO
10,4,2020,19,52,118,170,2020-04-10 18:00:00,2020-10-04 00:00:00,FESTIVO
10,4,2020,20,80,103,183,2020-04-10 19:00:00,2020-10-04 00:00:00,FESTIVO
10,4,2020,21,64,91,155,2020-04-10 20:00:00,2020-10-04 00:00:00,FESTIVO
10,4,2020,22,57,96,153,2020-04-10 21:00:00,2020-10-04 00:00:00,FESTIVO
10,4,2020,23,52,74,126,2020-04-10 22:00:00,2020-10-04 00:00:00,FESTIVO
10,4,2020,24,45,674,719,2020-04-10 23:00:00,2020-10-04 00:00:00,FESTIVO
11,4,2020,1,30,153,183,2020-04-11 00:00:00,2020-11-04 00:00:00,LABORABLE
11,4,2020,2,9,38,47,2020-04-11 01:00:00,2020-11-04 00:00:00,LABORABLE
11,4,2020,3,17,30,47,2020-04-11 02:00:00,2020-11-04 00:00:00,LABORABLE
11,4,2020,4,22,86,108,2020-04-11 03:00:00,2020-11-04 00:00:00,LABORABLE
11,4,2020,5,30,326,356,2020-04-11 04:00:00,2020-11-04 00:00:00,LABORABLE
11,4,2020,6,41,806,847,2020-04-11 05:00:00,2020-11-04 00:00:00,LABORABLE
11,4,2020,7,72,80,152,2020-04-11 06:00:00,2020-11-04 00:00:00,LABORABLE
11,4,2020,8,93,89,182,2020-04-11 07:00:00,2020-11-04 00:00:00,LABORABLE
11,4,2020,9,88,104,192,2020-04-11 08:00:00,2020-11-04 00:00:00,LABORABLE
11,4,2020,10,80,140,220,2020-04-11 09:00:00,2020-11-04 00:00:00,LABORABLE
11,4,2020,11,101,130,231,2020-04-11 10:00:00,2020-11-04 00:00:00,LABORABLE
11,4,2020,12,125,164,289,2020-04-11 11:00:00,2020-11-04 00:00:00,LABORABLE
11,4,2020,13,138,228,366,2020-04-11 12:00:00,2020-11-04 00:00:00,LABORABLE
11,4,2020,14,129,228,357,2020-04-11 13:00:00,2020-11-04 00:00:00,LABORABLE
11,4,2020,15,157,193,350,2020-04-11 14:00:00,2020-11-04 00:00:00,LABORABLE
11,4,2020,16,131,153,284,2020-04-11 15:00:00,2020-11-04 00:00:00,LABORABLE
11,4,2020,17,102,149,251,2020-04-11 16:00:00,2020-11-04 00:00:00,LABORABLE
11,4,2020,18,89,114,203,2020-04-11 17:00:00,2020-11-04 00:00:00,LABORABLE
11,4,2020,19,88,133,221,2020-04-11 18:00:00,2020-11-04 00:00:00,LABORABLE
11,4,2020,20,84,164,248,2020-04-11 19:00:00,2020-11-04 00:00:00,LABORABLE
11,4,2020,21,82,119,201,2020-04-11 20:00:00,2020-11-04 00:00:00,LABORABLE
11,4,2020,22,90,105,195,2020-04-11 21:00:00,2020-11-04 00:00:00,LABORABLE
11,4,2020,23,55,94,149,2020-04-11 22:00:00,2020-11-04 00:00:00,LABORABLE
11,4,2020,24,34,64,98,2020-04-11 23:00:00,2020-11-04 00:00:00,LABORABLE
12,4,2020,1,26,36,62,2020-04-12 00:00:00,2020-12-04 00:00:00,LABORABLE
12,4,2020,2,19,32,51,2020-04-12 01:00:00,2020-12-04 00:00:00,LABORABLE
12,4,2020,3,17,27,44,2020-04-12 02:00:00,2020-12-04 00:00:00,LABORABLE
12,4,2020,4,8,23,31,2020-04-12 03:00:00,2020-12-04 00:00:00,LABORABLE
12,4,2020,5,13,20,33,2020-04-12 04:00:00,2020-12-04 00:00:00,LABORABLE
12,4,2020,6,28,23,51,2020-04-12 05:00:00,2020-12-04 00:00:00,LABORABLE
12,4,2020,7,46,32,78,2020-04-12 06:00:00,2020-12-04 00:00:00,LABORABLE
12,4,2020,8,63,63,126,2020-04-12 07:00:00,2020-12-04 00:00:00,LABORABLE
12,4,2020,9,47,65,112,2020-04-12 08:00:00,2020-12-04 00:00:00,LABORABLE
12,4,2020,10,52,90,142,2020-04-12 09:00:00,2020-12-04 00:00:00,LABORABLE
12,4,2020,11,47,87,134,2020-04-12 10:00:00,2020-12-04 00:00:00,LABORABLE
12,4,2020,12,78,111,189,2020-04-12 11:00:00,2020-12-04 00:00:00,LABORABLE
12,4,2020,13,77,120,197,2020-04-12 12:00:00,2020-12-04 00:00:00,LABORABLE
12,4,2020,14,92,141,233,2020-04-12 13:00:00,2020-12-04 00:00:00,LABORABLE
12,4,2020,15,113,137,250,2020-04-12 14:00:00,2020-12-04 00:00:00,LABORABLE
12,4,2020,16,76,137,213,2020-04-12 15:00:00,2020-12-04 00:00:00,LABORABLE
12,4,2020,17,60,98,158,2020-04-12 16:00:00,2020-12-04 00:00:00,LABORABLE
12,4,2020,18,63,93,156,2020-04-12 17:00:00,2020-12-04 00:00:00,LABORABLE
12,4,2020,19,73,97,170,2020-04-12 18:00:00,2020-12-04 00:00:00,LABORABLE
12,4,2020,20,76,85,161,2020-04-12 19:00:00,2020-12-04 00:00:00,LABORABLE
12,4,2020,21,60,87,147,2020-04-12 20:00:00,2020-12-04 00:00:00,LABORABLE
12,4,2020,22,72,88,160,2020-04-12 21:00:00,2020-12-04 00:00:00,LABORABLE
12,4,2020,23,58,86,144,2020-04-12 22:00:00,2020-12-04 00:00:00,LABORABLE
12,4,2020,24,36,39,75,2020-04-12 23:00:00,2020-12-04 00:00:00,LABORABLE
13,4,2020,1,30,35,65,2020-04-13 00:00:00,2020-04-13 00:00:00,LABORABLE
13,4,2020,2,26,31,57,2020-04-13 01:00:00,2020-04-13 00:00:00,LABORABLE
13,4,2020,3,23,21,44,2020-04-13 02:00:00,2020-04-13 00:00:00,LABORABLE
13,4,2020,4,17,17,34,2020-04-13 03:00:00,2020-04-13 00:00:00,LABORABLE
13,4,2020,5,22,26,48,2020-04-13 04:00:00,2020-04-13 00:00:00,LABORABLE
13,4,2020,6,87,46,133,2020-04-13 05:00:00,2020-04-13 00:00:00,LABORABLE
13,4,2020,7,208,137,345,2020-04-13 06:00:00,2020-04-13 00:00:00,LABORABLE
13,4,2020,8,303,217,520,2020-04-13 07:00:00,2020-04-13 00:00:00,LABORABLE
13,4,2020,9,221,236,457,2020-04-13 08:00:00,2020-04-13 00:00:00,LABORABLE
13,4,2020,10,187,215,402,2020-04-13 09:00:00,2020-04-13 00:00:00,LABORABLE
13,4,2020,11,207,245,452,2020-04-13 10:00:00,2020-04-13 00:00:00,LABORABLE
13,4,2020,12,177,196,373,2020-04-13 11:00:00,2020-04-13 00:00:00,LABORABLE
13,4,2020,13,214,312,526,2020-04-13 12:00:00,2020-04-13 00:00:00,LABORABLE
13,4,2020,14,223,329,552,2020-04-13 13:00:00,2020-04-13 00:00:00,LABORABLE
13,4,2020,15,293,260,553,2020-04-13 14:00:00,2020-04-13 00:00:00,LABORABLE
13,4,2020,16,221,255,476,2020-04-13 15:00:00,2020-04-13 00:00:00,LABORABLE
13,4,2020,17,165,196,361,2020-04-13 16:00:00,2020-04-13 00:00:00,LABORABLE
13,4,2020,18,154,219,373,2020-04-13 17:00:00,2020-04-13 00:00:00,LABORABLE
13,4,2020,19,162,182,344,2020-04-13 18:00:00,2020-04-13 00:00:00,LABORABLE
13,4,2020,20,156,183,339,2020-04-13 19:00:00,2020-04-13 00:00:00,LABORABLE
13,4,2020,21,137,143,280,2020-04-13 20:00:00,2020-04-13 00:00:00,LABORABLE
13,4,2020,22,106,125,231,2020-04-13 21:00:00,2020-04-13 00:00:00,LABORABLE
13,4,2020,23,73,65,138,2020-04-13 22:00:00,2020-04-13 00:00:00,LABORABLE
13,4,2020,24,43,44,87,2020-04-13 23:00:00,2020-04-13 00:00:00,LABORABLE
14,4,2020,1,37,40,77,2020-04-14 00:00:00,2020-04-14 00:00:00,LABORABLE
14,4,2020,2,21,27,48,2020-04-14 01:00:00,2020-04-14 00:00:00,LABORABLE
14,4,2020,3,20,31,51,2020-04-14 02:00:00,2020-04-14 00:00:00,LABORABLE
14,4,2020,4,29,24,53,2020-04-14 03:00:00,2020-04-14 00:00:00,LABORABLE
14,4,2020,5,39,31,70,2020-04-14 04:00:00,2020-04-14 00:00:00,LABORABLE
14,4,2020,6,91,46,137,2020-04-14 05:00:00,2020-04-14 00:00:00,LABORABLE
14,4,2020,7,239,172,411,2020-04-14 06:00:00,2020-04-14 00:00:00,LABORABLE
14,4,2020,8,324,236,560,2020-04-14 07:00:00,2020-04-14 00:00:00,LABORABLE
14,4,2020,9,255,250,505,2020-04-14 08:00:00,2020-04-14 00:00:00,LABORABLE
14,4,2020,10,187,238,425,2020-04-14 09:00:00,2020-04-14 00:00:00,LABORABLE
14,4,2020,11,217,238,455,2020-04-14 10:00:00,2020-04-14 00:00:00,LABORABLE
14,4,2020,12,222,243,465,2020-04-14 11:00:00,2020-04-14 00:00:00,LABORABLE
14,4,2020,13,224,291,515,2020-04-14 12:00:00,2020-04-14 00:00:00,LABORABLE
14,4,2020,14,280,276,556,2020-04-14 13:00:00,2020-04-14 00:00:00,LABORABLE
14,4,2020,15,303,323,626,2020-04-14 14:00:00,2020-04-14 00:00:00,LABORABLE
14,4,2020,16,204,273,477,2020-04-14 15:00:00,2020-04-14 00:00:00,LABORABLE
14,4,2020,17,148,217,365,2020-04-14 16:00:00,2020-04-14 00:00:00,LABORABLE
14,4,2020,18,144,207,351,2020-04-14 17:00:00,2020-04-14 00:00:00,LABORABLE
14,4,2020,19,156,214,370,2020-04-14 18:00:00,2020-04-14 00:00:00,LABORABLE
14,4,2020,20,148,182,330,2020-04-14 19:00:00,2020-04-14 00:00:00,LABORABLE
14,4,2020,21,139,143,282,2020-04-14 20:00:00,2020-04-14 00:00:00,LABORABLE
14,4,2020,22,113,122,235,2020-04-14 21:00:00,2020-04-14 00:00:00,LABORABLE
14,4,2020,23,75,102,177,2020-04-14 22:00:00,2020-04-14 00:00:00,LABORABLE
14,4,2020,24,44,55,99,2020-04-14 23:00:00,2020-04-14 00:00:00,LABORABLE
15,4,2020,1,29,39,68,2020-04-15 00:00:00,2020-04-15 00:00:00,LABORABLE
15,4,2020,2,25,35,60,2020-04-15 01:00:00,2020-04-15 00:00:00,LABORABLE
15,4,2020,3,21,19,40,2020-04-15 02:00:00,2020-04-15 00:00:00,LABORABLE
15,4,2020,4,22,11,33,2020-04-15 03:00:00,2020-04-15 00:00:00,LABORABLE
15,4,2020,5,31,33,64,2020-04-15 04:00:00,2020-04-15 00:00:00,LABORABLE
15,4,2020,6,95,55,150,2020-04-15 05:00:00,2020-04-15 00:00:00,LABORABLE
15,4,2020,7,247,182,429,2020-04-15 06:00:00,2020-04-15 00:00:00,LABORABLE
15,4,2020,8,313,210,523,2020-04-15 07:00:00,2020-04-15 00:00:00,LABORABLE
15,4,2020,9,225,239,464,2020-04-15 08:00:00,2020-04-15 00:00:00,LABORABLE
15,4,2020,10,185,208,393,2020-04-15 09:00:00,2020-04-15 00:00:00,LABORABLE
15,4,2020,11,175,226,401,2020-04-15 10:00:00,2020-04-15 00:00:00,LABORABLE
15,4,2020,12,190,259,449,2020-04-15 11:00:00,2020-04-15 00:00:00,LABORABLE
15,4,2020,13,218,309,527,2020-04-15 12:00:00,2020-04-15 00:00:00,LABORABLE
15,4,2020,14,236,328,564,2020-04-15 13:00:00,2020-04-15 00:00:00,LABORABLE
15,4,2020,15,276,311,587,2020-04-15 14:00:00,2020-04-15 00:00:00,LABORABLE
15,4,2020,16,233,290,523,2020-04-15 15:00:00,2020-04-15 00:00:00,LABORABLE
15,4,2020,17,158,213,371,2020-04-15 16:00:00,2020-04-15 00:00:00,LABORABLE
15,4,2020,18,153,238,391,2020-04-15 17:00:00,2020-04-15 00:00:00,LABORABLE
15,4,2020,19,171,212,383,2020-04-15 18:00:00,2020-04-15 00:00:00,LABORABLE
15,4,2020,20,157,195,352,2020-04-15 19:00:00,2020-04-15 00:00:00,LABORABLE
15,4,2020,21,127,163,290,2020-04-15 20:00:00,2020-04-15 00:00:00,LABORABLE
15,4,2020,22,127,123,250,2020-04-15 21:00:00,2020-04-15 00:00:00,LABORABLE
15,4,2020,23,69,96,165,2020-04-15 22:00:00,2020-04-15 00:00:00,LABORABLE
15,4,2020,24,43,57,100,2020-04-15 23:00:00,2020-04-15 00:00:00,LABORABLE
16,4,2020,1,34,45,79,2020-04-16 00:00:00,2020-04-16 00:00:00,LABORABLE
16,4,2020,2,26,27,53,2020-04-16 01:00:00,2020-04-16 00:00:00,LABORABLE
16,4,2020,3,14,33,47,2020-04-16 02:00:00,2020-04-16 00:00:00,LABORABLE
16,4,2020,4,23,14,37,2020-04-16 03:00:00,2020-04-16 00:00:00,LABORABLE
16,4,2020,5,42,27,69,2020-04-16 04:00:00,2020-04-16 00:00:00,LABORABLE
16,4,2020,6,85,53,138,2020-04-16 05:00:00,2020-04-16 00:00:00,LABORABLE
16,4,2020,7,245,180,425,2020-04-16 06:00:00,2020-04-16 00:00:00,LABORABLE
16,4,2020,8,298,246,544,2020-04-16 07:00:00,2020-04-16 00:00:00,LABORABLE
16,4,2020,9,243,257,500,2020-04-16 08:00:00,2020-04-16 00:00:00,LABORABLE
16,4,2020,10,182,250,432,2020-04-16 09:00:00,2020-04-16 00:00:00,LABORABLE
16,4,2020,11,199,394,593,2020-04-16 10:00:00,2020-04-16 00:00:00,LABORABLE
16,4,2020,12,214,483,697,2020-04-16 11:00:00,2020-04-16 00:00:00,LABORABLE
16,4,2020,13,218,327,545,2020-04-16 12:00:00,2020-04-16 00:00:00,LABORABLE
16,4,2020,14,265,316,581,2020-04-16 13:00:00,2020-04-16 00:00:00,LABORABLE
16,4,2020,15,264,282,546,2020-04-16 14:00:00,2020-04-16 00:00:00,LABORABLE
16,4,2020,16,234,288,522,2020-04-16 15:00:00,2020-04-16 00:00:00,LABORABLE
16,4,2020,17,146,214,360,2020-04-16 16:00:00,2020-04-16 00:00:00,LABORABLE
16,4,2020,18,142,209,351,2020-04-16 17:00:00,2020-04-16 00:00:00,LABORABLE
16,4,2020,19,185,212,397,2020-04-16 18:00:00,2020-04-16 00:00:00,LABORABLE
16,4,2020,20,162,219,381,2020-04-16 19:00:00,2020-04-16 00:00:00,LABORABLE
16,4,2020,21,149,144,293,2020-04-16 20:00:00,2020-04-16 00:00:00,LABORABLE
16,4,2020,22,109,130,239,2020-04-16 21:00:00,2020-04-16 00:00:00,LABORABLE
16,4,2020,23,82,73,155,2020-04-16 22:00:00,2020-04-16 00:00:00,LABORABLE
16,4,2020,24,49,66,115,2020-04-16 23:00:00,2020-04-16 00:00:00,LABORABLE
17,4,2020,1,37,31,68,2020-04-17 00:00:00,2020-04-17 00:00:00,LABORABLE
17,4,2020,2,22,22,44,2020-04-17 01:00:00,2020-04-17 00:00:00,LABORABLE
17,4,2020,3,16,29,45,2020-04-17 02:00:00,2020-04-17 00:00:00,LABORABLE
17,4,2020,4,24,16,40,2020-04-17 03:00:00,2020-04-17 00:00:00,LABORABLE
17,4,2020,5,36,28,64,2020-04-17 04:00:00,2020-04-17 00:00:00,LABORABLE
17,4,2020,6,81,50,131,2020-04-17 05:00:00,2020-04-17 00:00:00,LABORABLE
17,4,2020,7,250,175,425,2020-04-17 06:00:00,2020-04-17 00:00:00,LABORABLE
17,4,2020,8,312,244,556,2020-04-17 07:00:00,2020-04-17 00:00:00,LABORABLE
17,4,2020,9,220,239,459,2020-04-17 08:00:00,2020-04-17 00:00:00,LABORABLE
17,4,2020,10,196,244,440,2020-04-17 09:00:00,2020-04-17 00:00:00,LABORABLE
17,4,2020,11,205,257,462,2020-04-17 10:00:00,2020-04-17 00:00:00,LABORABLE
17,4,2020,12,75,137,212,2020-04-17 11:00:00,2020-04-17 00:00:00,LABORABLE
17,4,2020,13,248,313,561,2020-04-17 12:00:00,2020-04-17 00:00:00,LABORABLE
17,4,2020,14,213,307,520,2020-04-17 13:00:00,2020-04-17 00:00:00,LABORABLE
17,4,2020,15,299,302,601,2020-04-17 14:00:00,2020-04-17 00:00:00,LABORABLE
17,4,2020,16,226,281,507,2020-04-17 15:00:00,2020-04-17 00:00:00,LABORABLE
17,4,2020,17,158,257,415,2020-04-17 16:00:00,2020-04-17 00:00:00,LABORABLE
17,4,2020,18,185,232,417,2020-04-17 17:00:00,2020-04-17 00:00:00,LABORABLE
17,4,2020,19,164,229,393,2020-04-17 18:00:00,2020-04-17 00:00:00,LABORABLE
17,4,2020,20,174,220,394,2020-04-17 19:00:00,2020-04-17 00:00:00,LABORABLE
17,4,2020,21,150,188,338,2020-04-17 20:00:00,2020-04-17 00:00:00,LABORABLE
17,4,2020,22,126,155,281,2020-04-17 21:00:00,2020-04-17 00:00:00,LABORABLE
17,4,2020,23,78,88,166,2020-04-17 22:00:00,2020-04-17 00:00:00,LABORABLE
17,4,2020,24,54,88,142,2020-04-17 23:00:00,2020-04-17 00:00:00,LABORABLE
18,4,2020,1,37,54,91,2020-04-18 00:00:00,2020-04-18 00:00:00,LABORABLE
18,4,2020,2,23,37,60,2020-04-18 01:00:00,2020-04-18 00:00:00,LABORABLE
18,4,2020,3,24,26,50,2020-04-18 02:00:00,2020-04-18 00:00:00,LABORABLE
18,4,2020,4,26,20,46,2020-04-18 03:00:00,2020-04-18 00:00:00,LABORABLE
18,4,2020,5,32,30,62,2020-04-18 04:00:00,2020-04-18 00:00:00,LABORABLE
18,4,2020,6,49,40,89,2020-04-18 05:00:00,2020-04-18 00:00:00,LABORABLE
18,4,2020,7,80,86,166,2020-04-18 06:00:00,2020-04-18 00:00:00,LABORABLE
18,4,2020,8,102,121,223,2020-04-18 07:00:00,2020-04-18 00:00:00,LABORABLE
18,4,2020,9,112,140,252,2020-04-18 08:00:00,2020-04-18 00:00:00,LABORABLE
18,4,2020,10,123,175,298,2020-04-18 09:00:00,2020-04-18 00:00:00,LABORABLE
18,4,2020,11,118,183,301,2020-04-18 10:00:00,2020-04-18 00:00:00,LABORABLE
18,4,2020,12,132,214,346,2020-04-18 11:00:00,2020-04-18 00:00:00,LABORABLE
18,4,2020,13,139,202,341,2020-04-18 12:00:00,2020-04-18 00:00:00,LABORABLE
18,4,2020,14,186,219,405,2020-04-18 13:00:00,2020-04-18 00:00:00,LABORABLE
18,4,2020,15,181,206,387,2020-04-18 14:00:00,2020-04-18 00:00:00,LABORABLE
18,4,2020,16,143,200,343,2020-04-18 15:00:00,2020-04-18 00:00:00,LABORABLE
18,4,2020,17,115,190,305,2020-04-18 16:00:00,2020-04-18 00:00:00,LABORABLE
18,4,2020,18,107,146,253,2020-04-18 17:00:00,2020-04-18 00:00:00,LABORABLE
18,4,2020,19,98,160,258,2020-04-18 18:00:00,2020-04-18 00:00:00,LABORABLE
18,4,2020,20,98,162,260,2020-04-18 19:00:00,2020-04-18 00:00:00,LABORABLE
18,4,2020,21,113,128,241,2020-04-18 20:00:00,2020-04-18 00:00:00,LABORABLE
18,4,2020,22,94,129,223,2020-04-18 21:00:00,2020-04-18 00:00:00,LABORABLE
18,4,2020,23,66,82,148,2020-04-18 22:00:00,2020-04-18 00:00:00,LABORABLE
18,4,2020,24,40,58,98,2020-04-18 23:00:00,2020-04-18 00:00:00,LABORABLE
19,4,2020,1,39,63,102,2020-04-19 00:00:00,2020-04-19 00:00:00,LABORABLE
19,4,2020,2,14,22,36,2020-04-19 01:00:00,2020-04-19 00:00:00,LABORABLE
19,4,2020,3,17,27,44,2020-04-19 02:00:00,2020-04-19 00:00:00,LABORABLE
19,4,2020,4,12,29,41,2020-04-19 03:00:00,2020-04-19 00:00:00,LABORABLE
19,4,2020,5,7,16,23,2020-04-19 04:00:00,2020-04-19 00:00:00,LABORABLE
19,4,2020,6,15,24,39,2020-04-19 05:00:00,2020-04-19 00:00:00,LABORABLE
19,4,2020,7,54,37,91,2020-04-19 06:00:00,2020-04-19 00:00:00,LABORABLE
19,4,2020,8,53,57,110,2020-04-19 07:00:00,2020-04-19 00:00:00,LABORABLE
19,4,2020,9,57,70,127,2020-04-19 08:00:00,2020-04-19 00:00:00,LABORABLE
19,4,2020,10,63,90,153,2020-04-19 09:00:00,2020-04-19 00:00:00,LABORABLE
19,4,2020,11,67,99,166,2020-04-19 10:00:00,2020-04-19 00:00:00,LABORABLE
19,4,2020,12,61,124,185,2020-04-19 11:00:00,2020-04-19 00:00:00,LABORABLE
19,4,2020,13,93,141,234,2020-04-19 12:00:00,2020-04-19 00:00:00,LABORABLE
19,4,2020,14,95,162,257,2020-04-19 13:00:00,2020-04-19 00:00:00,LABORABLE
19,4,2020,15,79,151,230,2020-04-19 14:00:00,2020-04-19 00:00:00,LABORABLE
19,4,2020,16,99,124,223,2020-04-19 15:00:00,2020-04-19 00:00:00,LABORABLE
19,4,2020,17,70,99,169,2020-04-19 16:00:00,2020-04-19 00:00:00,LABORABLE
19,4,2020,18,71,127,198,2020-04-19 17:00:00,2020-04-19 00:00:00,LABORABLE
19,4,2020,19,63,123,186,2020-04-19 18:00:00,2020-04-19 00:00:00,LABORABLE
19,4,2020,20,86,119,205,2020-04-19 19:00:00,2020-04-19 00:00:00,LABORABLE
19,4,2020,21,71,121,192,2020-04-19 20:00:00,2020-04-19 00:00:00,LABORABLE
19,4,2020,22,89,116,205,2020-04-19 21:00:00,2020-04-19 00:00:00,LABORABLE
19,4,2020,23,63,95,158,2020-04-19 22:00:00,2020-04-19 00:00:00,LABORABLE
19,4,2020,24,42,60,102,2020-04-19 23:00:00,2020-04-19 00:00:00,LABORABLE
20,4,2020,1,33,51,84,2020-04-20 00:00:00,2020-04-20 00:00:00,LABORABLE
20,4,2020,2,18,32,50,2020-04-20 01:00:00,2020-04-20 00:00:00,LABORABLE
20,4,2020,3,21,18,39,2020-04-20 02:00:00,2020-04-20 00:00:00,LABORABLE
20,4,2020,4,17,16,33,2020-04-20 03:00:00,2020-04-20 00:00:00,LABORABLE
20,4,2020,5,22,23,45,2020-04-20 04:00:00,2020-04-20 00:00:00,LABORABLE
20,4,2020,6,96,44,140,2020-04-20 05:00:00,2020-04-20 00:00:00,LABORABLE
20,4,2020,7,262,192,454,2020-04-20 06:00:00,2020-04-20 00:00:00,LABORABLE
20,4,2020,8,344,238,582,2020-04-20 07:00:00,2020-04-20 00:00:00,LABORABLE
20,4,2020,9,248,272,520,2020-04-20 08:00:00,2020-04-20 00:00:00,LABORABLE
20,4,2020,10,207,226,433,2020-04-20 09:00:00,2020-04-20 00:00:00,LABORABLE
20,4,2020,11,173,235,408,2020-04-20 10:00:00,2020-04-20 00:00:00,LABORABLE
20,4,2020,12,233,286,519,2020-04-20 11:00:00,2020-04-20 00:00:00,LABORABLE
20,4,2020,13,223,329,552,2020-04-20 12:00:00,2020-04-20 00:00:00,LABORABLE
20,4,2020,14,260,317,577,2020-04-20 13:00:00,2020-04-20 00:00:00,LABORABLE
20,4,2020,15,306,307,613,2020-04-20 14:00:00,2020-04-20 00:00:00,LABORABLE
20,4,2020,16,236,315,551,2020-04-20 15:00:00,2020-04-20 00:00:00,LABORABLE
20,4,2020,17,199,242,441,2020-04-20 16:00:00,2020-04-20 00:00:00,LABORABLE
20,4,2020,18,160,223,383,2020-04-20 17:00:00,2020-04-20 00:00:00,LABORABLE
20,4,2020,19,183,232,415,2020-04-20 18:00:00,2020-04-20 00:00:00,LABORABLE
20,4,2020,20,160,203,363,2020-04-20 19:00:00,2020-04-20 00:00:00,LABORABLE
20,4,2020,21,132,144,276,2020-04-20 20:00:00,2020-04-20 00:00:00,LABORABLE
20,4,2020,22,124,145,269,2020-04-20 21:00:00,2020-04-20 00:00:00,LABORABLE
20,4,2020,23,80,87,167,2020-04-20 22:00:00,2020-04-20 00:00:00,LABORABLE
20,4,2020,24,42,53,95,2020-04-20 23:00:00,2020-04-20 00:00:00,LABORABLE
21,4,2020,1,28,45,73,2020-04-21 00:00:00,2020-04-21 00:00:00,LABORABLE
21,4,2020,2,14,27,41,2020-04-21 01:00:00,2020-04-21 00:00:00,LABORABLE
21,4,2020,3,18,22,40,2020-04-21 02:00:00,2020-04-21 00:00:00,LABORABLE
21,4,2020,4,28,22,50,2020-04-21 03:00:00,2020-04-21 00:00:00,LABORABLE
21,4,2020,5,32,31,63,2020-04-21 04:00:00,2020-04-21 00:00:00,LABORABLE
21,4,2020,6,112,51,163,2020-04-21 05:00:00,2020-04-21 00:00:00,LABORABLE
21,4,2020,7,261,216,477,2020-04-21 06:00:00,2020-04-21 00:00:00,LABORABLE
21,4,2020,8,320,254,574,2020-04-21 07:00:00,2020-04-21 00:00:00,LABORABLE
21,4,2020,9,249,255,504,2020-04-21 08:00:00,2020-04-21 00:00:00,LABORABLE
21,4,2020,10,209,246,455,2020-04-21 09:00:00,2020-04-21 00:00:00,LABORABLE
21,4,2020,11,173,261,434,2020-04-21 10:00:00,2020-04-21 00:00:00,LABORABLE
21,4,2020,12,215,287,502,2020-04-21 11:00:00,2020-04-21 00:00:00,LABORABLE
21,4,2020,13,236,315,551,2020-04-21 12:00:00,2020-04-21 00:00:00,LABORABLE
21,4,2020,14,249,312,561,2020-04-21 13:00:00,2020-04-21 00:00:00,LABORABLE
21,4,2020,15,292,312,604,2020-04-21 14:00:00,2020-04-21 00:00:00,LABORABLE
21,4,2020,16,224,277,501,2020-04-21 15:00:00,2020-04-21 00:00:00,LABORABLE
21,4,2020,17,167,249,416,2020-04-21 16:00:00,2020-04-21 00:00:00,LABORABLE
21,4,2020,18,166,213,379,2020-04-21 17:00:00,2020-04-21 00:00:00,LABORABLE
21,4,2020,19,206,217,423,2020-04-21 18:00:00,2020-04-21 00:00:00,LABORABLE
21,4,2020,20,165,181,346,2020-04-21 19:00:00,2020-04-21 00:00:00,LABORABLE
21,4,2020,21,133,130,263,2020-04-21 20:00:00,2020-04-21 00:00:00,LABORABLE
21,4,2020,22,117,128,245,2020-04-21 21:00:00,2020-04-21 00:00:00,LABORABLE
21,4,2020,23,82,83,165,2020-04-21 22:00:00,2020-04-21 00:00:00,LABORABLE
21,4,2020,24,51,57,108,2020-04-21 23:00:00,2020-04-21 00:00:00,LABORABLE
22,4,2020,1,26,42,68,2020-04-22 00:00:00,2020-04-22 00:00:00,LABORABLE
22,4,2020,2,20,20,40,2020-04-22 01:00:00,2020-04-22 00:00:00,LABORABLE
22,4,2020,3,21,25,46,2020-04-22 02:00:00,2020-04-22 00:00:00,LABORABLE
22,4,2020,4,30,16,46,2020-04-22 03:00:00,2020-04-22 00:00:00,LABORABLE
22,4,2020,5,40,39,79,2020-04-22 04:00:00,2020-04-22 00:00:00,LABORABLE
22,4,2020,6,118,56,174,2020-04-22 05:00:00,2020-04-22 00:00:00,LABORABLE
22,4,2020,7,263,193,456,2020-04-22 06:00:00,2020-04-22 00:00:00,LABORABLE
22,4,2020,8,342,269,611,2020-04-22 07:00:00,2020-04-22 00:00:00,LABORABLE
22,4,2020,9,235,264,499,2020-04-22 08:00:00,2020-04-22 00:00:00,LABORABLE
22,4,2020,10,184,232,416,2020-04-22 09:00:00,2020-04-22 00:00:00,LABORABLE
22,4,2020,11,147,212,359,2020-04-22 10:00:00,2020-04-22 00:00:00,LABORABLE
22,4,2020,12,204,304,508,2020-04-22 11:00:00,2020-04-22 00:00:00,LABORABLE
22,4,2020,13,229,306,535,2020-04-22 12:00:00,2020-04-22 00:00:00,LABORABLE
22,4,2020,14,256,282,538,2020-04-22 13:00:00,2020-04-22 00:00:00,LABORABLE
22,4,2020,15,281,336,617,2020-04-22 14:00:00,2020-04-22 00:00:00,LABORABLE
22,4,2020,16,226,276,502,2020-04-22 15:00:00,2020-04-22 00:00:00,LABORABLE
22,4,2020,17,158,247,405,2020-04-22 16:00:00,2020-04-22 00:00:00,LABORABLE
22,4,2020,18,180,231,411,2020-04-22 17:00:00,2020-04-22 00:00:00,LABORABLE
22,4,2020,19,184,209,393,2020-04-22 18:00:00,2020-04-22 00:00:00,LABORABLE
22,4,2020,20,186,220,406,2020-04-22 19:00:00,2020-04-22 00:00:00,LABORABLE
22,4,2020,21,149,149,298,2020-04-22 20:00:00,2020-04-22 00:00:00,LABORABLE
22,4,2020,22,114,136,250,2020-04-22 21:00:00,2020-04-22 00:00:00,LABORABLE
22,4,2020,23,60,88,148,2020-04-22 22:00:00,2020-04-22 00:00:00,LABORABLE
22,4,2020,24,47,62,109,2020-04-22 23:00:00,2020-04-22 00:00:00,LABORABLE
23,4,2020,1,29,38,67,2020-04-23 00:00:00,2020-04-23 00:00:00,LABORABLE
23,4,2020,2,16,36,52,2020-04-23 01:00:00,2020-04-23 00:00:00,LABORABLE
23,4,2020,3,20,44,64,2020-04-23 02:00:00,2020-04-23 00:00:00,LABORABLE
23,4,2020,4,24,31,55,2020-04-23 03:00:00,2020-04-23 00:00:00,LABORABLE
23,4,2020,5,39,36,75,2020-04-23 04:00:00,2020-04-23 00:00:00,LABORABLE
23,4,2020,6,93,57,150,2020-04-23 05:00:00,2020-04-23 00:00:00,LABORABLE
23,4,2020,7,268,202,470,2020-04-23 06:00:00,2020-04-23 00:00:00,LABORABLE
23,4,2020,8,308,252,560,2020-04-23 07:00:00,2020-04-23 00:00:00,LABORABLE
23,4,2020,9,251,264,515,2020-04-23 08:00:00,2020-04-23 00:00:00,LABORABLE
23,4,2020,10,194,238,432,2020-04-23 09:00:00,2020-04-23 00:00:00,LABORABLE
23,4,2020,11,187,273,460,2020-04-23 10:00:00,2020-04-23 00:00:00,LABORABLE
23,4,2020,12,227,279,506,2020-04-23 11:00:00,2020-04-23 00:00:00,LABORABLE
23,4,2020,13,244,309,553,2020-04-23 12:00:00,2020-04-23 00:00:00,LABORABLE
23,4,2020,14,265,295,560,2020-04-23 13:00:00,2020-04-23 00:00:00,LABORABLE
23,4,2020,15,299,336,635,2020-04-23 14:00:00,2020-04-23 00:00:00,LABORABLE
23,4,2020,16,228,325,553,2020-04-23 15:00:00,2020-04-23 00:00:00,LABORABLE
23,4,2020,17,151,219,370,2020-04-23 16:00:00,2020-04-23 00:00:00,LABORABLE
23,4,2020,18,170,200,370,2020-04-23 17:00:00,2020-04-23 00:00:00,LABORABLE
23,4,2020,19,199,202,401,2020-04-23 18:00:00,2020-04-23 00:00:00,LABORABLE
23,4,2020,20,155,191,346,2020-04-23 19:00:00,2020-04-23 00:00:00,LABORABLE
23,4,2020,21,154,167,321,2020-04-23 20:00:00,2020-04-23 00:00:00,LABORABLE
23,4,2020,22,100,132,232,2020-04-23 21:00:00,2020-04-23 00:00:00,LABORABLE
23,4,2020,23,80,85,165,2020-04-23 22:00:00,2020-04-23 00:00:00,LABORABLE
23,4,2020,24,58,48,106,2020-04-23 23:00:00,2020-04-23 00:00:00,LABORABLE
24,4,2020,1,31,44,75,2020-04-24 00:00:00,2020-04-24 00:00:00,LABORABLE
24,4,2020,2,20,37,57,2020-04-24 01:00:00,2020-04-24 00:00:00,LABORABLE
24,4,2020,3,22,21,43,2020-04-24 02:00:00,2020-04-24 00:00:00,LABORABLE
24,4,2020,4,29,30,59,2020-04-24 03:00:00,2020-04-24 00:00:00,LABORABLE
24,4,2020,5,39,28,67,2020-04-24 04:00:00,2020-04-24 00:00:00,LABORABLE
24,4,2020,6,111,63,174,2020-04-24 05:00:00,2020-04-24 00:00:00,LABORABLE
24,4,2020,7,295,186,481,2020-04-24 06:00:00,2020-04-24 00:00:00,LABORABLE
24,4,2020,8,324,263,587,2020-04-24 07:00:00,2020-04-24 00:00:00,LABORABLE
24,4,2020,9,234,257,491,2020-04-24 08:00:00,2020-04-24 00:00:00,LABORABLE
24,4,2020,10,196,250,446,2020-04-24 09:00:00,2020-04-24 00:00:00,LABORABLE
24,4,2020,11,195,285,480,2020-04-24 10:00:00,2020-04-24 00:00:00,LABORABLE
24,4,2020,12,232,284,516,2020-04-24 11:00:00,2020-04-24 00:00:00,LABORABLE
24,4,2020,13,255,337,592,2020-04-24 12:00:00,2020-04-24 00:00:00,LABORABLE
24,4,2020,14,270,304,574,2020-04-24 13:00:00,2020-04-24 00:00:00,LABORABLE
24,4,2020,15,175,182,357,2020-04-24 14:00:00,2020-04-24 00:00:00,LABORABLE
24,4,2020,16,262,303,565,2020-04-24 15:00:00,2020-04-24 00:00:00,LABORABLE
24,4,2020,17,180,284,464,2020-04-24 16:00:00,2020-04-24 00:00:00,LABORABLE
24,4,2020,18,199,246,445,2020-04-24 17:00:00,2020-04-24 00:00:00,LABORABLE
24,4,2020,19,186,218,404,2020-04-24 18:00:00,2020-04-24 00:00:00,LABORABLE
24,4,2020,20,151,250,401,2020-04-24 19:00:00,2020-04-24 00:00:00,LABORABLE
24,4,2020,21,151,194,345,2020-04-24 20:00:00,2020-04-24 00:00:00,LABORABLE
24,4,2020,22,132,138,270,2020-04-24 21:00:00,2020-04-24 00:00:00,LABORABLE
24,4,2020,23,80,124,204,2020-04-24 22:00:00,2020-04-24 00:00:00,LABORABLE
24,4,2020,24,59,69,128,2020-04-24 23:00:00,2020-04-24 00:00:00,LABORABLE
25,4,2020,1,35,52,87,2020-04-25 00:00:00,2020-04-25 00:00:00,LABORABLE
25,4,2020,2,21,40,61,2020-04-25 01:00:00,2020-04-25 00:00:00,LABORABLE
25,4,2020,3,25,32,57,2020-04-25 02:00:00,2020-04-25 00:00:00,LABORABLE
25,4,2020,4,25,27,52,2020-04-25 03:00:00,2020-04-25 00:00:00,LABORABLE
25,4,2020,5,22,29,51,2020-04-25 04:00:00,2020-04-25 00:00:00,LABORABLE
25,4,2020,6,56,35,91,2020-04-25 05:00:00,2020-04-25 00:00:00,LABORABLE
25,4,2020,7,104,102,206,2020-04-25 06:00:00,2020-04-25 00:00:00,LABORABLE
25,4,2020,8,130,141,271,2020-04-25 07:00:00,2020-04-25 00:00:00,LABORABLE
25,4,2020,9,97,128,225,2020-04-25 08:00:00,2020-04-25 00:00:00,LABORABLE
25,4,2020,10,110,197,307,2020-04-25 09:00:00,2020-04-25 00:00:00,LABORABLE
25,4,2020,11,130,170,300,2020-04-25 10:00:00,2020-04-25 00:00:00,LABORABLE
25,4,2020,12,126,214,340,2020-04-25 11:00:00,2020-04-25 00:00:00,LABORABLE
25,4,2020,13,177,225,402,2020-04-25 12:00:00,2020-04-25 00:00:00,LABORABLE
25,4,2020,14,160,256,416,2020-04-25 13:00:00,2020-04-25 00:00:00,LABORABLE
25,4,2020,15,197,246,443,2020-04-25 14:00:00,2020-04-25 00:00:00,LABORABLE
25,4,2020,16,170,253,423,2020-04-25 15:00:00,2020-04-25 00:00:00,LABORABLE
25,4,2020,17,112,163,275,2020-04-25 16:00:00,2020-04-25 00:00:00,LABORABLE
25,4,2020,18,102,185,287,2020-04-25 17:00:00,2020-04-25 00:00:00,LABORABLE
25,4,2020,19,101,200,301,2020-04-25 18:00:00,2020-04-25 00:00:00,LABORABLE
25,4,2020,20,107,174,281,2020-04-25 19:00:00,2020-04-25 00:00:00,LABORABLE
25,4,2020,21,102,143,245,2020-04-25 20:00:00,2020-04-25 00:00:00,LABORABLE
25,4,2020,22,106,130,236,2020-04-25 21:00:00,2020-04-25 00:00:00,LABORABLE
25,4,2020,23,72,95,167,2020-04-25 22:00:00,2020-04-25 00:00:00,LABORABLE
25,4,2020,24,49,50,99,2020-04-25 23:00:00,2020-04-25 00:00:00,LABORABLE
26,4,2020,1,32,50,82,2020-04-26 00:00:00,2020-04-26 00:00:00,LABORABLE
26,4,2020,2,22,35,57,2020-04-26 01:00:00,2020-04-26 00:00:00,LABORABLE
26,4,2020,3,22,37,59,2020-04-26 02:00:00,2020-04-26 00:00:00,LABORABLE
26,4,2020,4,13,20,33,2020-04-26 03:00:00,2020-04-26 00:00:00,LABORABLE
26,4,2020,5,7,37,44,2020-04-26 04:00:00,2020-04-26 00:00:00,LABORABLE
26,4,2020,6,29,24,53,2020-04-26 05:00:00,2020-04-26 00:00:00,LABORABLE
26,4,2020,7,49,44,93,2020-04-26 06:00:00,2020-04-26 00:00:00,LABORABLE
26,4,2020,8,69,66,135,2020-04-26 07:00:00,2020-04-26 00:00:00,LABORABLE
26,4,2020,9,59,77,136,2020-04-26 08:00:00,2020-04-26 00:00:00,LABORABLE
26,4,2020,10,72,120,192,2020-04-26 09:00:00,2020-04-26 00:00:00,LABORABLE
26,4,2020,11,64,121,185,2020-04-26 10:00:00,2020-04-26 00:00:00,LABORABLE
26,4,2020,12,104,165,269,2020-04-26 11:00:00,2020-04-26 00:00:00,LABORABLE
26,4,2020,13,105,154,259,2020-04-26 12:00:00,2020-04-26 00:00:00,LABORABLE
26,4,2020,14,120,205,325,2020-04-26 13:00:00,2020-04-26 00:00:00,LABORABLE
26,4,2020,15,142,159,301,2020-04-26 14:00:00,2020-04-26 00:00:00,LABORABLE
26,4,2020,16,112,128,240,2020-04-26 15:00:00,2020-04-26 00:00:00,LABORABLE
26,4,2020,17,99,122,221,2020-04-26 16:00:00,2020-04-26 00:00:00,LABORABLE
26,4,2020,18,81,138,219,2020-04-26 17:00:00,2020-04-26 00:00:00,LABORABLE
26,4,2020,19,78,132,210,2020-04-26 18:00:00,2020-04-26 00:00:00,LABORABLE
26,4,2020,20,101,141,242,2020-04-26 19:00:00,2020-04-26 00:00:00,LABORABLE
26,4,2020,21,105,142,247,2020-04-26 20:00:00,2020-04-26 00:00:00,LABORABLE
26,4,2020,22,108,111,219,2020-04-26 21:00:00,2020-04-26 00:00:00,LABORABLE
26,4,2020,23,62,90,152,2020-04-26 22:00:00,2020-04-26 00:00:00,LABORABLE
26,4,2020,24,44,56,100,2020-04-26 23:00:00,2020-04-26 00:00:00,LABORABLE
27,4,2020,1,32,45,77,2020-04-27 00:00:00,2020-04-27 00:00:00,LABORABLE
27,4,2020,2,21,29,50,2020-04-27 01:00:00,2020-04-27 00:00:00,LABORABLE
27,4,2020,3,18,39,57,2020-04-27 02:00:00,2020-04-27 00:00:00,LABORABLE
27,4,2020,4,24,18,42,2020-04-27 03:00:00,2020-04-27 00:00:00,LABORABLE
27,4,2020,5,29,28,57,2020-04-27 04:00:00,2020-04-27 00:00:00,LABORABLE
27,4,2020,6,95,61,156,2020-04-27 05:00:00,2020-04-27 00:00:00,LABORABLE
27,4,2020,7,266,194,460,2020-04-27 06:00:00,2020-04-27 00:00:00,LABORABLE
27,4,2020,8,348,290,638,2020-04-27 07:00:00,2020-04-27 00:00:00,LABORABLE
27,4,2020,9,307,260,567,2020-04-27 08:00:00,2020-04-27 00:00:00,LABORABLE
27,4,2020,10,215,288,503,2020-04-27 09:00:00,2020-04-27 00:00:00,LABORABLE
27,4,2020,11,219,298,517,2020-04-27 10:00:00,2020-04-27 00:00:00,LABORABLE
27,4,2020,12,165,254,419,2020-04-27 11:00:00,2020-04-27 00:00:00,LABORABLE
27,4,2020,13,259,283,542,2020-04-27 12:00:00,2020-04-27 00:00:00,LABORABLE
27,4,2020,14,286,344,630,2020-04-27 13:00:00,2020-04-27 00:00:00,LABORABLE
27,4,2020,15,322,308,630,2020-04-27 14:00:00,2020-04-27 00:00:00,LABORABLE
27,4,2020,16,242,300,542,2020-04-27 15:00:00,2020-04-27 00:00:00,LABORABLE
27,4,2020,17,208,257,465,2020-04-27 16:00:00,2020-04-27 00:00:00,LABORABLE
27,4,2020,18,165,230,395,2020-04-27 17:00:00,2020-04-27 00:00:00,LABORABLE
27,4,2020,19,205,277,482,2020-04-27 18:00:00,2020-04-27 00:00:00,LABORABLE
27,4,2020,20,177,202,379,2020-04-27 19:00:00,2020-04-27 00:00:00,LABORABLE
27,4,2020,21,171,171,342,2020-04-27 20:00:00,2020-04-27 00:00:00,LABORABLE
27,4,2020,22,132,165,297,2020-04-27 21:00:00,2020-04-27 00:00:00,LABORABLE
27,4,2020,23,87,87,174,2020-04-27 22:00:00,2020-04-27 00:00:00,LABORABLE
27,4,2020,24,41,66,107,2020-04-27 23:00:00,2020-04-27 00:00:00,LABORABLE
28,4,2020,1,34,40,74,2020-04-28 00:00:00,2020-04-28 00:00:00,LABORABLE
28,4,2020,2,17,46,63,2020-04-28 01:00:00,2020-04-28 00:00:00,LABORABLE
28,4,2020,3,16,35,51,2020-04-28 02:00:00,2020-04-28 00:00:00,LABORABLE
28,4,2020,4,26,25,51,2020-04-28 03:00:00,2020-04-28 00:00:00,LABORABLE
28,4,2020,5,34,30,64,2020-04-28 04:00:00,2020-04-28 00:00:00,LABORABLE
28,4,2020,6,116,55,171,2020-04-28 05:00:00,2020-04-28 00:00:00,LABORABLE
28,4,2020,7,269,186,455,2020-04-28 06:00:00,2020-04-28 00:00:00,LABORABLE
28,4,2020,8,350,292,642,2020-04-28 07:00:00,2020-04-28 00:00:00,LABORABLE
28,4,2020,9,261,262,523,2020-04-28 08:00:00,2020-04-28 00:00:00,LABORABLE
28,4,2020,10,203,271,474,2020-04-28 09:00:00,2020-04-28 00:00:00,LABORABLE
28,4,2020,11,211,294,505,2020-04-28 10:00:00,2020-04-28 00:00:00,LABORABLE
28,4,2020,12,247,336,583,2020-04-28 11:00:00,2020-04-28 00:00:00,LABORABLE
28,4,2020,13,149,201,350,2020-04-28 12:00:00,2020-04-28 00:00:00,LABORABLE
28,4,2020,14,301,351,652,2020-04-28 13:00:00,2020-04-28 00:00:00,LABORABLE
28,4,2020,15,293,327,620,2020-04-28 14:00:00,2020-04-28 00:00:00,LABORABLE
28,4,2020,16,239,335,574,2020-04-28 15:00:00,2020-04-28 00:00:00,LABORABLE
28,4,2020,17,170,276,446,2020-04-28 16:00:00,2020-04-28 00:00:00,LABORABLE
28,4,2020,18,190,230,420,2020-04-28 17:00:00,2020-04-28 00:00:00,LABORABLE
28,4,2020,19,193,275,468,2020-04-28 18:00:00,2020-04-28 00:00:00,LABORABLE
28,4,2020,20,192,230,422,2020-04-28 19:00:00,2020-04-28 00:00:00,LABORABLE
28,4,2020,21,165,170,335,2020-04-28 20:00:00,2020-04-28 00:00:00,LABORABLE
28,4,2020,22,127,151,278,2020-04-28 21:00:00,2020-04-28 00:00:00,LABORABLE
28,4,2020,23,97,100,197,2020-04-28 22:00:00,2020-04-28 00:00:00,LABORABLE
28,4,2020,24,49,65,114,2020-04-28 23:00:00,2020-04-28 00:00:00,LABORABLE
29,4,2020,1,42,37,79,2020-04-29 00:00:00,2020-04-29 00:00:00,LABORABLE
29,4,2020,2,22,31,53,2020-04-29 01:00:00,2020-04-29 00:00:00,LABORABLE
29,4,2020,3,17,45,62,2020-04-29 02:00:00,2020-04-29 00:00:00,LABORABLE
29,4,2020,4,26,21,47,2020-04-29 03:00:00,2020-04-29 00:00:00,LABORABLE
29,4,2020,5,41,26,67,2020-04-29 04:00:00,2020-04-29 00:00:00,LABORABLE
29,4,2020,6,104,66,170,2020-04-29 05:00:00,2020-04-29 00:00:00,LABORABLE
29,4,2020,7,279,212,491,2020-04-29 06:00:00,2020-04-29 00:00:00,LABORABLE
29,4,2020,8,342,296,638,2020-04-29 07:00:00,2020-04-29 00:00:00,LABORABLE
29,4,2020,9,276,280,556,2020-04-29 08:00:00,2020-04-29 00:00:00,LABORABLE
29,4,2020,10,234,306,540,2020-04-29 09:00:00,2020-04-29 00:00:00,LABORABLE
29,4,2020,11,237,293,530,2020-04-29 10:00:00,2020-04-29 00:00:00,LABORABLE
29,4,2020,12,259,293,552,2020-04-29 11:00:00,2020-04-29 00:00:00,LABORABLE
29,4,2020,13,209,280,489,2020-04-29 12:00:00,2020-04-29 00:00:00,LABORABLE
29,4,2020,14,290,405,695,2020-04-29 13:00:00,2020-04-29 00:00:00,LABORABLE
29,4,2020,15,307,338,645,2020-04-29 14:00:00,2020-04-29 00:00:00,LABORABLE
29,4,2020,16,274,327,601,2020-04-29 15:00:00,2020-04-29 00:00:00,LABORABLE
29,4,2020,17,200,258,458,2020-04-29 16:00:00,2020-04-29 00:00:00,LABORABLE
29,4,2020,18,171,260,431,2020-04-29 17:00:00,2020-04-29 00:00:00,LABORABLE
29,4,2020,19,239,259,498,2020-04-29 18:00:00,2020-04-29 00:00:00,LABORABLE
29,4,2020,20,175,241,416,2020-04-29 19:00:00,2020-04-29 00:00:00,LABORABLE
29,4,2020,21,165,194,359,2020-04-29 20:00:00,2020-04-29 00:00:00,LABORABLE
29,4,2020,22,128,152,280,2020-04-29 21:00:00,2020-04-29 00:00:00,LABORABLE
29,4,2020,23,90,96,186,2020-04-29 22:00:00,2020-04-29 00:00:00,LABORABLE
29,4,2020,24,48,61,109,2020-04-29 23:00:00,2020-04-29 00:00:00,LABORABLE
30,4,2020,1,27,40,67,2020-04-30 00:00:00,2020-04-30 00:00:00,LABORABLE
30,4,2020,2,18,40,58,2020-04-30 01:00:00,2020-04-30 00:00:00,LABORABLE
30,4,2020,3,17,25,42,2020-04-30 02:00:00,2020-04-30 00:00:00,LABORABLE
30,4,2020,4,28,18,46,2020-04-30 03:00:00,2020-04-30 00:00:00,LABORABLE
30,4,2020,5,39,42,81,2020-04-30 04:00:00,2020-04-30 00:00:00,LABORABLE
30,4,2020,6,111,72,183,2020-04-30 05:00:00,2020-04-30 00:00:00,LABORABLE
30,4,2020,7,292,214,506,2020-04-30 06:00:00,2020-04-30 00:00:00,LABORABLE
30,4,2020,8,359,288,647,2020-04-30 07:00:00,2020-04-30 00:00:00,LABORABLE
30,4,2020,9,295,272,567,2020-04-30 08:00:00,2020-04-30 00:00:00,LABORABLE
30,4,2020,10,233,293,526,2020-04-30 09:00:00,2020-04-30 00:00:00,LABORABLE
30,4,2020,11,235,349,584,2020-04-30 10:00:00,2020-04-30 00:00:00,LABORABLE
30,4,2020,12,286,372,658,2020-04-30 11:00:00,2020-04-30 00:00:00,LABORABLE
30,4,2020,13,282,407,689,2020-04-30 12:00:00,2020-04-30 00:00:00,LABORABLE
30,4,2020,14,333,415,748,2020-04-30 13:00:00,2020-04-30 00:00:00,LABORABLE
30,4,2020,15,330,408,738,2020-04-30 14:00:00,2020-04-30 00:00:00,LABORABLE
30,4,2020,16,264,372,636,2020-04-30 15:00:00,2020-04-30 00:00:00,LABORABLE
30,4,2020,17,252,368,620,2020-04-30 16:00:00,2020-04-30 00:00:00,LABORABLE
30,4,2020,18,229,313,542,2020-04-30 17:00:00,2020-04-30 00:00:00,LABORABLE
30,4,2020,19,226,279,505,2020-04-30 18:00:00,2020-04-30 00:00:00,LABORABLE
30,4,2020,20,182,313,495,2020-04-30 19:00:00,2020-04-30 00:00:00,LABORABLE
30,4,2020,21,173,225,398,2020-04-30 20:00:00,2020-04-30 00:00:00,LABORABLE
30,4,2020,22,161,188,349,2020-04-30 21:00:00,2020-04-30 00:00:00,LABORABLE
30,4,2020,23,103,126,229,2020-04-30 22:00:00,2020-04-30 00:00:00,LABORABLE
30,4,2020,24,51,71,122,2020-04-30 23:00:00,2020-04-30 00:00:00,LABORABLE
1,5,2020,1,46,64,110,2020-05-01 00:00:00,2020-01-05 00:00:00,FESTIVO
1,5,2020,2,12,45,57,2020-05-01 01:00:00,2020-01-05 00:00:00,FESTIVO
1,5,2020,3,29,34,63,2020-05-01 02:00:00,2020-01-05 00:00:00,FESTIVO
1,5,2020,4,9,30,39,2020-05-01 03:00:00,2020-01-05 00:00:00,FESTIVO
1,5,2020,5,16,26,42,2020-05-01 04:00:00,2020-01-05 00:00:00,FESTIVO
1,5,2020,6,39,41,80,2020-05-01 05:00:00,2020-01-05 00:00:00,FESTIVO
1,5,2020,7,73,53,126,2020-05-01 06:00:00,2020-01-05 00:00:00,FESTIVO
1,5,2020,8,114,90,204,2020-05-01 07:00:00,2020-01-05 00:00:00,FESTIVO
1,5,2020,9,95,133,228,2020-05-01 08:00:00,2020-01-05 00:00:00,FESTIVO
1,5,2020,10,109,174,283,2020-05-01 09:00:00,2020-01-05 00:00:00,FESTIVO
1,5,2020,11,94,212,306,2020-05-01 10:00:00,2020-01-05 00:00:00,FESTIVO
1,5,2020,12,129,232,361,2020-05-01 11:00:00,2020-01-05 00:00:00,FESTIVO
1,5,2020,13,142,263,405,2020-05-01 12:00:00,2020-01-05 00:00:00,FESTIVO
1,5,2020,14,126,252,378,2020-05-01 13:00:00,2020-01-05 00:00:00,FESTIVO
1,5,2020,15,169,234,403,2020-05-01 14:00:00,2020-01-05 00:00:00,FESTIVO
1,5,2020,16,122,215,337,2020-05-01 15:00:00,2020-01-05 00:00:00,FESTIVO
1,5,2020,17,112,198,310,2020-05-01 16:00:00,2020-01-05 00:00:00,FESTIVO
1,5,2020,18,102,202,304,2020-05-01 17:00:00,2020-01-05 00:00:00,FESTIVO
1,5,2020,19,86,202,288,2020-05-01 18:00:00,2020-01-05 00:00:00,FESTIVO
1,5,2020,20,100,222,322,2020-05-01 19:00:00,2020-01-05 00:00:00,FESTIVO
1,5,2020,21,109,208,317,2020-05-01 20:00:00,2020-01-05 00:00:00,FESTIVO
1,5,2020,22,91,147,238,2020-05-01 21:00:00,2020-01-05 00:00:00,FESTIVO
1,5,2020,23,81,112,193,2020-05-01 22:00:00,2020-01-05 00:00:00,FESTIVO
1,5,2020,24,44,92,136,2020-05-01 23:00:00,2020-01-05 00:00:00,FESTIVO
2,5,2020,1,41,62,103,2020-05-02 00:00:00,2020-02-05 00:00:00,FESTIVO
2,5,2020,2,21,51,72,2020-05-02 01:00:00,2020-02-05 00:00:00,FESTIVO
2,5,2020,3,13,45,58,2020-05-02 02:00:00,2020-02-05 00:00:00,FESTIVO
2,5,2020,4,10,28,38,2020-05-02 03:00:00,2020-02-05 00:00:00,FESTIVO
2,5,2020,5,19,36,55,2020-05-02 04:00:00,2020-02-05 00:00:00,FESTIVO
2,5,2020,6,36,34,70,2020-05-02 05:00:00,2020-02-05 00:00:00,FESTIVO
2,5,2020,7,73,58,131,2020-05-02 06:00:00,2020-02-05 00:00:00,FESTIVO
2,5,2020,8,114,99,213,2020-05-02 07:00:00,2020-02-05 00:00:00,FESTIVO
2,5,2020,9,117,163,280,2020-05-02 08:00:00,2020-02-05 00:00:00,FESTIVO
2,5,2020,10,118,236,354,2020-05-02 09:00:00,2020-02-05 00:00:00,FESTIVO
2,5,2020,11,147,236,383,2020-05-02 10:00:00,2020-02-05 00:00:00,FESTIVO
2,5,2020,12,134,307,441,2020-05-02 11:00:00,2020-02-05 00:00:00,FESTIVO
2,5,2020,13,205,329,534,2020-05-02 12:00:00,2020-02-05 00:00:00,FESTIVO
2,5,2020,14,230,327,557,2020-05-02 13:00:00,2020-02-05 00:00:00,FESTIVO
2,5,2020,15,200,289,489,2020-05-02 14:00:00,2020-02-05 00:00:00,FESTIVO
2,5,2020,16,161,286,447,2020-05-02 15:00:00,2020-02-05 00:00:00,FESTIVO
2,5,2020,17,128,274,402,2020-05-02 16:00:00,2020-02-05 00:00:00,FESTIVO
2,5,2020,18,135,212,347,2020-05-02 17:00:00,2020-02-05 00:00:00,FESTIVO
2,5,2020,19,126,245,371,2020-05-02 18:00:00,2020-02-05 00:00:00,FESTIVO
2,5,2020,20,119,241,360,2020-05-02 19:00:00,2020-02-05 00:00:00,FESTIVO
2,5,2020,21,116,263,379,2020-05-02 20:00:00,2020-02-05 00:00:00,FESTIVO
2,5,2020,22,100,199,299,2020-05-02 21:00:00,2020-02-05 00:00:00,FESTIVO
2,5,2020,23,89,171,260,2020-05-02 22:00:00,2020-02-05 00:00:00,FESTIVO
2,5,2020,24,62,81,143,2020-05-02 23:00:00,2020-02-05 00:00:00,FESTIVO
3,5,2020,1,68,68,136,2020-05-03 00:00:00,2020-03-05 00:00:00,LABORABLE
3,5,2020,2,29,48,77,2020-05-03 01:00:00,2020-03-05 00:00:00,LABORABLE
3,5,2020,3,17,40,57,2020-05-03 02:00:00,2020-03-05 00:00:00,LABORABLE
3,5,2020,4,13,27,40,2020-05-03 03:00:00,2020-03-05 00:00:00,LABORABLE
3,5,2020,5,19,28,47,2020-05-03 04:00:00,2020-03-05 00:00:00,LABORABLE
3,5,2020,6,31,27,58,2020-05-03 05:00:00,2020-03-05 00:00:00,LABORABLE
3,5,2020,7,47,36,83,2020-05-03 06:00:00,2020-03-05 00:00:00,LABORABLE
3,5,2020,8,74,89,163,2020-05-03 07:00:00,2020-03-05 00:00:00,LABORABLE
3,5,2020,9,81,139,220,2020-05-03 08:00:00,2020-03-05 00:00:00,LABORABLE
3,5,2020,10,76,224,300,2020-05-03 09:00:00,2020-03-05 00:00:00,LABORABLE
3,5,2020,11,92,213,305,2020-05-03 10:00:00,2020-03-05 00:00:00,LABORABLE
3,5,2020,12,134,255,389,2020-05-03 11:00:00,2020-03-05 00:00:00,LABORABLE
3,5,2020,13,135,232,367,2020-05-03 12:00:00,2020-03-05 00:00:00,LABORABLE
3,5,2020,14,156,247,403,2020-05-03 13:00:00,2020-03-05 00:00:00,LABORABLE
3,5,2020,15,189,250,439,2020-05-03 14:00:00,2020-03-05 00:00:00,LABORABLE
3,5,2020,16,145,249,394,2020-05-03 15:00:00,2020-03-05 00:00:00,LABORABLE
3,5,2020,17,94,208,302,2020-05-03 16:00:00,2020-03-05 00:00:00,LABORABLE
3,5,2020,18,127,200,327,2020-05-03 17:00:00,2020-03-05 00:00:00,LABORABLE
3,5,2020,19,90,188,278,2020-05-03 18:00:00,2020-03-05 00:00:00,LABORABLE
3,5,2020,20,102,182,284,2020-05-03 19:00:00,2020-03-05 00:00:00,LABORABLE
3,5,2020,21,101,235,336,2020-05-03 20:00:00,2020-03-05 00:00:00,LABORABLE
3,5,2020,22,106,208,314,2020-05-03 21:00:00,2020-03-05 00:00:00,LABORABLE
3,5,2020,23,95,136,231,2020-05-03 22:00:00,2020-03-05 00:00:00,LABORABLE
3,5,2020,24,68,85,153,2020-05-03 23:00:00,2020-03-05 00:00:00,LABORABLE
4,5,2020,1,47,69,116,2020-05-04 00:00:00,2020-04-05 00:00:00,LABORABLE
4,5,2020,2,29,55,84,2020-05-04 01:00:00,2020-04-05 00:00:00,LABORABLE
4,5,2020,3,19,48,67,2020-05-04 02:00:00,2020-04-05 00:00:00,LABORABLE
4,5,2020,4,28,32,60,2020-05-04 03:00:00,2020-04-05 00:00:00,LABORABLE
4,5,2020,5,54,30,84,2020-05-04 04:00:00,2020-04-05 00:00:00,LABORABLE
4,5,2020,6,117,42,159,2020-05-04 05:00:00,2020-04-05 00:00:00,LABORABLE
4,5,2020,7,292,158,450,2020-05-04 06:00:00,2020-04-05 00:00:00,LABORABLE
4,5,2020,8,405,280,685,2020-05-04 07:00:00,2020-04-05 00:00:00,LABORABLE
4,5,2020,9,317,334,651,2020-05-04 08:00:00,2020-04-05 00:00:00,LABORABLE
4,5,2020,10,259,405,664,2020-05-04 09:00:00,2020-04-05 00:00:00,LABORABLE
4,5,2020,11,272,437,709,2020-05-04 10:00:00,2020-04-05 00:00:00,LABORABLE
4,5,2020,12,208,506,714,2020-05-04 11:00:00,2020-04-05 00:00:00,LABORABLE
4,5,2020,13,302,568,870,2020-05-04 12:00:00,2020-04-05 00:00:00,LABORABLE
4,5,2020,14,313,521,834,2020-05-04 13:00:00,2020-04-05 00:00:00,LABORABLE
4,5,2020,15,355,469,824,2020-05-04 14:00:00,2020-04-05 00:00:00,LABORABLE
4,5,2020,16,324,468,792,2020-05-04 15:00:00,2020-04-05 00:00:00,LABORABLE
4,5,2020,17,276,463,739,2020-05-04 16:00:00,2020-04-05 00:00:00,LABORABLE
4,5,2020,18,250,438,688,2020-05-04 17:00:00,2020-04-05 00:00:00,LABORABLE
4,5,2020,19,252,439,691,2020-05-04 18:00:00,2020-04-05 00:00:00,LABORABLE
4,5,2020,20,264,435,699,2020-05-04 19:00:00,2020-04-05 00:00:00,LABORABLE
4,5,2020,21,215,379,594,2020-05-04 20:00:00,2020-04-05 00:00:00,LABORABLE
4,5,2020,22,160,283,443,2020-05-04 21:00:00,2020-04-05 00:00:00,LABORABLE
4,5,2020,23,118,160,278,2020-05-04 22:00:00,2020-04-05 00:00:00,LABORABLE
4,5,2020,24,60,98,158,2020-05-04 23:00:00,2020-04-05 00:00:00,LABORABLE
5,5,2020,1,47,75,122,2020-05-05 00:00:00,2020-05-05 00:00:00,LABORABLE
5,5,2020,2,24,52,76,2020-05-05 01:00:00,2020-05-05 00:00:00,LABORABLE
5,5,2020,3,27,38,65,2020-05-05 02:00:00,2020-05-05 00:00:00,LABORABLE
5,5,2020,4,24,26,50,2020-05-05 03:00:00,2020-05-05 00:00:00,LABORABLE
5,5,2020,5,41,40,81,2020-05-05 04:00:00,2020-05-05 00:00:00,LABORABLE
5,5,2020,6,124,54,178,2020-05-05 05:00:00,2020-05-05 00:00:00,LABORABLE
5,5,2020,7,293,165,458,2020-05-05 06:00:00,2020-05-05 00:00:00,LABORABLE
5,5,2020,8,402,321,723,2020-05-05 07:00:00,2020-05-05 00:00:00,LABORABLE
5,5,2020,9,290,417,707,2020-05-05 08:00:00,2020-05-05 00:00:00,LABORABLE
5,5,2020,10,255,414,669,2020-05-05 09:00:00,2020-05-05 00:00:00,LABORABLE
5,5,2020,11,147,431,578,2020-05-05 10:00:00,2020-05-05 00:00:00,LABORABLE
5,5,2020,12,206,488,694,2020-05-05 11:00:00,2020-05-05 00:00:00,LABORABLE
5,5,2020,13,326,494,820,2020-05-05 12:00:00,2020-05-05 00:00:00,LABORABLE
5,5,2020,14,288,473,761,2020-05-05 13:00:00,2020-05-05 00:00:00,LABORABLE
5,5,2020,15,351,472,823,2020-05-05 14:00:00,2020-05-05 00:00:00,LABORABLE
5,5,2020,16,298,429,727,2020-05-05 15:00:00,2020-05-05 00:00:00,LABORABLE
5,5,2020,17,258,392,650,2020-05-05 16:00:00,2020-05-05 00:00:00,LABORABLE
5,5,2020,18,229,341,570,2020-05-05 17:00:00,2020-05-05 00:00:00,LABORABLE
5,5,2020,19,261,435,696,2020-05-05 18:00:00,2020-05-05 00:00:00,LABORABLE
5,5,2020,20,226,444,670,2020-05-05 19:00:00,2020-05-05 00:00:00,LABORABLE
5,5,2020,21,193,369,562,2020-05-05 20:00:00,2020-05-05 00:00:00,LABORABLE
5,5,2020,22,171,273,444,2020-05-05 21:00:00,2020-05-05 00:00:00,LABORABLE
5,5,2020,23,122,162,284,2020-05-05 22:00:00,2020-05-05 00:00:00,LABORABLE
5,5,2020,24,72,99,171,2020-05-05 23:00:00,2020-05-05 00:00:00,LABORABLE
6,5,2020,1,29,65,94,2020-05-06 00:00:00,2020-06-05 00:00:00,LABORABLE
6,5,2020,2,25,44,69,2020-05-06 01:00:00,2020-06-05 00:00:00,LABORABLE
6,5,2020,3,26,39,65,2020-05-06 02:00:00,2020-06-05 00:00:00,LABORABLE
6,5,2020,4,29,24,53,2020-05-06 03:00:00,2020-06-05 00:00:00,LABORABLE
6,5,2020,5,32,20,52,2020-05-06 04:00:00,2020-06-05 00:00:00,LABORABLE
6,5,2020,6,125,52,177,2020-05-06 05:00:00,2020-06-05 00:00:00,LABORABLE
6,5,2020,7,288,174,462,2020-05-06 06:00:00,2020-06-05 00:00:00,LABORABLE
6,5,2020,8,398,287,685,2020-05-06 07:00:00,2020-06-05 00:00:00,LABORABLE
6,5,2020,9,307,355,662,2020-05-06 08:00:00,2020-06-05 00:00:00,LABORABLE
6,5,2020,10,276,428,704,2020-05-06 09:00:00,2020-06-05 00:00:00,LABORABLE
6,5,2020,11,254,463,717,2020-05-06 10:00:00,2020-06-05 00:00:00,LABORABLE
6,5,2020,12,298,455,753,2020-05-06 11:00:00,2020-06-05 00:00:00,LABORABLE
6,5,2020,13,243,464,707,2020-05-06 12:00:00,2020-06-05 00:00:00,LABORABLE
6,5,2020,14,330,537,867,2020-05-06 13:00:00,2020-06-05 00:00:00,LABORABLE
6,5,2020,15,369,482,851,2020-05-06 14:00:00,2020-06-05 00:00:00,LABORABLE
6,5,2020,16,307,437,744,2020-05-06 15:00:00,2020-06-05 00:00:00,LABORABLE
6,5,2020,17,241,418,659,2020-05-06 16:00:00,2020-06-05 00:00:00,LABORABLE
6,5,2020,18,226,387,613,2020-05-06 17:00:00,2020-06-05 00:00:00,LABORABLE
6,5,2020,19,268,419,687,2020-05-06 18:00:00,2020-06-05 00:00:00,LABORABLE
6,5,2020,20,260,439,699,2020-05-06 19:00:00,2020-06-05 00:00:00,LABORABLE
6,5,2020,21,238,359,597,2020-05-06 20:00:00,2020-06-05 00:00:00,LABORABLE
6,5,2020,22,169,281,450,2020-05-06 21:00:00,2020-06-05 00:00:00,LABORABLE
6,5,2020,23,108,193,301,2020-05-06 22:00:00,2020-06-05 00:00:00,LABORABLE
6,5,2020,24,69,103,172,2020-05-06 23:00:00,2020-06-05 00:00:00,LABORABLE
7,5,2020,1,52,93,145,2020-05-07 00:00:00,2020-07-05 00:00:00,LABORABLE
7,5,2020,2,35,57,92,2020-05-07 01:00:00,2020-07-05 00:00:00,LABORABLE
7,5,2020,3,25,40,65,2020-05-07 02:00:00,2020-07-05 00:00:00,LABORABLE
7,5,2020,4,29,30,59,2020-05-07 03:00:00,2020-07-05 00:00:00,LABORABLE
7,5,2020,5,41,40,81,2020-05-07 04:00:00,2020-07-05 00:00:00,LABORABLE
7,5,2020,6,119,60,179,2020-05-07 05:00:00,2020-07-05 00:00:00,LABORABLE
7,5,2020,7,275,148,423,2020-05-07 06:00:00,2020-07-05 00:00:00,LABORABLE
7,5,2020,8,420,228,648,2020-05-07 07:00:00,2020-07-05 00:00:00,LABORABLE
7,5,2020,9,311,314,625,2020-05-07 08:00:00,2020-07-05 00:00:00,LABORABLE
7,5,2020,10,298,358,656,2020-05-07 09:00:00,2020-07-05 00:00:00,LABORABLE
7,5,2020,11,267,430,697,2020-05-07 10:00:00,2020-07-05 00:00:00,LABORABLE
7,5,2020,12,289,409,698,2020-05-07 11:00:00,2020-07-05 00:00:00,LABORABLE
7,5,2020,13,307,369,676,2020-05-07 12:00:00,2020-07-05 00:00:00,LABORABLE
7,5,2020,14,308,422,730,2020-05-07 13:00:00,2020-07-05 00:00:00,LABORABLE
7,5,2020,15,357,455,812,2020-05-07 14:00:00,2020-07-05 00:00:00,LABORABLE
7,5,2020,16,297,418,715,2020-05-07 15:00:00,2020-07-05 00:00:00,LABORABLE
7,5,2020,17,263,422,685,2020-05-07 16:00:00,2020-07-05 00:00:00,LABORABLE
7,5,2020,18,238,362,600,2020-05-07 17:00:00,2020-07-05 00:00:00,LABORABLE
7,5,2020,19,285,330,615,2020-05-07 18:00:00,2020-07-05 00:00:00,LABORABLE
7,5,2020,20,260,365,625,2020-05-07 19:00:00,2020-07-05 00:00:00,LABORABLE
7,5,2020,21,230,302,532,2020-05-07 20:00:00,2020-07-05 00:00:00,LABORABLE
7,5,2020,22,185,226,411,2020-05-07 21:00:00,2020-07-05 00:00:00,LABORABLE
7,5,2020,23,124,158,282,2020-05-07 22:00:00,2020-07-05 00:00:00,LABORABLE
7,5,2020,24,63,91,154,2020-05-07 23:00:00,2020-07-05 00:00:00,LABORABLE
8,5,2020,1,48,58,106,2020-05-08 00:00:00,2020-08-05 00:00:00,LABORABLE
8,5,2020,2,24,39,63,2020-05-08 01:00:00,2020-08-05 00:00:00,LABORABLE
8,5,2020,3,29,31,60,2020-05-08 02:00:00,2020-08-05 00:00:00,LABORABLE
8,5,2020,4,35,27,62,2020-05-08 03:00:00,2020-08-05 00:00:00,LABORABLE
8,5,2020,5,37,21,58,2020-05-08 04:00:00,2020-08-05 00:00:00,LABORABLE
8,5,2020,6,122,37,159,2020-05-08 05:00:00,2020-08-05 00:00:00,LABORABLE
8,5,2020,7,293,49,342,2020-05-08 06:00:00,2020-08-05 00:00:00,LABORABLE
8,5,2020,8,419,91,510,2020-05-08 07:00:00,2020-08-05 00:00:00,LABORABLE
8,5,2020,9,323,129,452,2020-05-08 08:00:00,2020-08-05 00:00:00,LABORABLE
8,5,2020,10,284,167,451,2020-05-08 09:00:00,2020-08-05 00:00:00,LABORABLE
8,5,2020,11,280,212,492,2020-05-08 10:00:00,2020-08-05 00:00:00,LABORABLE
8,5,2020,12,324,237,561,2020-05-08 11:00:00,2020-08-05 00:00:00,LABORABLE
8,5,2020,13,318,254,572,2020-05-08 12:00:00,2020-08-05 00:00:00,LABORABLE
8,5,2020,14,366,240,606,2020-05-08 13:00:00,2020-08-05 00:00:00,LABORABLE
8,5,2020,15,362,227,589,2020-05-08 14:00:00,2020-08-05 00:00:00,LABORABLE
8,5,2020,16,350,215,565,2020-05-08 15:00:00,2020-08-05 00:00:00,LABORABLE
8,5,2020,17,271,200,471,2020-05-08 16:00:00,2020-08-05 00:00:00,LABORABLE
8,5,2020,18,252,201,453,2020-05-08 17:00:00,2020-08-05 00:00:00,LABORABLE
8,5,2020,19,273,198,471,2020-05-08 18:00:00,2020-08-05 00:00:00,LABORABLE
8,5,2020,20,251,227,478,2020-05-08 19:00:00,2020-08-05 00:00:00,LABORABLE
8,5,2020,21,256,210,466,2020-05-08 20:00:00,2020-08-05 00:00:00,LABORABLE
8,5,2020,22,197,140,337,2020-05-08 21:00:00,2020-08-05 00:00:00,LABORABLE
8,5,2020,23,130,99,229,2020-05-08 22:00:00,2020-08-05 00:00:00,LABORABLE
8,5,2020,24,78,83,161,2020-05-08 23:00:00,2020-08-05 00:00:00,LABORABLE
9,5,2020,1,50,52,102,2020-05-09 00:00:00,2020-09-05 00:00:00,LABORABLE
9,5,2020,2,29,45,74,2020-05-09 01:00:00,2020-09-05 00:00:00,LABORABLE
9,5,2020,3,26,40,66,2020-05-09 02:00:00,2020-09-05 00:00:00,LABORABLE
9,5,2020,4,28,25,53,2020-05-09 03:00:00,2020-09-05 00:00:00,LABORABLE
9,5,2020,5,24,32,56,2020-05-09 04:00:00,2020-09-05 00:00:00,LABORABLE
9,5,2020,6,61,31,92,2020-05-09 05:00:00,2020-09-05 00:00:00,LABORABLE
9,5,2020,7,118,54,172,2020-05-09 06:00:00,2020-09-05 00:00:00,LABORABLE
9,5,2020,8,157,96,253,2020-05-09 07:00:00,2020-09-05 00:00:00,LABORABLE
9,5,2020,9,180,160,340,2020-05-09 08:00:00,2020-09-05 00:00:00,LABORABLE
9,5,2020,10,160,229,389,2020-05-09 09:00:00,2020-09-05 00:00:00,LABORABLE
9,5,2020,11,194,228,422,2020-05-09 10:00:00,2020-09-05 00:00:00,LABORABLE
9,5,2020,12,218,298,516,2020-05-09 11:00:00,2020-09-05 00:00:00,LABORABLE
9,5,2020,13,260,312,572,2020-05-09 12:00:00,2020-09-05 00:00:00,LABORABLE
9,5,2020,14,275,337,612,2020-05-09 13:00:00,2020-09-05 00:00:00,LABORABLE
9,5,2020,15,263,279,542,2020-05-09 14:00:00,2020-09-05 00:00:00,LABORABLE
9,5,2020,16,235,274,509,2020-05-09 15:00:00,2020-09-05 00:00:00,LABORABLE
9,5,2020,17,159,272,431,2020-05-09 16:00:00,2020-09-05 00:00:00,LABORABLE
9,5,2020,18,140,213,353,2020-05-09 17:00:00,2020-09-05 00:00:00,LABORABLE
9,5,2020,19,156,235,391,2020-05-09 18:00:00,2020-09-05 00:00:00,LABORABLE
9,5,2020,20,163,229,392,2020-05-09 19:00:00,2020-09-05 00:00:00,LABORABLE
9,5,2020,21,157,270,427,2020-05-09 20:00:00,2020-09-05 00:00:00,LABORABLE
9,5,2020,22,163,198,361,2020-05-09 21:00:00,2020-09-05 00:00:00,LABORABLE
9,5,2020,23,106,167,273,2020-05-09 22:00:00,2020-09-05 00:00:00,LABORABLE
9,5,2020,24,69,77,146,2020-05-09 23:00:00,2020-09-05 00:00:00,LABORABLE
10,5,2020,1,39,62,101,2020-05-10 00:00:00,2020-10-05 00:00:00,LABORABLE
10,5,2020,2,23,42,65,2020-05-10 01:00:00,2020-10-05 00:00:00,LABORABLE
10,5,2020,3,24,35,59,2020-05-10 02:00:00,2020-10-05 00:00:00,LABORABLE
10,5,2020,4,8,24,32,2020-05-10 03:00:00,2020-10-05 00:00:00,LABORABLE
10,5,2020,5,21,21,42,2020-05-10 04:00:00,2020-10-05 00:00:00,LABORABLE
10,5,2020,6,25,23,48,2020-05-10 05:00:00,2020-10-05 00:00:00,LABORABLE
10,5,2020,7,57,31,88,2020-05-10 06:00:00,2020-10-05 00:00:00,LABORABLE
10,5,2020,8,76,88,164,2020-05-10 07:00:00,2020-10-05 00:00:00,LABORABLE
10,5,2020,9,70,136,206,2020-05-10 08:00:00,2020-10-05 00:00:00,LABORABLE
10,5,2020,10,103,207,310,2020-05-10 09:00:00,2020-10-05 00:00:00,LABORABLE
10,5,2020,11,123,201,324,2020-05-10 10:00:00,2020-10-05 00:00:00,LABORABLE
10,5,2020,12,149,256,405,2020-05-10 11:00:00,2020-10-05 00:00:00,LABORABLE
10,5,2020,13,157,232,389,2020-05-10 12:00:00,2020-10-05 00:00:00,LABORABLE
10,5,2020,14,194,241,435,2020-05-10 13:00:00,2020-10-05 00:00:00,LABORABLE
10,5,2020,15,170,249,419,2020-05-10 14:00:00,2020-10-05 00:00:00,LABORABLE
10,5,2020,16,157,243,400,2020-05-10 15:00:00,2020-10-05 00:00:00,LABORABLE
10,5,2020,17,126,204,330,2020-05-10 16:00:00,2020-10-05 00:00:00,LABORABLE
10,5,2020,18,108,191,299,2020-05-10 17:00:00,2020-10-05 00:00:00,LABORABLE
10,5,2020,19,115,179,294,2020-05-10 18:00:00,2020-10-05 00:00:00,LABORABLE
10,5,2020,20,129,178,307,2020-05-10 19:00:00,2020-10-05 00:00:00,LABORABLE
10,5,2020,21,139,218,357,2020-05-10 20:00:00,2020-10-05 00:00:00,LABORABLE
10,5,2020,22,143,190,333,2020-05-10 21:00:00,2020-10-05 00:00:00,LABORABLE
10,5,2020,23,105,128,233,2020-05-10 22:00:00,2020-10-05 00:00:00,LABORABLE
10,5,2020,24,49,78,127,2020-05-10 23:00:00,2020-10-05 00:00:00,LABORABLE
11,5,2020,1,38,65,103,2020-05-11 00:00:00,2020-11-05 00:00:00,LABORABLE
11,5,2020,2,38,52,90,2020-05-11 01:00:00,2020-11-05 00:00:00,LABORABLE
11,5,2020,3,23,41,64,2020-05-11 02:00:00,2020-11-05 00:00:00,LABORABLE
11,5,2020,4,26,27,53,2020-05-11 03:00:00,2020-11-05 00:00:00,LABORABLE
11,5,2020,5,40,26,66,2020-05-11 04:00:00,2020-11-05 00:00:00,LABORABLE
11,5,2020,6,112,39,151,2020-05-11 05:00:00,2020-11-05 00:00:00,LABORABLE
11,5,2020,7,304,147,451,2020-05-11 06:00:00,2020-11-05 00:00:00,LABORABLE
11,5,2020,8,478,273,751,2020-05-11 07:00:00,2020-11-05 00:00:00,LABORABLE
11,5,2020,9,370,343,713,2020-05-11 08:00:00,2020-11-05 00:00:00,LABORABLE
11,5,2020,10,315,394,709,2020-05-11 09:00:00,2020-11-05 00:00:00,LABORABLE
11,5,2020,11,285,410,695,2020-05-11 10:00:00,2020-11-05 00:00:00,LABORABLE
11,5,2020,12,330,485,815,2020-05-11 11:00:00,2020-11-05 00:00:00,LABORABLE
11,5,2020,13,323,549,872,2020-05-11 12:00:00,2020-11-05 00:00:00,LABORABLE
11,5,2020,14,357,511,868,2020-05-11 13:00:00,2020-11-05 00:00:00,LABORABLE
11,5,2020,15,398,458,856,2020-05-11 14:00:00,2020-11-05 00:00:00,LABORABLE
11,5,2020,16,330,474,804,2020-05-11 15:00:00,2020-11-05 00:00:00,LABORABLE
11,5,2020,17,287,462,749,2020-05-11 16:00:00,2020-11-05 00:00:00,LABORABLE
11,5,2020,18,289,377,666,2020-05-11 17:00:00,2020-11-05 00:00:00,LABORABLE
11,5,2020,19,300,467,767,2020-05-11 18:00:00,2020-11-05 00:00:00,LABORABLE
11,5,2020,20,273,424,697,2020-05-11 19:00:00,2020-11-05 00:00:00,LABORABLE
11,5,2020,21,241,379,620,2020-05-11 20:00:00,2020-11-05 00:00:00,LABORABLE
11,5,2020,22,201,289,490,2020-05-11 21:00:00,2020-11-05 00:00:00,LABORABLE
11,5,2020,23,128,195,323,2020-05-11 22:00:00,2020-11-05 00:00:00,LABORABLE
11,5,2020,24,59,101,160,2020-05-11 23:00:00,2020-11-05 00:00:00,LABORABLE
12,5,2020,1,41,58,99,2020-05-12 00:00:00,2020-12-05 00:00:00,LABORABLE
12,5,2020,2,33,51,84,2020-05-12 01:00:00,2020-12-05 00:00:00,LABORABLE
12,5,2020,3,22,48,70,2020-05-12 02:00:00,2020-12-05 00:00:00,LABORABLE
12,5,2020,4,35,20,55,2020-05-12 03:00:00,2020-12-05 00:00:00,LABORABLE
12,5,2020,5,49,26,75,2020-05-12 04:00:00,2020-12-05 00:00:00,LABORABLE
12,5,2020,6,112,57,169,2020-05-12 05:00:00,2020-12-05 00:00:00,LABORABLE
12,5,2020,7,280,157,437,2020-05-12 06:00:00,2020-12-05 00:00:00,LABORABLE
12,5,2020,8,460,296,756,2020-05-12 07:00:00,2020-12-05 00:00:00,LABORABLE
12,5,2020,9,356,367,723,2020-05-12 08:00:00,2020-12-05 00:00:00,LABORABLE
12,5,2020,10,313,388,701,2020-05-12 09:00:00,2020-12-05 00:00:00,LABORABLE
12,5,2020,11,317,393,710,2020-05-12 10:00:00,2020-12-05 00:00:00,LABORABLE
12,5,2020,12,275,411,686,2020-05-12 11:00:00,2020-12-05 00:00:00,LABORABLE
12,5,2020,13,366,410,776,2020-05-12 12:00:00,2020-12-05 00:00:00,LABORABLE
12,5,2020,14,356,350,706,2020-05-12 13:00:00,2020-12-05 00:00:00,LABORABLE
12,5,2020,15,390,365,755,2020-05-12 14:00:00,2020-12-05 00:00:00,LABORABLE
12,5,2020,16,346,335,681,2020-05-12 15:00:00,2020-12-05 00:00:00,LABORABLE
12,5,2020,17,287,248,535,2020-05-12 16:00:00,2020-12-05 00:00:00,LABORABLE
12,5,2020,18,274,297,571,2020-05-12 17:00:00,2020-12-05 00:00:00,LABORABLE
12,5,2020,19,319,459,778,2020-05-12 18:00:00,2020-12-05 00:00:00,LABORABLE
12,5,2020,20,306,445,751,2020-05-12 19:00:00,2020-12-05 00:00:00,LABORABLE
12,5,2020,21,243,327,570,2020-05-12 20:00:00,2020-12-05 00:00:00,LABORABLE
12,5,2020,22,188,267,455,2020-05-12 21:00:00,2020-12-05 00:00:00,LABORABLE
12,5,2020,23,112,185,297,2020-05-12 22:00:00,2020-12-05 00:00:00,LABORABLE
12,5,2020,24,74,98,172,2020-05-12 23:00:00,2020-12-05 00:00:00,LABORABLE
13,5,2020,1,38,79,117,2020-05-13 00:00:00,2020-05-13 00:00:00,LABORABLE
13,5,2020,2,35,58,93,2020-05-13 01:00:00,2020-05-13 00:00:00,LABORABLE
13,5,2020,3,25,37,62,2020-05-13 02:00:00,2020-05-13 00:00:00,LABORABLE
13,5,2020,4,28,27,55,2020-05-13 03:00:00,2020-05-13 00:00:00,LABORABLE
13,5,2020,5,34,26,60,2020-05-13 04:00:00,2020-05-13 00:00:00,LABORABLE
13,5,2020,6,113,46,159,2020-05-13 05:00:00,2020-05-13 00:00:00,LABORABLE
13,5,2020,7,286,157,443,2020-05-13 06:00:00,2020-05-13 00:00:00,LABORABLE
13,5,2020,8,458,304,762,2020-05-13 07:00:00,2020-05-13 00:00:00,LABORABLE
13,5,2020,9,375,248,623,2020-05-13 08:00:00,2020-05-13 00:00:00,LABORABLE
13,5,2020,10,302,63,365,2020-05-13 09:00:00,2020-05-13 00:00:00,LABORABLE
13,5,2020,11,285,84,369,2020-05-13 10:00:00,2020-05-13 00:00:00,LABORABLE
13,5,2020,12,302,116,418,2020-05-13 11:00:00,2020-05-13 00:00:00,LABORABLE
13,5,2020,13,343,90,433,2020-05-13 12:00:00,2020-05-13 00:00:00,LABORABLE
13,5,2020,14,355,119,474,2020-05-13 13:00:00,2020-05-13 00:00:00,LABORABLE
13,5,2020,15,418,64,482,2020-05-13 14:00:00,2020-05-13 00:00:00,LABORABLE
13,5,2020,16,340,115,455,2020-05-13 15:00:00,2020-05-13 00:00:00,LABORABLE
13,5,2020,17,295,41,336,2020-05-13 16:00:00,2020-05-13 00:00:00,LABORABLE
13,5,2020,18,276,129,405,2020-05-13 17:00:00,2020-05-13 00:00:00,LABORABLE
13,5,2020,19,324,251,575,2020-05-13 18:00:00,2020-05-13 00:00:00,LABORABLE
13,5,2020,20,269,358,627,2020-05-13 19:00:00,2020-05-13 00:00:00,LABORABLE
13,5,2020,21,255,329,584,2020-05-13 20:00:00,2020-05-13 00:00:00,LABORABLE
13,5,2020,22,190,234,424,2020-05-13 21:00:00,2020-05-13 00:00:00,LABORABLE
13,5,2020,23,127,184,311,2020-05-13 22:00:00,2020-05-13 00:00:00,LABORABLE
13,5,2020,24,81,100,181,2020-05-13 23:00:00,2020-05-13 00:00:00,LABORABLE
14,5,2020,1,33,59,92,2020-05-14 00:00:00,2020-05-14 00:00:00,LABORABLE
14,5,2020,2,34,47,81,2020-05-14 01:00:00,2020-05-14 00:00:00,LABORABLE
14,5,2020,3,22,44,66,2020-05-14 02:00:00,2020-05-14 00:00:00,LABORABLE
14,5,2020,4,35,33,68,2020-05-14 03:00:00,2020-05-14 00:00:00,LABORABLE
14,5,2020,5,41,32,73,2020-05-14 04:00:00,2020-05-14 00:00:00,LABORABLE
14,5,2020,6,128,57,185,2020-05-14 05:00:00,2020-05-14 00:00:00,LABORABLE
14,5,2020,7,284,170,454,2020-05-14 06:00:00,2020-05-14 00:00:00,LABORABLE
14,5,2020,8,470,253,723,2020-05-14 07:00:00,2020-05-14 00:00:00,LABORABLE
14,5,2020,9,359,317,676,2020-05-14 08:00:00,2020-05-14 00:00:00,LABORABLE
14,5,2020,10,317,355,672,2020-05-14 09:00:00,2020-05-14 00:00:00,LABORABLE
14,5,2020,11,289,390,679,2020-05-14 10:00:00,2020-05-14 00:00:00,LABORABLE
14,5,2020,12,338,425,763,2020-05-14 11:00:00,2020-05-14 00:00:00,LABORABLE
14,5,2020,13,353,453,806,2020-05-14 12:00:00,2020-05-14 00:00:00,LABORABLE
14,5,2020,14,308,472,780,2020-05-14 13:00:00,2020-05-14 00:00:00,LABORABLE
14,5,2020,15,440,442,882,2020-05-14 14:00:00,2020-05-14 00:00:00,LABORABLE
14,5,2020,16,354,443,797,2020-05-14 15:00:00,2020-05-14 00:00:00,LABORABLE
14,5,2020,17,276,425,701,2020-05-14 16:00:00,2020-05-14 00:00:00,LABORABLE
14,5,2020,18,298,386,684,2020-05-14 17:00:00,2020-05-14 00:00:00,LABORABLE
14,5,2020,19,346,430,776,2020-05-14 18:00:00,2020-05-14 00:00:00,LABORABLE
14,5,2020,20,301,417,718,2020-05-14 19:00:00,2020-05-14 00:00:00,LABORABLE
14,5,2020,21,261,384,645,2020-05-14 20:00:00,2020-05-14 00:00:00,LABORABLE
14,5,2020,22,201,268,469,2020-05-14 21:00:00,2020-05-14 00:00:00,LABORABLE
14,5,2020,23,115,162,277,2020-05-14 22:00:00,2020-05-14 00:00:00,LABORABLE
14,5,2020,24,80,91,171,2020-05-14 23:00:00,2020-05-14 00:00:00,LABORABLE
15,5,2020,1,34,74,108,2020-05-15 00:00:00,2020-05-15 00:00:00,FESTIVO
15,5,2020,2,25,48,73,2020-05-15 01:00:00,2020-05-15 00:00:00,FESTIVO
15,5,2020,3,21,39,60,2020-05-15 02:00:00,2020-05-15 00:00:00,FESTIVO
15,5,2020,4,21,32,53,2020-05-15 03:00:00,2020-05-15 00:00:00,FESTIVO
15,5,2020,5,21,31,52,2020-05-15 04:00:00,2020-05-15 00:00:00,FESTIVO
15,5,2020,6,58,26,84,2020-05-15 05:00:00,2020-05-15 00:00:00,FESTIVO
15,5,2020,7,154,62,216,2020-05-15 06:00:00,2020-05-15 00:00:00,FESTIVO
15,5,2020,8,231,127,358,2020-05-15 07:00:00,2020-05-15 00:00:00,FESTIVO
15,5,2020,9,199,185,384,2020-05-15 08:00:00,2020-05-15 00:00:00,FESTIVO
15,5,2020,10,187,279,466,2020-05-15 09:00:00,2020-05-15 00:00:00,FESTIVO
15,5,2020,11,181,307,488,2020-05-15 10:00:00,2020-05-15 00:00:00,FESTIVO
15,5,2020,12,215,389,604,2020-05-15 11:00:00,2020-05-15 00:00:00,FESTIVO
15,5,2020,13,259,377,636,2020-05-15 12:00:00,2020-05-15 00:00:00,FESTIVO
15,5,2020,14,246,440,686,2020-05-15 13:00:00,2020-05-15 00:00:00,FESTIVO
15,5,2020,15,249,378,627,2020-05-15 14:00:00,2020-05-15 00:00:00,FESTIVO
15,5,2020,16,213,340,553,2020-05-15 15:00:00,2020-05-15 00:00:00,FESTIVO
15,5,2020,17,178,333,511,2020-05-15 16:00:00,2020-05-15 00:00:00,FESTIVO
15,5,2020,18,172,295,467,2020-05-15 17:00:00,2020-05-15 00:00:00,FESTIVO
15,5,2020,19,182,317,499,2020-05-15 18:00:00,2020-05-15 00:00:00,FESTIVO
15,5,2020,20,179,304,483,2020-05-15 19:00:00,2020-05-15 00:00:00,FESTIVO
15,5,2020,21,168,301,469,2020-05-15 20:00:00,2020-05-15 00:00:00,FESTIVO
15,5,2020,22,145,241,386,2020-05-15 21:00:00,2020-05-15 00:00:00,FESTIVO
15,5,2020,23,121,172,293,2020-05-15 22:00:00,2020-05-15 00:00:00,FESTIVO
15,5,2020,24,64,101,165,2020-05-15 23:00:00,2020-05-15 00:00:00,FESTIVO
16,5,2020,1,65,95,160,2020-05-16 00:00:00,2020-05-16 00:00:00,LABORABLE
16,5,2020,2,31,69,100,2020-05-16 01:00:00,2020-05-16 00:00:00,LABORABLE
16,5,2020,3,27,56,83,2020-05-16 02:00:00,2020-05-16 00:00:00,LABORABLE
16,5,2020,4,34,32,66,2020-05-16 03:00:00,2020-05-16 00:00:00,LABORABLE
16,5,2020,5,26,33,59,2020-05-16 04:00:00,2020-05-16 00:00:00,LABORABLE
16,5,2020,6,55,40,95,2020-05-16 05:00:00,2020-05-16 00:00:00,LABORABLE
16,5,2020,7,112,74,186,2020-05-16 06:00:00,2020-05-16 00:00:00,LABORABLE
16,5,2020,8,156,112,268,2020-05-16 07:00:00,2020-05-16 00:00:00,LABORABLE
16,5,2020,9,156,157,313,2020-05-16 08:00:00,2020-05-16 00:00:00,LABORABLE
16,5,2020,10,184,199,383,2020-05-16 09:00:00,2020-05-16 00:00:00,LABORABLE
16,5,2020,11,205,235,440,2020-05-16 10:00:00,2020-05-16 00:00:00,LABORABLE
16,5,2020,12,281,198,479,2020-05-16 11:00:00,2020-05-16 00:00:00,LABORABLE
16,5,2020,13,321,230,551,2020-05-16 12:00:00,2020-05-16 00:00:00,LABORABLE
16,5,2020,14,306,338,644,2020-05-16 13:00:00,2020-05-16 00:00:00,LABORABLE
16,5,2020,15,252,405,657,2020-05-16 14:00:00,2020-05-16 00:00:00,LABORABLE
16,5,2020,16,270,347,617,2020-05-16 15:00:00,2020-05-16 00:00:00,LABORABLE
16,5,2020,17,184,305,489,2020-05-16 16:00:00,2020-05-16 00:00:00,LABORABLE
16,5,2020,18,184,296,480,2020-05-16 17:00:00,2020-05-16 00:00:00,LABORABLE
16,5,2020,19,189,279,468,2020-05-16 18:00:00,2020-05-16 00:00:00,LABORABLE
16,5,2020,20,161,291,452,2020-05-16 19:00:00,2020-05-16 00:00:00,LABORABLE
16,5,2020,21,170,278,448,2020-05-16 20:00:00,2020-05-16 00:00:00,LABORABLE
16,5,2020,22,163,191,354,2020-05-16 21:00:00,2020-05-16 00:00:00,LABORABLE
16,5,2020,23,124,173,297,2020-05-16 22:00:00,2020-05-16 00:00:00,LABORABLE
16,5,2020,24,76,76,152,2020-05-16 23:00:00,2020-05-16 00:00:00,LABORABLE
17,5,2020,1,56,58,114,2020-05-17 00:00:00,2020-05-17 00:00:00,LABORABLE
17,5,2020,2,29,39,68,2020-05-17 01:00:00,2020-05-17 00:00:00,LABORABLE
17,5,2020,3,21,36,57,2020-05-17 02:00:00,2020-05-17 00:00:00,LABORABLE
17,5,2020,4,15,23,38,2020-05-17 03:00:00,2020-05-17 00:00:00,LABORABLE
17,5,2020,5,14,23,37,2020-05-17 04:00:00,2020-05-17 00:00:00,LABORABLE
17,5,2020,6,27,23,50,2020-05-17 05:00:00,2020-05-17 00:00:00,LABORABLE
17,5,2020,7,65,32,97,2020-05-17 06:00:00,2020-05-17 00:00:00,LABORABLE
17,5,2020,8,79,82,161,2020-05-17 07:00:00,2020-05-17 00:00:00,LABORABLE
17,5,2020,9,78,133,211,2020-05-17 08:00:00,2020-05-17 00:00:00,LABORABLE
17,5,2020,10,100,227,327,2020-05-17 09:00:00,2020-05-17 00:00:00,LABORABLE
17,5,2020,11,121,210,331,2020-05-17 10:00:00,2020-05-17 00:00:00,LABORABLE
17,5,2020,12,130,252,382,2020-05-17 11:00:00,2020-05-17 00:00:00,LABORABLE
17,5,2020,13,170,219,389,2020-05-17 12:00:00,2020-05-17 00:00:00,LABORABLE
17,5,2020,14,188,238,426,2020-05-17 13:00:00,2020-05-17 00:00:00,LABORABLE
17,5,2020,15,190,248,438,2020-05-17 14:00:00,2020-05-17 00:00:00,LABORABLE
17,5,2020,16,169,246,415,2020-05-17 15:00:00,2020-05-17 00:00:00,LABORABLE
17,5,2020,17,126,203,329,2020-05-17 16:00:00,2020-05-17 00:00:00,LABORABLE
17,5,2020,18,102,195,297,2020-05-17 17:00:00,2020-05-17 00:00:00,LABORABLE
17,5,2020,19,137,174,311,2020-05-17 18:00:00,2020-05-17 00:00:00,LABORABLE
17,5,2020,20,142,176,318,2020-05-17 19:00:00,2020-05-17 00:00:00,LABORABLE
17,5,2020,21,148,228,376,2020-05-17 20:00:00,2020-05-17 00:00:00,LABORABLE
17,5,2020,22,145,210,355,2020-05-17 21:00:00,2020-05-17 00:00:00,LABORABLE
17,5,2020,23,128,134,262,2020-05-17 22:00:00,2020-05-17 00:00:00,LABORABLE
17,5,2020,24,58,81,139,2020-05-17 23:00:00,2020-05-17 00:00:00,LABORABLE
18,5,2020,1,35,63,98,2020-05-18 00:00:00,2020-05-18 00:00:00,LABORABLE
18,5,2020,2,27,54,81,2020-05-18 01:00:00,2020-05-18 00:00:00,LABORABLE
18,5,2020,3,26,44,70,2020-05-18 02:00:00,2020-05-18 00:00:00,LABORABLE
18,5,2020,4,24,30,54,2020-05-18 03:00:00,2020-05-18 00:00:00,LABORABLE
18,5,2020,5,38,26,64,2020-05-18 04:00:00,2020-05-18 00:00:00,LABORABLE
18,5,2020,6,131,36,167,2020-05-18 05:00:00,2020-05-18 00:00:00,LABORABLE
18,5,2020,7,316,149,465,2020-05-18 06:00:00,2020-05-18 00:00:00,LABORABLE
18,5,2020,8,490,264,754,2020-05-18 07:00:00,2020-05-18 00:00:00,LABORABLE
18,5,2020,9,392,327,719,2020-05-18 08:00:00,2020-05-18 00:00:00,LABORABLE
18,5,2020,10,334,392,726,2020-05-18 09:00:00,2020-05-18 00:00:00,LABORABLE
18,5,2020,11,327,450,777,2020-05-18 10:00:00,2020-05-18 00:00:00,LABORABLE
18,5,2020,12,381,523,904,2020-05-18 11:00:00,2020-05-18 00:00:00,LABORABLE
18,5,2020,13,383,575,958,2020-05-18 12:00:00,2020-05-18 00:00:00,LABORABLE
18,5,2020,14,418,495,913,2020-05-18 13:00:00,2020-05-18 00:00:00,LABORABLE
18,5,2020,15,404,462,866,2020-05-18 14:00:00,2020-05-18 00:00:00,LABORABLE
18,5,2020,16,409,450,859,2020-05-18 15:00:00,2020-05-18 00:00:00,LABORABLE
18,5,2020,17,303,467,770,2020-05-18 16:00:00,2020-05-18 00:00:00,LABORABLE
18,5,2020,18,264,396,660,2020-05-18 17:00:00,2020-05-18 00:00:00,LABORABLE
18,5,2020,19,346,434,780,2020-05-18 18:00:00,2020-05-18 00:00:00,LABORABLE
18,5,2020,20,273,415,688,2020-05-18 19:00:00,2020-05-18 00:00:00,LABORABLE
18,5,2020,21,264,360,624,2020-05-18 20:00:00,2020-05-18 00:00:00,LABORABLE
18,5,2020,22,243,279,522,2020-05-18 21:00:00,2020-05-18 00:00:00,LABORABLE
18,5,2020,23,163,185,348,2020-05-18 22:00:00,2020-05-18 00:00:00,LABORABLE
18,5,2020,24,64,98,162,2020-05-18 23:00:00,2020-05-18 00:00:00,LABORABLE
19,5,2020,1,45,50,95,2020-05-19 00:00:00,2020-05-19 00:00:00,LABORABLE
19,5,2020,2,29,44,73,2020-05-19 01:00:00,2020-05-19 00:00:00,LABORABLE
19,5,2020,3,31,44,75,2020-05-19 02:00:00,2020-05-19 00:00:00,LABORABLE
19,5,2020,4,34,16,50,2020-05-19 03:00:00,2020-05-19 00:00:00,LABORABLE
19,5,2020,5,44,22,66,2020-05-19 04:00:00,2020-05-19 00:00:00,LABORABLE
19,5,2020,6,118,56,174,2020-05-19 05:00:00,2020-05-19 00:00:00,LABORABLE
19,5,2020,7,317,150,467,2020-05-19 06:00:00,2020-05-19 00:00:00,LABORABLE
19,5,2020,8,477,293,770,2020-05-19 07:00:00,2020-05-19 00:00:00,LABORABLE
19,5,2020,9,382,334,716,2020-05-19 08:00:00,2020-05-19 00:00:00,LABORABLE
19,5,2020,10,339,386,725,2020-05-19 09:00:00,2020-05-19 00:00:00,LABORABLE
19,5,2020,11,300,387,687,2020-05-19 10:00:00,2020-05-19 00:00:00,LABORABLE
19,5,2020,12,349,428,777,2020-05-19 11:00:00,2020-05-19 00:00:00,LABORABLE
19,5,2020,13,304,396,700,2020-05-19 12:00:00,2020-05-19 00:00:00,LABORABLE
19,5,2020,14,389,341,730,2020-05-19 13:00:00,2020-05-19 00:00:00,LABORABLE
19,5,2020,15,412,358,770,2020-05-19 14:00:00,2020-05-19 00:00:00,LABORABLE
19,5,2020,16,347,323,670,2020-05-19 15:00:00,2020-05-19 00:00:00,LABORABLE
19,5,2020,17,295,236,531,2020-05-19 16:00:00,2020-05-19 00:00:00,LABORABLE
19,5,2020,18,297,289,586,2020-05-19 17:00:00,2020-05-19 00:00:00,LABORABLE
19,5,2020,19,360,438,798,2020-05-19 18:00:00,2020-05-19 00:00:00,LABORABLE
19,5,2020,20,321,449,770,2020-05-19 19:00:00,2020-05-19 00:00:00,LABORABLE
19,5,2020,21,292,453,745,2020-05-19 20:00:00,2020-05-19 00:00:00,LABORABLE
19,5,2020,22,206,344,550,2020-05-19 21:00:00,2020-05-19 00:00:00,LABORABLE
19,5,2020,23,134,237,371,2020-05-19 22:00:00,2020-05-19 00:00:00,LABORABLE
19,5,2020,24,71,138,209,2020-05-19 23:00:00,2020-05-19 00:00:00,LABORABLE
20,5,2020,1,42,73,115,2020-05-20 00:00:00,2020-05-20 00:00:00,LABORABLE
20,5,2020,2,24,53,77,2020-05-20 01:00:00,2020-05-20 00:00:00,LABORABLE
20,5,2020,3,23,46,69,2020-05-20 02:00:00,2020-05-20 00:00:00,LABORABLE
20,5,2020,4,32,23,55,2020-05-20 03:00:00,2020-05-20 00:00:00,LABORABLE
20,5,2020,5,38,27,65,2020-05-20 04:00:00,2020-05-20 00:00:00,LABORABLE
20,5,2020,6,116,64,180,2020-05-20 05:00:00,2020-05-20 00:00:00,LABORABLE
20,5,2020,7,293,170,463,2020-05-20 06:00:00,2020-05-20 00:00:00,LABORABLE
20,5,2020,8,492,330,822,2020-05-20 07:00:00,2020-05-20 00:00:00,LABORABLE
20,5,2020,9,407,400,807,2020-05-20 08:00:00,2020-05-20 00:00:00,LABORABLE
20,5,2020,10,342,492,834,2020-05-20 09:00:00,2020-05-20 00:00:00,LABORABLE
20,5,2020,11,355,471,826,2020-05-20 10:00:00,2020-05-20 00:00:00,LABORABLE
20,5,2020,12,352,525,877,2020-05-20 11:00:00,2020-05-20 00:00:00,LABORABLE
20,5,2020,13,417,596,1013,2020-05-20 12:00:00,2020-05-20 00:00:00,LABORABLE
20,5,2020,14,418,616,1034,2020-05-20 13:00:00,2020-05-20 00:00:00,LABORABLE
20,5,2020,15,439,532,971,2020-05-20 14:00:00,2020-05-20 00:00:00,LABORABLE
20,5,2020,16,366,429,795,2020-05-20 15:00:00,2020-05-20 00:00:00,LABORABLE
20,5,2020,17,320,435,755,2020-05-20 16:00:00,2020-05-20 00:00:00,LABORABLE
20,5,2020,18,309,491,800,2020-05-20 17:00:00,2020-05-20 00:00:00,LABORABLE
20,5,2020,19,339,505,844,2020-05-20 18:00:00,2020-05-20 00:00:00,LABORABLE
20,5,2020,20,345,488,833,2020-05-20 19:00:00,2020-05-20 00:00:00,LABORABLE
20,5,2020,21,297,461,758,2020-05-20 20:00:00,2020-05-20 00:00:00,LABORABLE
20,5,2020,22,214,334,548,2020-05-20 21:00:00,2020-05-20 00:00:00,LABORABLE
20,5,2020,23,131,233,364,2020-05-20 22:00:00,2020-05-20 00:00:00,LABORABLE
20,5,2020,24,75,146,221,2020-05-20 23:00:00,2020-05-20 00:00:00,LABORABLE
21,5,2020,1,43,91,134,2020-05-21 00:00:00,2020-05-21 00:00:00,LABORABLE
21,5,2020,2,30,62,92,2020-05-21 01:00:00,2020-05-21 00:00:00,LABORABLE
21,5,2020,3,30,43,73,2020-05-21 02:00:00,2020-05-21 00:00:00,LABORABLE
21,5,2020,4,29,35,64,2020-05-21 03:00:00,2020-05-21 00:00:00,LABORABLE
21,5,2020,5,49,32,81,2020-05-21 04:00:00,2020-05-21 00:00:00,LABORABLE
21,5,2020,6,139,50,189,2020-05-21 05:00:00,2020-05-21 00:00:00,LABORABLE
21,5,2020,7,315,171,486,2020-05-21 06:00:00,2020-05-21 00:00:00,LABORABLE
21,5,2020,8,480,317,797,2020-05-21 07:00:00,2020-05-21 00:00:00,LABORABLE
21,5,2020,9,386,405,791,2020-05-21 08:00:00,2020-05-21 00:00:00,LABORABLE
21,5,2020,10,323,541,864,2020-05-21 09:00:00,2020-05-21 00:00:00,LABORABLE
21,5,2020,11,322,561,883,2020-05-21 10:00:00,2020-05-21 00:00:00,LABORABLE
21,5,2020,12,352,609,961,2020-05-21 11:00:00,2020-05-21 00:00:00,LABORABLE
21,5,2020,13,389,611,1000,2020-05-21 12:00:00,2020-05-21 00:00:00,LABORABLE
21,5,2020,14,421,594,1015,2020-05-21 13:00:00,2020-05-21 00:00:00,LABORABLE
21,5,2020,15,407,563,970,2020-05-21 14:00:00,2020-05-21 00:00:00,LABORABLE
21,5,2020,16,369,519,888,2020-05-21 15:00:00,2020-05-21 00:00:00,LABORABLE
21,5,2020,17,291,476,767,2020-05-21 16:00:00,2020-05-21 00:00:00,LABORABLE
21,5,2020,18,321,499,820,2020-05-21 17:00:00,2020-05-21 00:00:00,LABORABLE
21,5,2020,19,392,531,923,2020-05-21 18:00:00,2020-05-21 00:00:00,LABORABLE
21,5,2020,20,322,538,860,2020-05-21 19:00:00,2020-05-21 00:00:00,LABORABLE
21,5,2020,21,305,470,775,2020-05-21 20:00:00,2020-05-21 00:00:00,LABORABLE
21,5,2020,22,226,347,573,2020-05-21 21:00:00,2020-05-21 00:00:00,LABORABLE
21,5,2020,23,141,248,389,2020-05-21 22:00:00,2020-05-21 00:00:00,LABORABLE
21,5,2020,24,81,132,213,2020-05-21 23:00:00,2020-05-21 00:00:00,LABORABLE
22,5,2020,1,53,84,137,2020-05-22 00:00:00,2020-05-22 00:00:00,LABORABLE
22,5,2020,2,53,76,129,2020-05-22 01:00:00,2020-05-22 00:00:00,LABORABLE
22,5,2020,3,34,46,80,2020-05-22 02:00:00,2020-05-22 00:00:00,LABORABLE
22,5,2020,4,30,37,67,2020-05-22 03:00:00,2020-05-22 00:00:00,LABORABLE
22,5,2020,5,44,42,86,2020-05-22 04:00:00,2020-05-22 00:00:00,LABORABLE
22,5,2020,6,135,70,205,2020-05-22 05:00:00,2020-05-22 00:00:00,LABORABLE
22,5,2020,7,325,187,512,2020-05-22 06:00:00,2020-05-22 00:00:00,LABORABLE
22,5,2020,8,465,275,740,2020-05-22 07:00:00,2020-05-22 00:00:00,LABORABLE
22,5,2020,9,428,423,851,2020-05-22 08:00:00,2020-05-22 00:00:00,LABORABLE
22,5,2020,10,358,536,894,2020-05-22 09:00:00,2020-05-22 00:00:00,LABORABLE
22,5,2020,11,352,578,930,2020-05-22 10:00:00,2020-05-22 00:00:00,LABORABLE
22,5,2020,12,328,591,919,2020-05-22 11:00:00,2020-05-22 00:00:00,LABORABLE
22,5,2020,13,380,548,928,2020-05-22 12:00:00,2020-05-22 00:00:00,LABORABLE
22,5,2020,14,424,649,1073,2020-05-22 13:00:00,2020-05-22 00:00:00,LABORABLE
22,5,2020,15,458,606,1064,2020-05-22 14:00:00,2020-05-22 00:00:00,LABORABLE
22,5,2020,16,395,578,973,2020-05-22 15:00:00,2020-05-22 00:00:00,LABORABLE
22,5,2020,17,335,533,868,2020-05-22 16:00:00,2020-05-22 00:00:00,LABORABLE
22,5,2020,18,321,503,824,2020-05-22 17:00:00,2020-05-22 00:00:00,LABORABLE
22,5,2020,19,386,607,993,2020-05-22 18:00:00,2020-05-22 00:00:00,LABORABLE
22,5,2020,20,364,600,964,2020-05-22 19:00:00,2020-05-22 00:00:00,LABORABLE
22,5,2020,21,335,579,914,2020-05-22 20:00:00,2020-05-22 00:00:00,LABORABLE
22,5,2020,22,259,479,738,2020-05-22 21:00:00,2020-05-22 00:00:00,LABORABLE
22,5,2020,23,183,298,481,2020-05-22 22:00:00,2020-05-22 00:00:00,LABORABLE
22,5,2020,24,99,148,247,2020-05-22 23:00:00,2020-05-22 00:00:00,LABORABLE
23,5,2020,1,64,121,185,2020-05-23 00:00:00,2020-05-23 00:00:00,LABORABLE
23,5,2020,2,38,84,122,2020-05-23 01:00:00,2020-05-23 00:00:00,LABORABLE
23,5,2020,3,40,64,104,2020-05-23 02:00:00,2020-05-23 00:00:00,LABORABLE
23,5,2020,4,44,46,90,2020-05-23 03:00:00,2020-05-23 00:00:00,LABORABLE
23,5,2020,5,38,31,69,2020-05-23 04:00:00,2020-05-23 00:00:00,LABORABLE
23,5,2020,6,71,50,121,2020-05-23 05:00:00,2020-05-23 00:00:00,LABORABLE
23,5,2020,7,126,101,227,2020-05-23 06:00:00,2020-05-23 00:00:00,LABORABLE
23,5,2020,8,196,177,373,2020-05-23 07:00:00,2020-05-23 00:00:00,LABORABLE
23,5,2020,9,209,307,516,2020-05-23 08:00:00,2020-05-23 00:00:00,LABORABLE
23,5,2020,10,209,411,620,2020-05-23 09:00:00,2020-05-23 00:00:00,LABORABLE
23,5,2020,11,253,513,766,2020-05-23 10:00:00,2020-05-23 00:00:00,LABORABLE
23,5,2020,12,302,511,813,2020-05-23 11:00:00,2020-05-23 00:00:00,LABORABLE
23,5,2020,13,320,571,891,2020-05-23 12:00:00,2020-05-23 00:00:00,LABORABLE
23,5,2020,14,306,570,876,2020-05-23 13:00:00,2020-05-23 00:00:00,LABORABLE
23,5,2020,15,356,564,920,2020-05-23 14:00:00,2020-05-23 00:00:00,LABORABLE
23,5,2020,16,263,501,764,2020-05-23 15:00:00,2020-05-23 00:00:00,LABORABLE
23,5,2020,17,202,460,662,2020-05-23 16:00:00,2020-05-23 00:00:00,LABORABLE
23,5,2020,18,208,420,628,2020-05-23 17:00:00,2020-05-23 00:00:00,LABORABLE
23,5,2020,19,220,406,626,2020-05-23 18:00:00,2020-05-23 00:00:00,LABORABLE
23,5,2020,20,196,457,653,2020-05-23 19:00:00,2020-05-23 00:00:00,LABORABLE
23,5,2020,21,209,482,691,2020-05-23 20:00:00,2020-05-23 00:00:00,LABORABLE
23,5,2020,22,190,391,581,2020-05-23 21:00:00,2020-05-23 00:00:00,LABORABLE
23,5,2020,23,151,295,446,2020-05-23 22:00:00,2020-05-23 00:00:00,LABORABLE
23,5,2020,24,106,151,257,2020-05-23 23:00:00,2020-05-23 00:00:00,LABORABLE
24,5,2020,1,75,135,210,2020-05-24 00:00:00,2020-05-24 00:00:00,LABORABLE
24,5,2020,2,31,74,105,2020-05-24 01:00:00,2020-05-24 00:00:00,LABORABLE
24,5,2020,3,32,67,99,2020-05-24 02:00:00,2020-05-24 00:00:00,LABORABLE
24,5,2020,4,20,41,61,2020-05-24 03:00:00,2020-05-24 00:00:00,LABORABLE
24,5,2020,5,15,34,49,2020-05-24 04:00:00,2020-05-24 00:00:00,LABORABLE
24,5,2020,6,28,44,72,2020-05-24 05:00:00,2020-05-24 00:00:00,LABORABLE
24,5,2020,7,52,61,113,2020-05-24 06:00:00,2020-05-24 00:00:00,LABORABLE
24,5,2020,8,105,79,184,2020-05-24 07:00:00,2020-05-24 00:00:00,LABORABLE
24,5,2020,9,108,180,288,2020-05-24 08:00:00,2020-05-24 00:00:00,LABORABLE
24,5,2020,10,133,272,405,2020-05-24 09:00:00,2020-05-24 00:00:00,LABORABLE
24,5,2020,11,161,306,467,2020-05-24 10:00:00,2020-05-24 00:00:00,LABORABLE
24,5,2020,12,190,404,594,2020-05-24 11:00:00,2020-05-24 00:00:00,LABORABLE
24,5,2020,13,217,411,628,2020-05-24 12:00:00,2020-05-24 00:00:00,LABORABLE
24,5,2020,14,217,468,685,2020-05-24 13:00:00,2020-05-24 00:00:00,LABORABLE
24,5,2020,15,220,464,684,2020-05-24 14:00:00,2020-05-24 00:00:00,LABORABLE
24,5,2020,16,179,359,538,2020-05-24 15:00:00,2020-05-24 00:00:00,LABORABLE
24,5,2020,17,147,317,464,2020-05-24 16:00:00,2020-05-24 00:00:00,LABORABLE
24,5,2020,18,155,298,453,2020-05-24 17:00:00,2020-05-24 00:00:00,LABORABLE
24,5,2020,19,150,314,464,2020-05-24 18:00:00,2020-05-24 00:00:00,LABORABLE
24,5,2020,20,181,371,552,2020-05-24 19:00:00,2020-05-24 00:00:00,LABORABLE
24,5,2020,21,194,412,606,2020-05-24 20:00:00,2020-05-24 00:00:00,LABORABLE
24,5,2020,22,169,339,508,2020-05-24 21:00:00,2020-05-24 00:00:00,LABORABLE
24,5,2020,23,143,230,373,2020-05-24 22:00:00,2020-05-24 00:00:00,LABORABLE
24,5,2020,24,86,142,228,2020-05-24 23:00:00,2020-05-24 00:00:00,LABORABLE
25,5,2020,1,47,138,185,2020-05-25 00:00:00,2020-05-25 00:00:00,LABORABLE
25,5,2020,2,29,81,110,2020-05-25 01:00:00,2020-05-25 00:00:00,LABORABLE
25,5,2020,3,31,43,74,2020-05-25 02:00:00,2020-05-25 00:00:00,LABORABLE
25,5,2020,4,37,41,78,2020-05-25 03:00:00,2020-05-25 00:00:00,LABORABLE
25,5,2020,5,40,38,78,2020-05-25 04:00:00,2020-05-25 00:00:00,LABORABLE
25,5,2020,6,110,78,188,2020-05-25 05:00:00,2020-05-25 00:00:00,LABORABLE
25,5,2020,7,360,191,551,2020-05-25 06:00:00,2020-05-25 00:00:00,LABORABLE
25,5,2020,8,508,311,819,2020-05-25 07:00:00,2020-05-25 00:00:00,LABORABLE
25,5,2020,9,488,474,962,2020-05-25 08:00:00,2020-05-25 00:00:00,LABORABLE
25,5,2020,10,446,615,1061,2020-05-25 09:00:00,2020-05-25 00:00:00,LABORABLE
25,5,2020,11,389,692,1081,2020-05-25 10:00:00,2020-05-25 00:00:00,LABORABLE
25,5,2020,12,382,671,1053,2020-05-25 11:00:00,2020-05-25 00:00:00,LABORABLE
25,5,2020,13,533,776,1309,2020-05-25 12:00:00,2020-05-25 00:00:00,LABORABLE
25,5,2020,14,537,781,1318,2020-05-25 13:00:00,2020-05-25 00:00:00,LABORABLE
25,5,2020,15,522,688,1210,2020-05-25 14:00:00,2020-05-25 00:00:00,LABORABLE
25,5,2020,16,472,500,972,2020-05-25 15:00:00,2020-05-25 00:00:00,LABORABLE
25,5,2020,17,387,458,845,2020-05-25 16:00:00,2020-05-25 00:00:00,LABORABLE
25,5,2020,18,524,382,906,2020-05-25 17:00:00,2020-05-25 00:00:00,LABORABLE
25,5,2020,19,563,447,1010,2020-05-25 18:00:00,2020-05-25 00:00:00,LABORABLE
25,5,2020,20,526,423,949,2020-05-25 19:00:00,2020-05-25 00:00:00,LABORABLE
25,5,2020,21,503,368,871,2020-05-25 20:00:00,2020-05-25 00:00:00,LABORABLE
25,5,2020,22,381,281,662,2020-05-25 21:00:00,2020-05-25 00:00:00,LABORABLE
25,5,2020,23,264,191,455,2020-05-25 22:00:00,2020-05-25 00:00:00,LABORABLE
25,5,2020,24,181,98,279,2020-05-25 23:00:00,2020-05-25 00:00:00,LABORABLE
26,5,2020,1,91,52,143,2020-05-26 00:00:00,2020-05-26 00:00:00,LABORABLE
26,5,2020,2,61,48,109,2020-05-26 01:00:00,2020-05-26 00:00:00,LABORABLE
26,5,2020,3,49,44,93,2020-05-26 02:00:00,2020-05-26 00:00:00,LABORABLE
26,5,2020,4,42,16,58,2020-05-26 03:00:00,2020-05-26 00:00:00,LABORABLE
26,5,2020,5,47,23,70,2020-05-26 04:00:00,2020-05-26 00:00:00,LABORABLE
26,5,2020,6,117,55,172,2020-05-26 05:00:00,2020-05-26 00:00:00,LABORABLE
26,5,2020,7,341,145,486,2020-05-26 06:00:00,2020-05-26 00:00:00,LABORABLE
26,5,2020,8,535,305,840,2020-05-26 07:00:00,2020-05-26 00:00:00,LABORABLE
26,5,2020,9,480,406,886,2020-05-26 08:00:00,2020-05-26 00:00:00,LABORABLE
26,5,2020,10,481,568,1049,2020-05-26 09:00:00,2020-05-26 00:00:00,LABORABLE
26,5,2020,11,406,578,984,2020-05-26 10:00:00,2020-05-26 00:00:00,LABORABLE
26,5,2020,12,498,709,1207,2020-05-26 11:00:00,2020-05-26 00:00:00,LABORABLE
26,5,2020,13,507,710,1217,2020-05-26 12:00:00,2020-05-26 00:00:00,LABORABLE
26,5,2020,14,549,740,1289,2020-05-26 13:00:00,2020-05-26 00:00:00,LABORABLE
26,5,2020,15,518,682,1200,2020-05-26 14:00:00,2020-05-26 00:00:00,LABORABLE
26,5,2020,16,450,576,1026,2020-05-26 15:00:00,2020-05-26 00:00:00,LABORABLE
26,5,2020,17,429,637,1066,2020-05-26 16:00:00,2020-05-26 00:00:00,LABORABLE
26,5,2020,18,511,616,1127,2020-05-26 17:00:00,2020-05-26 00:00:00,LABORABLE
26,5,2020,19,542,680,1222,2020-05-26 18:00:00,2020-05-26 00:00:00,LABORABLE
26,5,2020,20,491,739,1230,2020-05-26 19:00:00,2020-05-26 00:00:00,LABORABLE
26,5,2020,21,458,617,1075,2020-05-26 20:00:00,2020-05-26 00:00:00,LABORABLE
26,5,2020,22,395,440,835,2020-05-26 21:00:00,2020-05-26 00:00:00,LABORABLE
26,5,2020,23,271,358,629,2020-05-26 22:00:00,2020-05-26 00:00:00,LABORABLE
26,5,2020,24,153,209,362,2020-05-26 23:00:00,2020-05-26 00:00:00,LABORABLE
27,5,2020,1,110,147,257,2020-05-27 00:00:00,2020-05-27 00:00:00,LABORABLE
27,5,2020,2,71,98,169,2020-05-27 01:00:00,2020-05-27 00:00:00,LABORABLE
27,5,2020,3,41,69,110,2020-05-27 02:00:00,2020-05-27 00:00:00,LABORABLE
27,5,2020,4,44,45,89,2020-05-27 03:00:00,2020-05-27 00:00:00,LABORABLE
27,5,2020,5,48,42,90,2020-05-27 04:00:00,2020-05-27 00:00:00,LABORABLE
27,5,2020,6,127,59,186,2020-05-27 05:00:00,2020-05-27 00:00:00,LABORABLE
27,5,2020,7,334,170,504,2020-05-27 06:00:00,2020-05-27 00:00:00,LABORABLE
27,5,2020,8,542,357,899,2020-05-27 07:00:00,2020-05-27 00:00:00,LABORABLE
27,5,2020,9,482,463,945,2020-05-27 08:00:00,2020-05-27 00:00:00,LABORABLE
27,5,2020,10,457,620,1077,2020-05-27 09:00:00,2020-05-27 00:00:00,LABORABLE
27,5,2020,11,450,651,1101,2020-05-27 10:00:00,2020-05-27 00:00:00,LABORABLE
27,5,2020,12,484,781,1265,2020-05-27 11:00:00,2020-05-27 00:00:00,LABORABLE
27,5,2020,13,398,726,1124,2020-05-27 12:00:00,2020-05-27 00:00:00,LABORABLE
27,5,2020,14,492,595,1087,2020-05-27 13:00:00,2020-05-27 00:00:00,LABORABLE
27,5,2020,15,553,755,1308,2020-05-27 14:00:00,2020-05-27 00:00:00,LABORABLE
27,5,2020,16,447,665,1112,2020-05-27 15:00:00,2020-05-27 00:00:00,LABORABLE
27,5,2020,17,399,663,1062,2020-05-27 16:00:00,2020-05-27 00:00:00,LABORABLE
27,5,2020,18,487,704,1191,2020-05-27 17:00:00,2020-05-27 00:00:00,LABORABLE
27,5,2020,19,521,844,1365,2020-05-27 18:00:00,2020-05-27 00:00:00,LABORABLE
27,5,2020,20,512,832,1344,2020-05-27 19:00:00,2020-05-27 00:00:00,LABORABLE
27,5,2020,21,483,657,1140,2020-05-27 20:00:00,2020-05-27 00:00:00,LABORABLE
27,5,2020,22,358,533,891,2020-05-27 21:00:00,2020-05-27 00:00:00,LABORABLE
27,5,2020,23,280,367,647,2020-05-27 22:00:00,2020-05-27 00:00:00,LABORABLE
27,5,2020,24,193,233,426,2020-05-27 23:00:00,2020-05-27 00:00:00,LABORABLE
28,5,2020,1,130,167,297,2020-05-28 00:00:00,2020-05-28 00:00:00,LABORABLE
28,5,2020,2,84,119,203,2020-05-28 01:00:00,2020-05-28 00:00:00,LABORABLE
28,5,2020,3,41,83,124,2020-05-28 02:00:00,2020-05-28 00:00:00,LABORABLE
28,5,2020,4,42,45,87,2020-05-28 03:00:00,2020-05-28 00:00:00,LABORABLE
28,5,2020,5,56,50,106,2020-05-28 04:00:00,2020-05-28 00:00:00,LABORABLE
28,5,2020,6,131,84,215,2020-05-28 05:00:00,2020-05-28 00:00:00,LABORABLE
28,5,2020,7,344,192,536,2020-05-28 06:00:00,2020-05-28 00:00:00,LABORABLE
28,5,2020,8,484,376,860,2020-05-28 07:00:00,2020-05-28 00:00:00,LABORABLE
28,5,2020,9,472,533,1005,2020-05-28 08:00:00,2020-05-28 00:00:00,LABORABLE
28,5,2020,10,341,567,908,2020-05-28 09:00:00,2020-05-28 00:00:00,LABORABLE
28,5,2020,11,468,657,1125,2020-05-28 10:00:00,2020-05-28 00:00:00,LABORABLE
28,5,2020,12,62,640,702,2020-05-28 11:00:00,2020-05-28 00:00:00,LABORABLE
28,5,2020,13,0,733,733,2020-05-28 12:00:00,2020-05-28 00:00:00,LABORABLE
28,5,2020,14,105,791,896,2020-05-28 13:00:00,2020-05-28 00:00:00,LABORABLE
28,5,2020,15,558,658,1216,2020-05-28 14:00:00,2020-05-28 00:00:00,LABORABLE
28,5,2020,16,450,618,1068,2020-05-28 15:00:00,2020-05-28 00:00:00,LABORABLE
28,5,2020,17,416,573,989,2020-05-28 16:00:00,2020-05-28 00:00:00,LABORABLE
28,5,2020,18,459,697,1156,2020-05-28 17:00:00,2020-05-28 00:00:00,LABORABLE
28,5,2020,19,547,734,1281,2020-05-28 18:00:00,2020-05-28 00:00:00,LABORABLE
28,5,2020,20,534,711,1245,2020-05-28 19:00:00,2020-05-28 00:00:00,LABORABLE
28,5,2020,21,498,710,1208,2020-05-28 20:00:00,2020-05-28 00:00:00,LABORABLE
28,5,2020,22,375,524,899,2020-05-28 21:00:00,2020-05-28 00:00:00,LABORABLE
28,5,2020,23,271,391,662,2020-05-28 22:00:00,2020-05-28 00:00:00,LABORABLE
28,5,2020,24,175,234,409,2020-05-28 23:00:00,2020-05-28 00:00:00,LABORABLE
29,5,2020,1,118,207,325,2020-05-29 00:00:00,2020-05-29 00:00:00,LABORABLE
29,5,2020,2,92,149,241,2020-05-29 01:00:00,2020-05-29 00:00:00,LABORABLE
29,5,2020,3,56,109,165,2020-05-29 02:00:00,2020-05-29 00:00:00,LABORABLE
29,5,2020,4,55,60,115,2020-05-29 03:00:00,2020-05-29 00:00:00,LABORABLE
29,5,2020,5,54,47,101,2020-05-29 04:00:00,2020-05-29 00:00:00,LABORABLE
29,5,2020,6,141,68,209,2020-05-29 05:00:00,2020-05-29 00:00:00,LABORABLE
29,5,2020,7,345,198,543,2020-05-29 06:00:00,2020-05-29 00:00:00,LABORABLE
29,5,2020,8,508,387,895,2020-05-29 07:00:00,2020-05-29 00:00:00,LABORABLE
29,5,2020,9,473,522,995,2020-05-29 08:00:00,2020-05-29 00:00:00,LABORABLE
29,5,2020,10,467,644,1111,2020-05-29 09:00:00,2020-05-29 00:00:00,LABORABLE
29,5,2020,11,479,645,1124,2020-05-29 10:00:00,2020-05-29 00:00:00,LABORABLE
29,5,2020,12,519,744,1263,2020-05-29 11:00:00,2020-05-29 00:00:00,LABORABLE
29,5,2020,13,530,756,1286,2020-05-29 12:00:00,2020-05-29 00:00:00,LABORABLE
29,5,2020,14,567,785,1352,2020-05-29 13:00:00,2020-05-29 00:00:00,LABORABLE
29,5,2020,15,590,732,1322,2020-05-29 14:00:00,2020-05-29 00:00:00,LABORABLE
29,5,2020,16,514,672,1186,2020-05-29 15:00:00,2020-05-29 00:00:00,LABORABLE
29,5,2020,17,428,634,1062,2020-05-29 16:00:00,2020-05-29 00:00:00,LABORABLE
29,5,2020,18,562,677,1239,2020-05-29 17:00:00,2020-05-29 00:00:00,LABORABLE
29,5,2020,19,579,660,1239,2020-05-29 18:00:00,2020-05-29 00:00:00,LABORABLE
29,5,2020,20,494,772,1266,2020-05-29 19:00:00,2020-05-29 00:00:00,LABORABLE
29,5,2020,21,509,759,1268,2020-05-29 20:00:00,2020-05-29 00:00:00,LABORABLE
29,5,2020,22,446,630,1076,2020-05-29 21:00:00,2020-05-29 00:00:00,LABORABLE
29,5,2020,23,351,440,791,2020-05-29 22:00:00,2020-05-29 00:00:00,LABORABLE
29,5,2020,24,227,254,481,2020-05-29 23:00:00,2020-05-29 00:00:00,LABORABLE
30,5,2020,1,201,251,452,2020-05-30 00:00:00,2020-05-30 00:00:00,LABORABLE
30,5,2020,2,140,164,304,2020-05-30 01:00:00,2020-05-30 00:00:00,LABORABLE
30,5,2020,3,116,144,260,2020-05-30 02:00:00,2020-05-30 00:00:00,LABORABLE
30,5,2020,4,52,77,129,2020-05-30 03:00:00,2020-05-30 00:00:00,LABORABLE
30,5,2020,5,57,68,125,2020-05-30 04:00:00,2020-05-30 00:00:00,LABORABLE
30,5,2020,6,84,80,164,2020-05-30 05:00:00,2020-05-30 00:00:00,LABORABLE
30,5,2020,7,139,105,244,2020-05-30 06:00:00,2020-05-30 00:00:00,LABORABLE
30,5,2020,8,238,230,468,2020-05-30 07:00:00,2020-05-30 00:00:00,LABORABLE
30,5,2020,9,294,373,667,2020-05-30 08:00:00,2020-05-30 00:00:00,LABORABLE
30,5,2020,10,352,485,837,2020-05-30 09:00:00,2020-05-30 00:00:00,LABORABLE
30,5,2020,11,375,651,1026,2020-05-30 10:00:00,2020-05-30 00:00:00,LABORABLE
30,5,2020,12,491,761,1252,2020-05-30 11:00:00,2020-05-30 00:00:00,LABORABLE
30,5,2020,13,576,874,1450,2020-05-30 12:00:00,2020-05-30 00:00:00,LABORABLE
30,5,2020,14,593,883,1476,2020-05-30 13:00:00,2020-05-30 00:00:00,LABORABLE
30,5,2020,15,496,832,1328,2020-05-30 14:00:00,2020-05-30 00:00:00,LABORABLE
30,5,2020,16,410,659,1069,2020-05-30 15:00:00,2020-05-30 00:00:00,LABORABLE
30,5,2020,17,351,606,957,2020-05-30 16:00:00,2020-05-30 00:00:00,LABORABLE
30,5,2020,18,360,624,984,2020-05-30 17:00:00,2020-05-30 00:00:00,LABORABLE
30,5,2020,19,437,732,1169,2020-05-30 18:00:00,2020-05-30 00:00:00,LABORABLE
30,5,2020,20,486,770,1256,2020-05-30 19:00:00,2020-05-30 00:00:00,LABORABLE
30,5,2020,21,449,774,1223,2020-05-30 20:00:00,2020-05-30 00:00:00,LABORABLE
30,5,2020,22,452,671,1123,2020-05-30 21:00:00,2020-05-30 00:00:00,LABORABLE
30,5,2020,23,334,427,761,2020-05-30 22:00:00,2020-05-30 00:00:00,LABORABLE
30,5,2020,24,252,215,467,2020-05-30 23:00:00,2020-05-30 00:00:00,LABORABLE
31,5,2020,1,219,311,530,2020-05-31 00:00:00,2020-05-31 00:00:00,LABORABLE
31,5,2020,2,158,230,388,2020-05-31 01:00:00,2020-05-31 00:00:00,LABORABLE
31,5,2020,3,131,154,285,2020-05-31 02:00:00,2020-05-31 00:00:00,LABORABLE
31,5,2020,4,79,118,197,2020-05-31 03:00:00,2020-05-31 00:00:00,LABORABLE
31,5,2020,5,49,74,123,2020-05-31 04:00:00,2020-05-31 00:00:00,LABORABLE
31,5,2020,6,44,60,104,2020-05-31 05:00:00,2020-05-31 00:00:00,LABORABLE
31,5,2020,7,74,57,131,2020-05-31 06:00:00,2020-05-31 00:00:00,LABORABLE
31,5,2020,8,120,110,230,2020-05-31 07:00:00,2020-05-31 00:00:00,LABORABLE
31,5,2020,9,149,222,371,2020-05-31 08:00:00,2020-05-31 00:00:00,LABORABLE
31,5,2020,10,202,332,534,2020-05-31 09:00:00,2020-05-31 00:00:00,LABORABLE
31,5,2020,11,299,437,736,2020-05-31 10:00:00,2020-05-31 00:00:00,LABORABLE
31,5,2020,12,357,541,898,2020-05-31 11:00:00,2020-05-31 00:00:00,LABORABLE
31,5,2020,13,450,654,1104,2020-05-31 12:00:00,2020-05-31 00:00:00,LABORABLE
31,5,2020,14,428,730,1158,2020-05-31 13:00:00,2020-05-31 00:00:00,LABORABLE
31,5,2020,15,385,674,1059,2020-05-31 14:00:00,2020-05-31 00:00:00,LABORABLE
31,5,2020,16,290,519,809,2020-05-31 15:00:00,2020-05-31 00:00:00,LABORABLE
31,5,2020,17,254,495,749,2020-05-31 16:00:00,2020-05-31 00:00:00,LABORABLE
31,5,2020,18,348,552,900,2020-05-31 17:00:00,2020-05-31 00:00:00,LABORABLE
31,5,2020,19,305,605,910,2020-05-31 18:00:00,2020-05-31 00:00:00,LABORABLE
31,5,2020,20,418,679,1097,2020-05-31 19:00:00,2020-05-31 00:00:00,LABORABLE
31,5,2020,21,389,646,1035,2020-05-31 20:00:00,2020-05-31 00:00:00,LABORABLE
31,5,2020,22,320,490,810,2020-05-31 21:00:00,2020-05-31 00:00:00,LABORABLE
31,5,2020,23,258,357,615,2020-05-31 22:00:00,2020-05-31 00:00:00,LABORABLE
31,5,2020,24,171,229,400,2020-05-31 23:00:00,2020-05-31 00:00:00,LABORABLE
1,6,2020,1,116,169,285,2020-06-01 00:00:00,2020-01-06 00:00:00,LABORABLE
1,6,2020,2,73,113,186,2020-06-01 01:00:00,2020-01-06 00:00:00,LABORABLE
1,6,2020,3,45,70,115,2020-06-01 02:00:00,2020-01-06 00:00:00,LABORABLE
1,6,2020,4,36,36,72,2020-06-01 03:00:00,2020-01-06 00:00:00,LABORABLE
1,6,2020,5,56,28,84,2020-06-01 04:00:00,2020-01-06 00:00:00,LABORABLE
1,6,2020,6,142,54,196,2020-06-01 05:00:00,2020-01-06 00:00:00,LABORABLE
1,6,2020,7,344,155,499,2020-06-01 06:00:00,2020-01-06 00:00:00,LABORABLE
1,6,2020,8,558,314,872,2020-06-01 07:00:00,2020-01-06 00:00:00,LABORABLE
1,6,2020,9,502,447,949,2020-06-01 08:00:00,2020-01-06 00:00:00,LABORABLE
1,6,2020,10,461,502,963,2020-06-01 09:00:00,2020-01-06 00:00:00,LABORABLE
1,6,2020,11,476,545,1021,2020-06-01 10:00:00,2020-01-06 00:00:00,LABORABLE
1,6,2020,12,518,538,1056,2020-06-01 11:00:00,2020-01-06 00:00:00,LABORABLE
1,6,2020,13,524,555,1079,2020-06-01 12:00:00,2020-01-06 00:00:00,LABORABLE
1,6,2020,14,578,602,1180,2020-06-01 13:00:00,2020-01-06 00:00:00,LABORABLE
1,6,2020,15,629,554,1183,2020-06-01 14:00:00,2020-01-06 00:00:00,LABORABLE
1,6,2020,16,534,530,1064,2020-06-01 15:00:00,2020-01-06 00:00:00,LABORABLE
1,6,2020,17,460,512,972,2020-06-01 16:00:00,2020-01-06 00:00:00,LABORABLE
1,6,2020,18,542,604,1146,2020-06-01 17:00:00,2020-01-06 00:00:00,LABORABLE
1,6,2020,19,534,676,1210,2020-06-01 18:00:00,2020-01-06 00:00:00,LABORABLE
1,6,2020,20,525,695,1220,2020-06-01 19:00:00,2020-01-06 00:00:00,LABORABLE
1,6,2020,21,496,591,1087,2020-06-01 20:00:00,2020-01-06 00:00:00,LABORABLE
1,6,2020,22,347,431,778,2020-06-01 21:00:00,2020-01-06 00:00:00,LABORABLE
1,6,2020,23,259,281,540,2020-06-01 22:00:00,2020-01-06 00:00:00,LABORABLE
1,6,2020,24,177,185,362,2020-06-01 23:00:00,2020-01-06 00:00:00,LABORABLE
2,6,2020,1,109,151,260,2020-06-02 00:00:00,2020-02-06 00:00:00,LABORABLE
2,6,2020,2,85,115,200,2020-06-02 01:00:00,2020-02-06 00:00:00,LABORABLE
2,6,2020,3,47,60,107,2020-06-02 02:00:00,2020-02-06 00:00:00,LABORABLE
2,6,2020,4,46,33,79,2020-06-02 03:00:00,2020-02-06 00:00:00,LABORABLE
2,6,2020,5,47,29,76,2020-06-02 04:00:00,2020-02-06 00:00:00,LABORABLE
2,6,2020,6,136,54,190,2020-06-02 05:00:00,2020-02-06 00:00:00,LABORABLE
2,6,2020,7,339,143,482,2020-06-02 06:00:00,2020-02-06 00:00:00,LABORABLE
2,6,2020,8,534,304,838,2020-06-02 07:00:00,2020-02-06 00:00:00,LABORABLE
2,6,2020,9,507,442,949,2020-06-02 08:00:00,2020-02-06 00:00:00,LABORABLE
2,6,2020,10,518,504,1022,2020-06-02 09:00:00,2020-02-06 00:00:00,LABORABLE
2,6,2020,11,533,510,1043,2020-06-02 10:00:00,2020-02-06 00:00:00,LABORABLE
2,6,2020,12,383,592,975,2020-06-02 11:00:00,2020-02-06 00:00:00,LABORABLE
2,6,2020,13,567,661,1228,2020-06-02 12:00:00,2020-02-06 00:00:00,LABORABLE
2,6,2020,14,470,626,1096,2020-06-02 13:00:00,2020-02-06 00:00:00,LABORABLE
2,6,2020,15,574,550,1124,2020-06-02 14:00:00,2020-02-06 00:00:00,LABORABLE
2,6,2020,16,480,502,982,2020-06-02 15:00:00,2020-02-06 00:00:00,LABORABLE
2,6,2020,17,435,520,955,2020-06-02 16:00:00,2020-02-06 00:00:00,LABORABLE
2,6,2020,18,528,570,1098,2020-06-02 17:00:00,2020-02-06 00:00:00,LABORABLE
2,6,2020,19,543,643,1186,2020-06-02 18:00:00,2020-02-06 00:00:00,LABORABLE
2,6,2020,20,525,676,1201,2020-06-02 19:00:00,2020-02-06 00:00:00,LABORABLE
2,6,2020,21,461,522,983,2020-06-02 20:00:00,2020-02-06 00:00:00,LABORABLE
2,6,2020,22,381,439,820,2020-06-02 21:00:00,2020-02-06 00:00:00,LABORABLE
2,6,2020,23,277,340,617,2020-06-02 22:00:00,2020-02-06 00:00:00,LABORABLE
2,6,2020,24,207,212,419,2020-06-02 23:00:00,2020-02-06 00:00:00,LABORABLE
3,6,2020,1,108,149,257,2020-06-03 00:00:00,2020-03-06 00:00:00,LABORABLE
3,6,2020,2,83,110,193,2020-06-03 01:00:00,2020-03-06 00:00:00,LABORABLE
3,6,2020,3,45,61,106,2020-06-03 02:00:00,2020-03-06 00:00:00,LABORABLE
3,6,2020,4,46,33,79,2020-06-03 03:00:00,2020-03-06 00:00:00,LABORABLE
3,6,2020,5,45,33,78,2020-06-03 04:00:00,2020-03-06 00:00:00,LABORABLE
3,6,2020,6,129,57,186,2020-06-03 05:00:00,2020-03-06 00:00:00,LABORABLE
3,6,2020,7,328,153,481,2020-06-03 06:00:00,2020-03-06 00:00:00,LABORABLE
3,6,2020,8,532,293,825,2020-06-03 07:00:00,2020-03-06 00:00:00,LABORABLE
3,6,2020,9,526,417,943,2020-06-03 08:00:00,2020-03-06 00:00:00,LABORABLE
3,6,2020,10,504,529,1033,2020-06-03 09:00:00,2020-03-06 00:00:00,LABORABLE
3,6,2020,11,482,552,1034,2020-06-03 10:00:00,2020-03-06 00:00:00,LABORABLE
3,6,2020,12,522,552,1074,2020-06-03 11:00:00,2020-03-06 00:00:00,LABORABLE
3,6,2020,13,528,556,1084,2020-06-03 12:00:00,2020-03-06 00:00:00,LABORABLE
3,6,2020,14,548,580,1128,2020-06-03 13:00:00,2020-03-06 00:00:00,LABORABLE
3,6,2020,15,580,560,1140,2020-06-03 14:00:00,2020-03-06 00:00:00,LABORABLE
3,6,2020,16,509,473,982,2020-06-03 15:00:00,2020-03-06 00:00:00,LABORABLE
3,6,2020,17,418,493,911,2020-06-03 16:00:00,2020-03-06 00:00:00,LABORABLE
3,6,2020,18,521,551,1072,2020-06-03 17:00:00,2020-03-06 00:00:00,LABORABLE
3,6,2020,19,572,630,1202,2020-06-03 18:00:00,2020-03-06 00:00:00,LABORABLE
3,6,2020,20,544,723,1267,2020-06-03 19:00:00,2020-03-06 00:00:00,LABORABLE
3,6,2020,21,509,608,1117,2020-06-03 20:00:00,2020-03-06 00:00:00,LABORABLE
3,6,2020,22,391,471,862,2020-06-03 21:00:00,2020-03-06 00:00:00,LABORABLE
3,6,2020,23,309,333,642,2020-06-03 22:00:00,2020-03-06 00:00:00,LABORABLE
3,6,2020,24,208,196,404,2020-06-03 23:00:00,2020-03-06 00:00:00,LABORABLE
4,6,2020,1,134,172,306,2020-06-04 00:00:00,2020-04-06 00:00:00,LABORABLE
4,6,2020,2,87,109,196,2020-06-04 01:00:00,2020-04-06 00:00:00,LABORABLE
4,6,2020,3,57,63,120,2020-06-04 02:00:00,2020-04-06 00:00:00,LABORABLE
4,6,2020,4,52,39,91,2020-06-04 03:00:00,2020-04-06 00:00:00,LABORABLE
4,6,2020,5,43,40,83,2020-06-04 04:00:00,2020-04-06 00:00:00,LABORABLE
4,6,2020,6,142,68,210,2020-06-04 05:00:00,2020-04-06 00:00:00,LABORABLE
4,6,2020,7,346,154,500,2020-06-04 06:00:00,2020-04-06 00:00:00,LABORABLE
4,6,2020,8,550,323,873,2020-06-04 07:00:00,2020-04-06 00:00:00,LABORABLE
4,6,2020,9,360,373,733,2020-06-04 08:00:00,2020-04-06 00:00:00,LABORABLE
4,6,2020,10,447,466,913,2020-06-04 09:00:00,2020-04-06 00:00:00,LABORABLE
4,6,2020,11,452,522,974,2020-06-04 10:00:00,2020-04-06 00:00:00,LABORABLE
4,6,2020,12,406,570,976,2020-06-04 11:00:00,2020-04-06 00:00:00,LABORABLE
4,6,2020,13,418,587,1005,2020-06-04 12:00:00,2020-04-06 00:00:00,LABORABLE
4,6,2020,14,481,584,1065,2020-06-04 13:00:00,2020-04-06 00:00:00,LABORABLE
4,6,2020,15,499,581,1080,2020-06-04 14:00:00,2020-04-06 00:00:00,LABORABLE
4,6,2020,16,500,512,1012,2020-06-04 15:00:00,2020-04-06 00:00:00,LABORABLE
4,6,2020,17,374,505,879,2020-06-04 16:00:00,2020-04-06 00:00:00,LABORABLE
4,6,2020,18,438,574,1012,2020-06-04 17:00:00,2020-04-06 00:00:00,LABORABLE
4,6,2020,19,575,645,1220,2020-06-04 18:00:00,2020-04-06 00:00:00,LABORABLE
4,6,2020,20,541,687,1228,2020-06-04 19:00:00,2020-04-06 00:00:00,LABORABLE
4,6,2020,21,493,614,1107,2020-06-04 20:00:00,2020-04-06 00:00:00,LABORABLE
4,6,2020,22,415,464,879,2020-06-04 21:00:00,2020-04-06 00:00:00,LABORABLE
4,6,2020,23,313,341,654,2020-06-04 22:00:00,2020-04-06 00:00:00,LABORABLE
4,6,2020,24,203,220,423,2020-06-04 23:00:00,2020-04-06 00:00:00,LABORABLE
5,6,2020,1,158,169,327,2020-06-05 00:00:00,2020-05-06 00:00:00,LABORABLE
5,6,2020,2,83,130,213,2020-06-05 01:00:00,2020-05-06 00:00:00,LABORABLE
5,6,2020,3,60,85,145,2020-06-05 02:00:00,2020-05-06 00:00:00,LABORABLE
5,6,2020,4,50,55,105,2020-06-05 03:00:00,2020-05-06 00:00:00,LABORABLE
5,6,2020,5,50,39,89,2020-06-05 04:00:00,2020-05-06 00:00:00,LABORABLE
5,6,2020,6,125,60,185,2020-06-05 05:00:00,2020-05-06 00:00:00,LABORABLE
5,6,2020,7,345,138,483,2020-06-05 06:00:00,2020-05-06 00:00:00,LABORABLE
5,6,2020,8,538,327,865,2020-06-05 07:00:00,2020-05-06 00:00:00,LABORABLE
5,6,2020,9,463,440,903,2020-06-05 08:00:00,2020-05-06 00:00:00,LABORABLE
5,6,2020,10,447,474,921,2020-06-05 09:00:00,2020-05-06 00:00:00,LABORABLE
5,6,2020,11,415,602,1017,2020-06-05 10:00:00,2020-05-06 00:00:00,LABORABLE
5,6,2020,12,508,616,1124,2020-06-05 11:00:00,2020-05-06 00:00:00,LABORABLE
5,6,2020,13,516,579,1095,2020-06-05 12:00:00,2020-05-06 00:00:00,LABORABLE
5,6,2020,14,566,630,1196,2020-06-05 13:00:00,2020-05-06 00:00:00,LABORABLE
5,6,2020,15,532,570,1102,2020-06-05 14:00:00,2020-05-06 00:00:00,LABORABLE
5,6,2020,16,496,523,1019,2020-06-05 15:00:00,2020-05-06 00:00:00,LABORABLE
5,6,2020,17,458,495,953,2020-06-05 16:00:00,2020-05-06 00:00:00,LABORABLE
5,6,2020,18,495,593,1088,2020-06-05 17:00:00,2020-05-06 00:00:00,LABORABLE
5,6,2020,19,572,657,1229,2020-06-05 18:00:00,2020-05-06 00:00:00,LABORABLE
5,6,2020,20,580,761,1341,2020-06-05 19:00:00,2020-05-06 00:00:00,LABORABLE
5,6,2020,21,624,718,1342,2020-06-05 20:00:00,2020-05-06 00:00:00,LABORABLE
5,6,2020,22,463,568,1031,2020-06-05 21:00:00,2020-05-06 00:00:00,LABORABLE
5,6,2020,23,386,430,816,2020-06-05 22:00:00,2020-05-06 00:00:00,LABORABLE
5,6,2020,24,253,242,495,2020-06-05 23:00:00,2020-05-06 00:00:00,LABORABLE
6,6,2020,1,238,332,570,2020-06-06 00:00:00,2020-06-06 00:00:00,LABORABLE
6,6,2020,2,177,271,448,2020-06-06 01:00:00,2020-06-06 00:00:00,LABORABLE
6,6,2020,3,126,196,322,2020-06-06 02:00:00,2020-06-06 00:00:00,LABORABLE
6,6,2020,4,85,105,190,2020-06-06 03:00:00,2020-06-06 00:00:00,LABORABLE
6,6,2020,5,79,60,139,2020-06-06 04:00:00,2020-06-06 00:00:00,LABORABLE
6,6,2020,6,82,92,174,2020-06-06 05:00:00,2020-06-06 00:00:00,LABORABLE
6,6,2020,7,130,117,247,2020-06-06 06:00:00,2020-06-06 00:00:00,LABORABLE
6,6,2020,8,242,245,487,2020-06-06 07:00:00,2020-06-06 00:00:00,LABORABLE
6,6,2020,9,312,378,690,2020-06-06 08:00:00,2020-06-06 00:00:00,LABORABLE
6,6,2020,10,351,555,906,2020-06-06 09:00:00,2020-06-06 00:00:00,LABORABLE
6,6,2020,11,434,629,1063,2020-06-06 10:00:00,2020-06-06 00:00:00,LABORABLE
6,6,2020,12,470,747,1217,2020-06-06 11:00:00,2020-06-06 00:00:00,LABORABLE
6,6,2020,13,538,755,1293,2020-06-06 12:00:00,2020-06-06 00:00:00,LABORABLE
6,6,2020,14,564,971,1535,2020-06-06 13:00:00,2020-06-06 00:00:00,LABORABLE
6,6,2020,15,532,922,1454,2020-06-06 14:00:00,2020-06-06 00:00:00,LABORABLE
6,6,2020,16,392,726,1118,2020-06-06 15:00:00,2020-06-06 00:00:00,LABORABLE
6,6,2020,17,374,704,1078,2020-06-06 16:00:00,2020-06-06 00:00:00,LABORABLE
6,6,2020,18,387,734,1121,2020-06-06 17:00:00,2020-06-06 00:00:00,LABORABLE
6,6,2020,19,458,786,1244,2020-06-06 18:00:00,2020-06-06 00:00:00,LABORABLE
6,6,2020,20,524,879,1403,2020-06-06 19:00:00,2020-06-06 00:00:00,LABORABLE
6,6,2020,21,462,845,1307,2020-06-06 20:00:00,2020-06-06 00:00:00,LABORABLE
6,6,2020,22,515,805,1320,2020-06-06 21:00:00,2020-06-06 00:00:00,LABORABLE
6,6,2020,23,405,587,992,2020-06-06 22:00:00,2020-06-06 00:00:00,LABORABLE
6,6,2020,24,304,347,651,2020-06-06 23:00:00,2020-06-06 00:00:00,LABORABLE
7,6,2020,1,256,368,624,2020-06-07 00:00:00,2020-07-06 00:00:00,LABORABLE
7,6,2020,2,224,341,565,2020-06-07 01:00:00,2020-07-06 00:00:00,LABORABLE
7,6,2020,3,171,211,382,2020-06-07 02:00:00,2020-07-06 00:00:00,LABORABLE
7,6,2020,4,80,181,261,2020-06-07 03:00:00,2020-07-06 00:00:00,LABORABLE
7,6,2020,5,61,90,151,2020-06-07 04:00:00,2020-07-06 00:00:00,LABORABLE
7,6,2020,6,59,72,131,2020-06-07 05:00:00,2020-07-06 00:00:00,LABORABLE
7,6,2020,7,92,86,178,2020-06-07 06:00:00,2020-07-06 00:00:00,LABORABLE
7,6,2020,8,126,132,258,2020-06-07 07:00:00,2020-07-06 00:00:00,LABORABLE
7,6,2020,9,148,224,372,2020-06-07 08:00:00,2020-07-06 00:00:00,LABORABLE
7,6,2020,10,205,369,574,2020-06-07 09:00:00,2020-07-06 00:00:00,LABORABLE
7,6,2020,11,303,464,767,2020-06-07 10:00:00,2020-07-06 00:00:00,LABORABLE
7,6,2020,12,362,608,970,2020-06-07 11:00:00,2020-07-06 00:00:00,LABORABLE
7,6,2020,13,449,703,1152,2020-06-07 12:00:00,2020-07-06 00:00:00,LABORABLE
7,6,2020,14,511,750,1261,2020-06-07 13:00:00,2020-07-06 00:00:00,LABORABLE
7,6,2020,15,411,722,1133,2020-06-07 14:00:00,2020-07-06 00:00:00,LABORABLE
7,6,2020,16,320,639,959,2020-06-07 15:00:00,2020-07-06 00:00:00,LABORABLE
7,6,2020,17,245,585,830,2020-06-07 16:00:00,2020-07-06 00:00:00,LABORABLE
7,6,2020,18,341,617,958,2020-06-07 17:00:00,2020-07-06 00:00:00,LABORABLE
7,6,2020,19,380,654,1034,2020-06-07 18:00:00,2020-07-06 00:00:00,LABORABLE
7,6,2020,20,467,808,1275,2020-06-07 19:00:00,2020-07-06 00:00:00,LABORABLE
7,6,2020,21,374,726,1100,2020-06-07 20:00:00,2020-07-06 00:00:00,LABORABLE
7,6,2020,22,333,606,939,2020-06-07 21:00:00,2020-07-06 00:00:00,LABORABLE
7,6,2020,23,315,498,813,2020-06-07 22:00:00,2020-07-06 00:00:00,LABORABLE
7,6,2020,24,243,332,575,2020-06-07 23:00:00,2020-07-06 00:00:00,LABORABLE
8,6,2020,1,144,175,319,2020-06-08 00:00:00,2020-08-06 00:00:00,LABORABLE
8,6,2020,2,91,113,204,2020-06-08 01:00:00,2020-08-06 00:00:00,LABORABLE
8,6,2020,3,66,79,145,2020-06-08 02:00:00,2020-08-06 00:00:00,LABORABLE
8,6,2020,4,41,59,100,2020-06-08 03:00:00,2020-08-06 00:00:00,LABORABLE
8,6,2020,5,49,43,92,2020-06-08 04:00:00,2020-08-06 00:00:00,LABORABLE
8,6,2020,6,139,73,212,2020-06-08 05:00:00,2020-08-06 00:00:00,LABORABLE
8,6,2020,7,337,151,488,2020-06-08 06:00:00,2020-08-06 00:00:00,LABORABLE
8,6,2020,8,560,323,883,2020-06-08 07:00:00,2020-08-06 00:00:00,LABORABLE
8,6,2020,9,521,436,957,2020-06-08 08:00:00,2020-08-06 00:00:00,LABORABLE
8,6,2020,10,499,553,1052,2020-06-08 09:00:00,2020-08-06 00:00:00,LABORABLE
8,6,2020,11,460,566,1026,2020-06-08 10:00:00,2020-08-06 00:00:00,LABORABLE
8,6,2020,12,524,577,1101,2020-06-08 11:00:00,2020-08-06 00:00:00,LABORABLE
8,6,2020,13,514,596,1110,2020-06-08 12:00:00,2020-08-06 00:00:00,LABORABLE
8,6,2020,14,559,635,1194,2020-06-08 13:00:00,2020-08-06 00:00:00,LABORABLE
8,6,2020,15,557,564,1121,2020-06-08 14:00:00,2020-08-06 00:00:00,LABORABLE
8,6,2020,16,492,528,1020,2020-06-08 15:00:00,2020-08-06 00:00:00,LABORABLE
8,6,2020,17,466,528,994,2020-06-08 16:00:00,2020-08-06 00:00:00,LABORABLE
8,6,2020,18,523,600,1123,2020-06-08 17:00:00,2020-08-06 00:00:00,LABORABLE
8,6,2020,19,584,664,1248,2020-06-08 18:00:00,2020-08-06 00:00:00,LABORABLE
8,6,2020,20,517,729,1246,2020-06-08 19:00:00,2020-08-06 00:00:00,LABORABLE
8,6,2020,21,459,632,1091,2020-06-08 20:00:00,2020-08-06 00:00:00,LABORABLE
8,6,2020,22,399,482,881,2020-06-08 21:00:00,2020-08-06 00:00:00,LABORABLE
8,6,2020,23,323,355,678,2020-06-08 22:00:00,2020-08-06 00:00:00,LABORABLE
8,6,2020,24,170,197,367,2020-06-08 23:00:00,2020-08-06 00:00:00,LABORABLE
9,6,2020,1,125,170,295,2020-06-09 00:00:00,2020-09-06 00:00:00,LABORABLE
9,6,2020,2,83,107,190,2020-06-09 01:00:00,2020-09-06 00:00:00,LABORABLE
9,6,2020,3,63,90,153,2020-06-09 02:00:00,2020-09-06 00:00:00,LABORABLE
9,6,2020,4,59,39,98,2020-06-09 03:00:00,2020-09-06 00:00:00,LABORABLE
9,6,2020,5,54,43,97,2020-06-09 04:00:00,2020-09-06 00:00:00,LABORABLE
9,6,2020,6,122,73,195,2020-06-09 05:00:00,2020-09-06 00:00:00,LABORABLE
9,6,2020,7,326,160,486,2020-06-09 06:00:00,2020-09-06 00:00:00,LABORABLE
9,6,2020,8,580,339,919,2020-06-09 07:00:00,2020-09-06 00:00:00,LABORABLE
9,6,2020,9,494,441,935,2020-06-09 08:00:00,2020-09-06 00:00:00,LABORABLE
9,6,2020,10,462,496,958,2020-06-09 09:00:00,2020-09-06 00:00:00,LABORABLE
9,6,2020,11,477,514,991,2020-06-09 10:00:00,2020-09-06 00:00:00,LABORABLE
9,6,2020,12,392,551,943,2020-06-09 11:00:00,2020-09-06 00:00:00,LABORABLE
9,6,2020,13,555,582,1137,2020-06-09 12:00:00,2020-09-06 00:00:00,LABORABLE
9,6,2020,14,557,567,1124,2020-06-09 13:00:00,2020-09-06 00:00:00,LABORABLE
9,6,2020,15,540,546,1086,2020-06-09 14:00:00,2020-09-06 00:00:00,LABORABLE
9,6,2020,16,503,459,962,2020-06-09 15:00:00,2020-09-06 00:00:00,LABORABLE
9,6,2020,17,468,512,980,2020-06-09 16:00:00,2020-09-06 00:00:00,LABORABLE
9,6,2020,18,522,526,1048,2020-06-09 17:00:00,2020-09-06 00:00:00,LABORABLE
9,6,2020,19,593,662,1255,2020-06-09 18:00:00,2020-09-06 00:00:00,LABORABLE
9,6,2020,20,549,688,1237,2020-06-09 19:00:00,2020-09-06 00:00:00,LABORABLE
9,6,2020,21,509,591,1100,2020-06-09 20:00:00,2020-09-06 00:00:00,LABORABLE
9,6,2020,22,424,526,950,2020-06-09 21:00:00,2020-09-06 00:00:00,LABORABLE
9,6,2020,23,340,381,721,2020-06-09 22:00:00,2020-09-06 00:00:00,LABORABLE
9,6,2020,24,187,230,417,2020-06-09 23:00:00,2020-09-06 00:00:00,LABORABLE
10,6,2020,1,137,171,308,2020-06-10 00:00:00,2020-10-06 00:00:00,LABORABLE
10,6,2020,2,85,93,178,2020-06-10 01:00:00,2020-10-06 00:00:00,LABORABLE
10,6,2020,3,76,71,147,2020-06-10 02:00:00,2020-10-06 00:00:00,LABORABLE
10,6,2020,4,55,41,96,2020-06-10 03:00:00,2020-10-06 00:00:00,LABORABLE
10,6,2020,5,62,46,108,2020-06-10 04:00:00,2020-10-06 00:00:00,LABORABLE
10,6,2020,6,133,61,194,2020-06-10 05:00:00,2020-10-06 00:00:00,LABORABLE
10,6,2020,7,339,141,480,2020-06-10 06:00:00,2020-10-06 00:00:00,LABORABLE
10,6,2020,8,595,304,899,2020-06-10 07:00:00,2020-10-06 00:00:00,LABORABLE
10,6,2020,9,525,459,984,2020-06-10 08:00:00,2020-10-06 00:00:00,LABORABLE
10,6,2020,10,460,509,969,2020-06-10 09:00:00,2020-10-06 00:00:00,LABORABLE
10,6,2020,11,400,501,901,2020-06-10 10:00:00,2020-10-06 00:00:00,LABORABLE
10,6,2020,12,514,557,1071,2020-06-10 11:00:00,2020-10-06 00:00:00,LABORABLE
10,6,2020,13,536,596,1132,2020-06-10 12:00:00,2020-10-06 00:00:00,LABORABLE
10,6,2020,14,491,574,1065,2020-06-10 13:00:00,2020-10-06 00:00:00,LABORABLE
10,6,2020,15,555,569,1124,2020-06-10 14:00:00,2020-10-06 00:00:00,LABORABLE
10,6,2020,16,498,551,1049,2020-06-10 15:00:00,2020-10-06 00:00:00,LABORABLE
10,6,2020,17,488,544,1032,2020-06-10 16:00:00,2020-10-06 00:00:00,LABORABLE
10,6,2020,18,539,569,1108,2020-06-10 17:00:00,2020-10-06 00:00:00,LABORABLE
10,6,2020,19,589,654,1243,2020-06-10 18:00:00,2020-10-06 00:00:00,LABORABLE
10,6,2020,20,579,676,1255,2020-06-10 19:00:00,2020-10-06 00:00:00,LABORABLE
10,6,2020,21,500,580,1080,2020-06-10 20:00:00,2020-10-06 00:00:00,LABORABLE
10,6,2020,22,468,480,948,2020-06-10 21:00:00,2020-10-06 00:00:00,LABORABLE
10,6,2020,23,307,370,677,2020-06-10 22:00:00,2020-10-06 00:00:00,LABORABLE
10,6,2020,24,230,202,432,2020-06-10 23:00:00,2020-10-06 00:00:00,LABORABLE
11,6,2020,1,166,195,361,2020-06-11 00:00:00,2020-11-06 00:00:00,LABORABLE
11,6,2020,2,94,112,206,2020-06-11 01:00:00,2020-11-06 00:00:00,LABORABLE
11,6,2020,3,73,85,158,2020-06-11 02:00:00,2020-11-06 00:00:00,LABORABLE
11,6,2020,4,49,44,93,2020-06-11 03:00:00,2020-11-06 00:00:00,LABORABLE
11,6,2020,5,60,43,103,2020-06-11 04:00:00,2020-11-06 00:00:00,LABORABLE
11,6,2020,6,140,65,205,2020-06-11 05:00:00,2020-11-06 00:00:00,LABORABLE
11,6,2020,7,355,166,521,2020-06-11 06:00:00,2020-11-06 00:00:00,LABORABLE
11,6,2020,8,535,347,882,2020-06-11 07:00:00,2020-11-06 00:00:00,LABORABLE
11,6,2020,9,481,459,940,2020-06-11 08:00:00,2020-11-06 00:00:00,LABORABLE
11,6,2020,10,483,510,993,2020-06-11 09:00:00,2020-11-06 00:00:00,LABORABLE
11,6,2020,11,525,552,1077,2020-06-11 10:00:00,2020-11-06 00:00:00,LABORABLE
11,6,2020,12,398,565,963,2020-06-11 11:00:00,2020-11-06 00:00:00,LABORABLE
11,6,2020,13,375,564,939,2020-06-11 12:00:00,2020-11-06 00:00:00,LABORABLE
11,6,2020,14,539,600,1139,2020-06-11 13:00:00,2020-11-06 00:00:00,LABORABLE
11,6,2020,15,533,572,1105,2020-06-11 14:00:00,2020-11-06 00:00:00,LABORABLE
11,6,2020,16,511,498,1009,2020-06-11 15:00:00,2020-11-06 00:00:00,LABORABLE
11,6,2020,17,463,550,1013,2020-06-11 16:00:00,2020-11-06 00:00:00,LABORABLE
11,6,2020,18,563,638,1201,2020-06-11 17:00:00,2020-11-06 00:00:00,LABORABLE
11,6,2020,19,577,687,1264,2020-06-11 18:00:00,2020-11-06 00:00:00,LABORABLE
11,6,2020,20,572,747,1319,2020-06-11 19:00:00,2020-11-06 00:00:00,LABORABLE
11,6,2020,21,529,648,1177,2020-06-11 20:00:00,2020-11-06 00:00:00,LABORABLE
11,6,2020,22,462,499,961,2020-06-11 21:00:00,2020-11-06 00:00:00,LABORABLE
11,6,2020,23,307,379,686,2020-06-11 22:00:00,2020-11-06 00:00:00,LABORABLE
11,6,2020,24,191,232,423,2020-06-11 23:00:00,2020-11-06 00:00:00,LABORABLE
12,6,2020,1,137,190,327,2020-06-12 00:00:00,2020-12-06 00:00:00,LABORABLE
12,6,2020,2,109,132,241,2020-06-12 01:00:00,2020-12-06 00:00:00,LABORABLE
12,6,2020,3,71,106,177,2020-06-12 02:00:00,2020-12-06 00:00:00,LABORABLE
12,6,2020,4,59,47,106,2020-06-12 03:00:00,2020-12-06 00:00:00,LABORABLE
12,6,2020,5,61,45,106,2020-06-12 04:00:00,2020-12-06 00:00:00,LABORABLE
12,6,2020,6,143,66,209,2020-06-12 05:00:00,2020-12-06 00:00:00,LABORABLE
12,6,2020,7,338,147,485,2020-06-12 06:00:00,2020-12-06 00:00:00,LABORABLE
12,6,2020,8,548,301,849,2020-06-12 07:00:00,2020-12-06 00:00:00,LABORABLE
12,6,2020,9,528,443,971,2020-06-12 08:00:00,2020-12-06 00:00:00,LABORABLE
12,6,2020,10,504,523,1027,2020-06-12 09:00:00,2020-12-06 00:00:00,LABORABLE
12,6,2020,11,336,516,852,2020-06-12 10:00:00,2020-12-06 00:00:00,LABORABLE
12,6,2020,12,0,552,552,2020-06-12 11:00:00,2020-12-06 00:00:00,LABORABLE
12,6,2020,13,369,573,942,2020-06-12 12:00:00,2020-12-06 00:00:00,LABORABLE
12,6,2020,14,536,647,1183,2020-06-12 13:00:00,2020-12-06 00:00:00,LABORABLE
12,6,2020,15,542,581,1123,2020-06-12 14:00:00,2020-12-06 00:00:00,LABORABLE
12,6,2020,16,555,569,1124,2020-06-12 15:00:00,2020-12-06 00:00:00,LABORABLE
12,6,2020,17,535,577,1112,2020-06-12 16:00:00,2020-12-06 00:00:00,LABORABLE
12,6,2020,18,568,634,1202,2020-06-12 17:00:00,2020-12-06 00:00:00,LABORABLE
12,6,2020,19,589,655,1244,2020-06-12 18:00:00,2020-12-06 00:00:00,LABORABLE
12,6,2020,20,599,735,1334,2020-06-12 19:00:00,2020-12-06 00:00:00,LABORABLE
12,6,2020,21,574,732,1306,2020-06-12 20:00:00,2020-12-06 00:00:00,LABORABLE
12,6,2020,22,492,605,1097,2020-06-12 21:00:00,2020-12-06 00:00:00,LABORABLE
12,6,2020,23,436,479,915,2020-06-12 22:00:00,2020-12-06 00:00:00,LABORABLE
12,6,2020,24,286,328,614,2020-06-12 23:00:00,2020-12-06 00:00:00,LABORABLE
13,6,2020,1,209,341,550,2020-06-13 00:00:00,2020-06-13 00:00:00,LABORABLE
13,6,2020,2,162,278,440,2020-06-13 01:00:00,2020-06-13 00:00:00,LABORABLE
13,6,2020,3,131,199,330,2020-06-13 02:00:00,2020-06-13 00:00:00,LABORABLE
13,6,2020,4,92,135,227,2020-06-13 03:00:00,2020-06-13 00:00:00,LABORABLE
13,6,2020,5,66,103,169,2020-06-13 04:00:00,2020-06-13 00:00:00,LABORABLE
13,6,2020,6,80,93,173,2020-06-13 05:00:00,2020-06-13 00:00:00,LABORABLE
13,6,2020,7,125,133,258,2020-06-13 06:00:00,2020-06-13 00:00:00,LABORABLE
13,6,2020,8,254,256,510,2020-06-13 07:00:00,2020-06-13 00:00:00,LABORABLE
13,6,2020,9,310,397,707,2020-06-13 08:00:00,2020-06-13 00:00:00,LABORABLE
13,6,2020,10,390,556,946,2020-06-13 09:00:00,2020-06-13 00:00:00,LABORABLE
13,6,2020,11,432,681,1113,2020-06-13 10:00:00,2020-06-13 00:00:00,LABORABLE
13,6,2020,12,536,794,1330,2020-06-13 11:00:00,2020-06-13 00:00:00,LABORABLE
13,6,2020,13,551,850,1401,2020-06-13 12:00:00,2020-06-13 00:00:00,LABORABLE
13,6,2020,14,594,882,1476,2020-06-13 13:00:00,2020-06-13 00:00:00,LABORABLE
13,6,2020,15,569,849,1418,2020-06-13 14:00:00,2020-06-13 00:00:00,LABORABLE
13,6,2020,16,397,706,1103,2020-06-13 15:00:00,2020-06-13 00:00:00,LABORABLE
13,6,2020,17,411,697,1108,2020-06-13 16:00:00,2020-06-13 00:00:00,LABORABLE
13,6,2020,18,466,759,1225,2020-06-13 17:00:00,2020-06-13 00:00:00,LABORABLE
13,6,2020,19,544,760,1304,2020-06-13 18:00:00,2020-06-13 00:00:00,LABORABLE
13,6,2020,20,537,826,1363,2020-06-13 19:00:00,2020-06-13 00:00:00,LABORABLE
13,6,2020,21,517,777,1294,2020-06-13 20:00:00,2020-06-13 00:00:00,LABORABLE
13,6,2020,22,473,739,1212,2020-06-13 21:00:00,2020-06-13 00:00:00,LABORABLE
13,6,2020,23,422,620,1042,2020-06-13 22:00:00,2020-06-13 00:00:00,LABORABLE
13,6,2020,24,325,424,749,2020-06-13 23:00:00,2020-06-13 00:00:00,LABORABLE
14,6,2020,1,329,443,772,2020-06-14 00:00:00,2020-06-14 00:00:00,LABORABLE
14,6,2020,2,241,334,575,2020-06-14 01:00:00,2020-06-14 00:00:00,LABORABLE
14,6,2020,3,199,289,488,2020-06-14 02:00:00,2020-06-14 00:00:00,LABORABLE
14,6,2020,4,99,191,290,2020-06-14 03:00:00,2020-06-14 00:00:00,LABORABLE
14,6,2020,5,64,139,203,2020-06-14 04:00:00,2020-06-14 00:00:00,LABORABLE
14,6,2020,6,50,107,157,2020-06-14 05:00:00,2020-06-14 00:00:00,LABORABLE
14,6,2020,7,88,85,173,2020-06-14 06:00:00,2020-06-14 00:00:00,LABORABLE
14,6,2020,8,119,145,264,2020-06-14 07:00:00,2020-06-14 00:00:00,LABORABLE
14,6,2020,9,150,245,395,2020-06-14 08:00:00,2020-06-14 00:00:00,LABORABLE
14,6,2020,10,254,362,616,2020-06-14 09:00:00,2020-06-14 00:00:00,LABORABLE
14,6,2020,11,352,445,797,2020-06-14 10:00:00,2020-06-14 00:00:00,LABORABLE
14,6,2020,12,426,520,946,2020-06-14 11:00:00,2020-06-14 00:00:00,LABORABLE
14,6,2020,13,481,677,1158,2020-06-14 12:00:00,2020-06-14 00:00:00,LABORABLE
14,6,2020,14,524,790,1314,2020-06-14 13:00:00,2020-06-14 00:00:00,LABORABLE
14,6,2020,15,481,725,1206,2020-06-14 14:00:00,2020-06-14 00:00:00,LABORABLE
14,6,2020,16,347,665,1012,2020-06-14 15:00:00,2020-06-14 00:00:00,LABORABLE
14,6,2020,17,351,647,998,2020-06-14 16:00:00,2020-06-14 00:00:00,LABORABLE
14,6,2020,18,372,650,1022,2020-06-14 17:00:00,2020-06-14 00:00:00,LABORABLE
14,6,2020,19,416,716,1132,2020-06-14 18:00:00,2020-06-14 00:00:00,LABORABLE
14,6,2020,20,448,785,1233,2020-06-14 19:00:00,2020-06-14 00:00:00,LABORABLE
14,6,2020,21,388,738,1126,2020-06-14 20:00:00,2020-06-14 00:00:00,LABORABLE
14,6,2020,22,414,689,1103,2020-06-14 21:00:00,2020-06-14 00:00:00,LABORABLE
14,6,2020,23,394,576,970,2020-06-14 22:00:00,2020-06-14 00:00:00,LABORABLE
14,6,2020,24,230,326,556,2020-06-14 23:00:00,2020-06-14 00:00:00,LABORABLE
15,6,2020,1,192,279,471,2020-06-15 00:00:00,2020-06-15 00:00:00,LABORABLE
15,6,2020,2,117,147,264,2020-06-15 01:00:00,2020-06-15 00:00:00,LABORABLE
15,6,2020,3,72,135,207,2020-06-15 02:00:00,2020-06-15 00:00:00,LABORABLE
15,6,2020,4,49,76,125,2020-06-15 03:00:00,2020-06-15 00:00:00,LABORABLE
15,6,2020,5,55,47,102,2020-06-15 04:00:00,2020-06-15 00:00:00,LABORABLE
15,6,2020,6,124,78,202,2020-06-15 05:00:00,2020-06-15 00:00:00,LABORABLE
15,6,2020,7,361,174,535,2020-06-15 06:00:00,2020-06-15 00:00:00,LABORABLE
15,6,2020,8,609,349,958,2020-06-15 07:00:00,2020-06-15 00:00:00,LABORABLE
15,6,2020,9,517,483,1000,2020-06-15 08:00:00,2020-06-15 00:00:00,LABORABLE
15,6,2020,10,491,529,1020,2020-06-15 09:00:00,2020-06-15 00:00:00,LABORABLE
15,6,2020,11,511,540,1051,2020-06-15 10:00:00,2020-06-15 00:00:00,LABORABLE
15,6,2020,12,513,594,1107,2020-06-15 11:00:00,2020-06-15 00:00:00,LABORABLE
15,6,2020,13,518,598,1116,2020-06-15 12:00:00,2020-06-15 00:00:00,LABORABLE
15,6,2020,14,551,618,1169,2020-06-15 13:00:00,2020-06-15 00:00:00,LABORABLE
15,6,2020,15,576,570,1146,2020-06-15 14:00:00,2020-06-15 00:00:00,LABORABLE
15,6,2020,16,500,503,1003,2020-06-15 15:00:00,2020-06-15 00:00:00,LABORABLE
15,6,2020,17,493,595,1088,2020-06-15 16:00:00,2020-06-15 00:00:00,LABORABLE
15,6,2020,18,548,629,1177,2020-06-15 17:00:00,2020-06-15 00:00:00,LABORABLE
15,6,2020,19,584,673,1257,2020-06-15 18:00:00,2020-06-15 00:00:00,LABORABLE
15,6,2020,20,574,735,1309,2020-06-15 19:00:00,2020-06-15 00:00:00,LABORABLE
15,6,2020,21,533,651,1184,2020-06-15 20:00:00,2020-06-15 00:00:00,LABORABLE
15,6,2020,22,398,507,905,2020-06-15 21:00:00,2020-06-15 00:00:00,LABORABLE
15,6,2020,23,318,374,692,2020-06-15 22:00:00,2020-06-15 00:00:00,LABORABLE
15,6,2020,24,191,202,393,2020-06-15 23:00:00,2020-06-15 00:00:00,LABORABLE
16,6,2020,1,132,183,315,2020-06-16 00:00:00,2020-06-16 00:00:00,LABORABLE
16,6,2020,2,78,121,199,2020-06-16 01:00:00,2020-06-16 00:00:00,LABORABLE
16,6,2020,3,64,92,156,2020-06-16 02:00:00,2020-06-16 00:00:00,LABORABLE
16,6,2020,4,58,51,109,2020-06-16 03:00:00,2020-06-16 00:00:00,LABORABLE
16,6,2020,5,65,40,105,2020-06-16 04:00:00,2020-06-16 00:00:00,LABORABLE
16,6,2020,6,153,73,226,2020-06-16 05:00:00,2020-06-16 00:00:00,LABORABLE
16,6,2020,7,361,170,531,2020-06-16 06:00:00,2020-06-16 00:00:00,LABORABLE
16,6,2020,8,588,336,924,2020-06-16 07:00:00,2020-06-16 00:00:00,LABORABLE
16,6,2020,9,500,411,911,2020-06-16 08:00:00,2020-06-16 00:00:00,LABORABLE
16,6,2020,10,503,552,1055,2020-06-16 09:00:00,2020-06-16 00:00:00,LABORABLE
16,6,2020,11,462,536,998,2020-06-16 10:00:00,2020-06-16 00:00:00,LABORABLE
16,6,2020,12,554,609,1163,2020-06-16 11:00:00,2020-06-16 00:00:00,LABORABLE
16,6,2020,13,474,644,1118,2020-06-16 12:00:00,2020-06-16 00:00:00,LABORABLE
16,6,2020,14,492,640,1132,2020-06-16 13:00:00,2020-06-16 00:00:00,LABORABLE
16,6,2020,15,553,582,1135,2020-06-16 14:00:00,2020-06-16 00:00:00,LABORABLE
16,6,2020,16,494,536,1030,2020-06-16 15:00:00,2020-06-16 00:00:00,LABORABLE
16,6,2020,17,477,550,1027,2020-06-16 16:00:00,2020-06-16 00:00:00,LABORABLE
16,6,2020,18,559,631,1190,2020-06-16 17:00:00,2020-06-16 00:00:00,LABORABLE
16,6,2020,19,592,669,1261,2020-06-16 18:00:00,2020-06-16 00:00:00,LABORABLE
16,6,2020,20,573,706,1279,2020-06-16 19:00:00,2020-06-16 00:00:00,LABORABLE
16,6,2020,21,512,634,1146,2020-06-16 20:00:00,2020-06-16 00:00:00,LABORABLE
16,6,2020,22,423,480,903,2020-06-16 21:00:00,2020-06-16 00:00:00,LABORABLE
16,6,2020,23,314,371,685,2020-06-16 22:00:00,2020-06-16 00:00:00,LABORABLE
16,6,2020,24,206,212,418,2020-06-16 23:00:00,2020-06-16 00:00:00,LABORABLE
17,6,2020,1,145,184,329,2020-06-17 00:00:00,2020-06-17 00:00:00,LABORABLE
17,6,2020,2,82,116,198,2020-06-17 01:00:00,2020-06-17 00:00:00,LABORABLE
17,6,2020,3,47,87,134,2020-06-17 02:00:00,2020-06-17 00:00:00,LABORABLE
17,6,2020,4,57,52,109,2020-06-17 03:00:00,2020-06-17 00:00:00,LABORABLE
17,6,2020,5,65,35,100,2020-06-17 04:00:00,2020-06-17 00:00:00,LABORABLE
17,6,2020,6,145,65,210,2020-06-17 05:00:00,2020-06-17 00:00:00,LABORABLE
17,6,2020,7,360,154,514,2020-06-17 06:00:00,2020-06-17 00:00:00,LABORABLE
17,6,2020,8,574,329,903,2020-06-17 07:00:00,2020-06-17 00:00:00,LABORABLE
17,6,2020,9,502,412,914,2020-06-17 08:00:00,2020-06-17 00:00:00,LABORABLE
17,6,2020,10,479,572,1051,2020-06-17 09:00:00,2020-06-17 00:00:00,LABORABLE
17,6,2020,11,510,564,1074,2020-06-17 10:00:00,2020-06-17 00:00:00,LABORABLE
17,6,2020,12,525,594,1119,2020-06-17 11:00:00,2020-06-17 00:00:00,LABORABLE
17,6,2020,13,429,589,1018,2020-06-17 12:00:00,2020-06-17 00:00:00,LABORABLE
17,6,2020,14,547,640,1187,2020-06-17 13:00:00,2020-06-17 00:00:00,LABORABLE
17,6,2020,15,541,510,1051,2020-06-17 14:00:00,2020-06-17 00:00:00,LABORABLE
17,6,2020,16,501,511,1012,2020-06-17 15:00:00,2020-06-17 00:00:00,LABORABLE
17,6,2020,17,476,556,1032,2020-06-17 16:00:00,2020-06-17 00:00:00,LABORABLE
17,6,2020,18,539,597,1136,2020-06-17 17:00:00,2020-06-17 00:00:00,LABORABLE
17,6,2020,19,595,692,1287,2020-06-17 18:00:00,2020-06-17 00:00:00,LABORABLE
17,6,2020,20,621,719,1340,2020-06-17 19:00:00,2020-06-17 00:00:00,LABORABLE
17,6,2020,21,562,661,1223,2020-06-17 20:00:00,2020-06-17 00:00:00,LABORABLE
17,6,2020,22,478,527,1005,2020-06-17 21:00:00,2020-06-17 00:00:00,LABORABLE
17,6,2020,23,387,349,736,2020-06-17 22:00:00,2020-06-17 00:00:00,LABORABLE
17,6,2020,24,219,213,432,2020-06-17 23:00:00,2020-06-17 00:00:00,LABORABLE
18,6,2020,1,180,201,381,2020-06-18 00:00:00,2020-06-18 00:00:00,LABORABLE
18,6,2020,2,117,154,271,2020-06-18 01:00:00,2020-06-18 00:00:00,LABORABLE
18,6,2020,3,72,97,169,2020-06-18 02:00:00,2020-06-18 00:00:00,LABORABLE
18,6,2020,4,54,57,111,2020-06-18 03:00:00,2020-06-18 00:00:00,LABORABLE
18,6,2020,5,69,55,124,2020-06-18 04:00:00,2020-06-18 00:00:00,LABORABLE
18,6,2020,6,160,76,236,2020-06-18 05:00:00,2020-06-18 00:00:00,LABORABLE
18,6,2020,7,341,163,504,2020-06-18 06:00:00,2020-06-18 00:00:00,LABORABLE
18,6,2020,8,542,321,863,2020-06-18 07:00:00,2020-06-18 00:00:00,LABORABLE
18,6,2020,9,533,441,974,2020-06-18 08:00:00,2020-06-18 00:00:00,LABORABLE
18,6,2020,10,483,536,1019,2020-06-18 09:00:00,2020-06-18 00:00:00,LABORABLE
18,6,2020,11,494,588,1082,2020-06-18 10:00:00,2020-06-18 00:00:00,LABORABLE
18,6,2020,12,550,564,1114,2020-06-18 11:00:00,2020-06-18 00:00:00,LABORABLE
18,6,2020,13,531,624,1155,2020-06-18 12:00:00,2020-06-18 00:00:00,LABORABLE
18,6,2020,14,560,645,1205,2020-06-18 13:00:00,2020-06-18 00:00:00,LABORABLE
18,6,2020,15,431,599,1030,2020-06-18 14:00:00,2020-06-18 00:00:00,LABORABLE
18,6,2020,16,505,516,1021,2020-06-18 15:00:00,2020-06-18 00:00:00,LABORABLE
18,6,2020,17,544,552,1096,2020-06-18 16:00:00,2020-06-18 00:00:00,LABORABLE
18,6,2020,18,577,596,1173,2020-06-18 17:00:00,2020-06-18 00:00:00,LABORABLE
18,6,2020,19,620,678,1298,2020-06-18 18:00:00,2020-06-18 00:00:00,LABORABLE
18,6,2020,20,627,742,1369,2020-06-18 19:00:00,2020-06-18 00:00:00,LABORABLE
18,6,2020,21,567,623,1190,2020-06-18 20:00:00,2020-06-18 00:00:00,LABORABLE
18,6,2020,22,465,536,1001,2020-06-18 21:00:00,2020-06-18 00:00:00,LABORABLE
18,6,2020,23,364,405,769,2020-06-18 22:00:00,2020-06-18 00:00:00,LABORABLE
18,6,2020,24,231,256,487,2020-06-18 23:00:00,2020-06-18 00:00:00,LABORABLE
19,6,2020,1,194,248,442,2020-06-19 00:00:00,2020-06-19 00:00:00,LABORABLE
19,6,2020,2,120,154,274,2020-06-19 01:00:00,2020-06-19 00:00:00,LABORABLE
19,6,2020,3,90,118,208,2020-06-19 02:00:00,2020-06-19 00:00:00,LABORABLE
19,6,2020,4,68,74,142,2020-06-19 03:00:00,2020-06-19 00:00:00,LABORABLE
19,6,2020,5,63,62,125,2020-06-19 04:00:00,2020-06-19 00:00:00,LABORABLE
19,6,2020,6,144,66,210,2020-06-19 05:00:00,2020-06-19 00:00:00,LABORABLE
19,6,2020,7,345,153,498,2020-06-19 06:00:00,2020-06-19 00:00:00,LABORABLE
19,6,2020,8,555,375,930,2020-06-19 07:00:00,2020-06-19 00:00:00,LABORABLE
19,6,2020,9,506,446,952,2020-06-19 08:00:00,2020-06-19 00:00:00,LABORABLE
19,6,2020,10,509,519,1028,2020-06-19 09:00:00,2020-06-19 00:00:00,LABORABLE
19,6,2020,11,491,592,1083,2020-06-19 10:00:00,2020-06-19 00:00:00,LABORABLE
19,6,2020,12,536,608,1144,2020-06-19 11:00:00,2020-06-19 00:00:00,LABORABLE
19,6,2020,13,510,647,1157,2020-06-19 12:00:00,2020-06-19 00:00:00,LABORABLE
19,6,2020,14,593,672,1265,2020-06-19 13:00:00,2020-06-19 00:00:00,LABORABLE
19,6,2020,15,585,607,1192,2020-06-19 14:00:00,2020-06-19 00:00:00,LABORABLE
19,6,2020,16,518,579,1097,2020-06-19 15:00:00,2020-06-19 00:00:00,LABORABLE
19,6,2020,17,501,629,1130,2020-06-19 16:00:00,2020-06-19 00:00:00,LABORABLE
19,6,2020,18,563,626,1189,2020-06-19 17:00:00,2020-06-19 00:00:00,LABORABLE
19,6,2020,19,627,685,1312,2020-06-19 18:00:00,2020-06-19 00:00:00,LABORABLE
19,6,2020,20,637,737,1374,2020-06-19 19:00:00,2020-06-19 00:00:00,LABORABLE
19,6,2020,21,561,739,1300,2020-06-19 20:00:00,2020-06-19 00:00:00,LABORABLE
19,6,2020,22,524,630,1154,2020-06-19 21:00:00,2020-06-19 00:00:00,LABORABLE
19,6,2020,23,449,481,930,2020-06-19 22:00:00,2020-06-19 00:00:00,LABORABLE
19,6,2020,24,305,291,596,2020-06-19 23:00:00,2020-06-19 00:00:00,LABORABLE
20,6,2020,1,250,399,649,2020-06-20 00:00:00,2020-06-20 00:00:00,LABORABLE
20,6,2020,2,221,314,535,2020-06-20 01:00:00,2020-06-20 00:00:00,LABORABLE
20,6,2020,3,163,274,437,2020-06-20 02:00:00,2020-06-20 00:00:00,LABORABLE
20,6,2020,4,112,178,290,2020-06-20 03:00:00,2020-06-20 00:00:00,LABORABLE
20,6,2020,5,89,135,224,2020-06-20 04:00:00,2020-06-20 00:00:00,LABORABLE
20,6,2020,6,93,127,220,2020-06-20 05:00:00,2020-06-20 00:00:00,LABORABLE
20,6,2020,7,174,137,311,2020-06-20 06:00:00,2020-06-20 00:00:00,LABORABLE
20,6,2020,8,238,245,483,2020-06-20 07:00:00,2020-06-20 00:00:00,LABORABLE
20,6,2020,9,330,380,710,2020-06-20 08:00:00,2020-06-20 00:00:00,LABORABLE
20,6,2020,10,411,541,952,2020-06-20 09:00:00,2020-06-20 00:00:00,LABORABLE
20,6,2020,11,475,708,1183,2020-06-20 10:00:00,2020-06-20 00:00:00,LABORABLE
20,6,2020,12,553,803,1356,2020-06-20 11:00:00,2020-06-20 00:00:00,LABORABLE
20,6,2020,13,617,903,1520,2020-06-20 12:00:00,2020-06-20 00:00:00,LABORABLE
20,6,2020,14,614,934,1548,2020-06-20 13:00:00,2020-06-20 00:00:00,LABORABLE
20,6,2020,15,588,877,1465,2020-06-20 14:00:00,2020-06-20 00:00:00,LABORABLE
20,6,2020,16,421,723,1144,2020-06-20 15:00:00,2020-06-20 00:00:00,LABORABLE
20,6,2020,17,389,745,1134,2020-06-20 16:00:00,2020-06-20 00:00:00,LABORABLE
20,6,2020,18,460,804,1264,2020-06-20 17:00:00,2020-06-20 00:00:00,LABORABLE
20,6,2020,19,534,829,1363,2020-06-20 18:00:00,2020-06-20 00:00:00,LABORABLE
20,6,2020,20,578,816,1394,2020-06-20 19:00:00,2020-06-20 00:00:00,LABORABLE
20,6,2020,21,475,837,1312,2020-06-20 20:00:00,2020-06-20 00:00:00,LABORABLE
20,6,2020,22,487,765,1252,2020-06-20 21:00:00,2020-06-20 00:00:00,LABORABLE
20,6,2020,23,432,718,1150,2020-06-20 22:00:00,2020-06-20 00:00:00,LABORABLE
20,6,2020,24,348,431,779,2020-06-20 23:00:00,2020-06-20 00:00:00,LABORABLE
21,6,2020,1,271,509,780,2020-06-21 00:00:00,2020-06-21 00:00:00,LABORABLE
21,6,2020,2,268,388,656,2020-06-21 01:00:00,2020-06-21 00:00:00,LABORABLE
21,6,2020,3,180,310,490,2020-06-21 02:00:00,2020-06-21 00:00:00,LABORABLE
21,6,2020,4,146,193,339,2020-06-21 03:00:00,2020-06-21 00:00:00,LABORABLE
21,6,2020,5,69,156,225,2020-06-21 04:00:00,2020-06-21 00:00:00,LABORABLE
21,6,2020,6,68,128,196,2020-06-21 05:00:00,2020-06-21 00:00:00,LABORABLE
21,6,2020,7,108,122,230,2020-06-21 06:00:00,2020-06-21 00:00:00,LABORABLE
21,6,2020,8,156,176,332,2020-06-21 07:00:00,2020-06-21 00:00:00,LABORABLE
21,6,2020,9,197,254,451,2020-06-21 08:00:00,2020-06-21 00:00:00,LABORABLE
21,6,2020,10,280,416,696,2020-06-21 09:00:00,2020-06-21 00:00:00,LABORABLE
21,6,2020,11,339,572,911,2020-06-21 10:00:00,2020-06-21 00:00:00,LABORABLE
21,6,2020,12,501,637,1138,2020-06-21 11:00:00,2020-06-21 00:00:00,LABORABLE
21,6,2020,13,526,730,1256,2020-06-21 12:00:00,2020-06-21 00:00:00,LABORABLE
21,6,2020,14,537,801,1338,2020-06-21 13:00:00,2020-06-21 00:00:00,LABORABLE
21,6,2020,15,470,748,1218,2020-06-21 14:00:00,2020-06-21 00:00:00,LABORABLE
21,6,2020,16,374,609,983,2020-06-21 15:00:00,2020-06-21 00:00:00,LABORABLE
21,6,2020,17,332,574,906,2020-06-21 16:00:00,2020-06-21 00:00:00,LABORABLE
21,6,2020,18,347,617,964,2020-06-21 17:00:00,2020-06-21 00:00:00,LABORABLE
21,6,2020,19,491,692,1183,2020-06-21 18:00:00,2020-06-21 00:00:00,LABORABLE
21,6,2020,20,446,771,1217,2020-06-21 19:00:00,2020-06-21 00:00:00,LABORABLE
21,6,2020,21,440,745,1185,2020-06-21 20:00:00,2020-06-21 00:00:00,LABORABLE
21,6,2020,22,438,647,1085,2020-06-21 21:00:00,2020-06-21 00:00:00,LABORABLE
21,6,2020,23,398,586,984,2020-06-21 22:00:00,2020-06-21 00:00:00,LABORABLE
21,6,2020,24,259,350,609,2020-06-21 23:00:00,2020-06-21 00:00:00,LABORABLE
22,6,2020,1,237,274,511,2020-06-22 00:00:00,2020-06-22 00:00:00,LABORABLE
22,6,2020,2,123,184,307,2020-06-22 01:00:00,2020-06-22 00:00:00,LABORABLE
22,6,2020,3,87,134,221,2020-06-22 02:00:00,2020-06-22 00:00:00,LABORABLE
22,6,2020,4,62,94,156,2020-06-22 03:00:00,2020-06-22 00:00:00,LABORABLE
22,6,2020,5,60,67,127,2020-06-22 04:00:00,2020-06-22 00:00:00,LABORABLE
22,6,2020,6,145,84,229,2020-06-22 05:00:00,2020-06-22 00:00:00,LABORABLE
22,6,2020,7,379,197,576,2020-06-22 06:00:00,2020-06-22 00:00:00,LABORABLE
22,6,2020,8,618,381,999,2020-06-22 07:00:00,2020-06-22 00:00:00,LABORABLE
22,6,2020,9,553,577,1130,2020-06-22 08:00:00,2020-06-22 00:00:00,LABORABLE
22,6,2020,10,560,632,1192,2020-06-22 09:00:00,2020-06-22 00:00:00,LABORABLE
22,6,2020,11,538,697,1235,2020-06-22 10:00:00,2020-06-22 00:00:00,LABORABLE
22,6,2020,12,563,660,1223,2020-06-22 11:00:00,2020-06-22 00:00:00,LABORABLE
22,6,2020,13,577,681,1258,2020-06-22 12:00:00,2020-06-22 00:00:00,LABORABLE
22,6,2020,14,581,657,1238,2020-06-22 13:00:00,2020-06-22 00:00:00,LABORABLE
22,6,2020,15,562,642,1204,2020-06-22 14:00:00,2020-06-22 00:00:00,LABORABLE
22,6,2020,16,515,585,1100,2020-06-22 15:00:00,2020-06-22 00:00:00,LABORABLE
22,6,2020,17,523,595,1118,2020-06-22 16:00:00,2020-06-22 00:00:00,LABORABLE
22,6,2020,18,556,666,1222,2020-06-22 17:00:00,2020-06-22 00:00:00,LABORABLE
22,6,2020,19,578,714,1292,2020-06-22 18:00:00,2020-06-22 00:00:00,LABORABLE
22,6,2020,20,637,763,1400,2020-06-22 19:00:00,2020-06-22 00:00:00,LABORABLE
22,6,2020,21,544,703,1247,2020-06-22 20:00:00,2020-06-22 00:00:00,LABORABLE
22,6,2020,22,431,574,1005,2020-06-22 21:00:00,2020-06-22 00:00:00,LABORABLE
22,6,2020,23,363,447,810,2020-06-22 22:00:00,2020-06-22 00:00:00,LABORABLE
22,6,2020,24,234,267,501,2020-06-22 23:00:00,2020-06-22 00:00:00,LABORABLE
23,6,2020,1,162,211,373,2020-06-23 00:00:00,2020-06-23 00:00:00,LABORABLE
23,6,2020,2,98,128,226,2020-06-23 01:00:00,2020-06-23 00:00:00,LABORABLE
23,6,2020,3,77,108,185,2020-06-23 02:00:00,2020-06-23 00:00:00,LABORABLE
23,6,2020,4,62,67,129,2020-06-23 03:00:00,2020-06-23 00:00:00,LABORABLE
23,6,2020,5,84,67,151,2020-06-23 04:00:00,2020-06-23 00:00:00,LABORABLE
23,6,2020,6,151,87,238,2020-06-23 05:00:00,2020-06-23 00:00:00,LABORABLE
23,6,2020,7,399,194,593,2020-06-23 06:00:00,2020-06-23 00:00:00,LABORABLE
23,6,2020,8,598,386,984,2020-06-23 07:00:00,2020-06-23 00:00:00,LABORABLE
23,6,2020,9,587,551,1138,2020-06-23 08:00:00,2020-06-23 00:00:00,LABORABLE
23,6,2020,10,555,625,1180,2020-06-23 09:00:00,2020-06-23 00:00:00,LABORABLE
23,6,2020,11,395,620,1015,2020-06-23 10:00:00,2020-06-23 00:00:00,LABORABLE
23,6,2020,12,586,671,1257,2020-06-23 11:00:00,2020-06-23 00:00:00,LABORABLE
23,6,2020,13,564,688,1252,2020-06-23 12:00:00,2020-06-23 00:00:00,LABORABLE
23,6,2020,14,625,705,1330,2020-06-23 13:00:00,2020-06-23 00:00:00,LABORABLE
23,6,2020,15,565,593,1158,2020-06-23 14:00:00,2020-06-23 00:00:00,LABORABLE
23,6,2020,16,539,519,1058,2020-06-23 15:00:00,2020-06-23 00:00:00,LABORABLE
23,6,2020,17,492,605,1097,2020-06-23 16:00:00,2020-06-23 00:00:00,LABORABLE
23,6,2020,18,547,618,1165,2020-06-23 17:00:00,2020-06-23 00:00:00,LABORABLE
23,6,2020,19,618,745,1363,2020-06-23 18:00:00,2020-06-23 00:00:00,LABORABLE
23,6,2020,20,586,772,1358,2020-06-23 19:00:00,2020-06-23 00:00:00,LABORABLE
23,6,2020,21,504,705,1209,2020-06-23 20:00:00,2020-06-23 00:00:00,LABORABLE
23,6,2020,22,437,540,977,2020-06-23 21:00:00,2020-06-23 00:00:00,LABORABLE
23,6,2020,23,372,450,822,2020-06-23 22:00:00,2020-06-23 00:00:00,LABORABLE
23,6,2020,24,249,281,530,2020-06-23 23:00:00,2020-06-23 00:00:00,LABORABLE
24,6,2020,1,157,218,375,2020-06-24 00:00:00,2020-06-24 00:00:00,LABORABLE
24,6,2020,2,130,128,258,2020-06-24 01:00:00,2020-06-24 00:00:00,LABORABLE
24,6,2020,3,65,113,178,2020-06-24 02:00:00,2020-06-24 00:00:00,LABORABLE
24,6,2020,4,67,66,133,2020-06-24 03:00:00,2020-06-24 00:00:00,LABORABLE
24,6,2020,5,73,65,138,2020-06-24 04:00:00,2020-06-24 00:00:00,LABORABLE
24,6,2020,6,132,93,225,2020-06-24 05:00:00,2020-06-24 00:00:00,LABORABLE
24,6,2020,7,386,199,585,2020-06-24 06:00:00,2020-06-24 00:00:00,LABORABLE
24,6,2020,8,614,375,989,2020-06-24 07:00:00,2020-06-24 00:00:00,LABORABLE
24,6,2020,9,594,497,1091,2020-06-24 08:00:00,2020-06-24 00:00:00,LABORABLE
24,6,2020,10,589,604,1193,2020-06-24 09:00:00,2020-06-24 00:00:00,LABORABLE
24,6,2020,11,529,623,1152,2020-06-24 10:00:00,2020-06-24 00:00:00,LABORABLE
24,6,2020,12,538,631,1169,2020-06-24 11:00:00,2020-06-24 00:00:00,LABORABLE
24,6,2020,13,466,642,1108,2020-06-24 12:00:00,2020-06-24 00:00:00,LABORABLE
24,6,2020,14,620,688,1308,2020-06-24 13:00:00,2020-06-24 00:00:00,LABORABLE
24,6,2020,15,568,605,1173,2020-06-24 14:00:00,2020-06-24 00:00:00,LABORABLE
24,6,2020,16,503,570,1073,2020-06-24 15:00:00,2020-06-24 00:00:00,LABORABLE
24,6,2020,17,478,613,1091,2020-06-24 16:00:00,2020-06-24 00:00:00,LABORABLE
24,6,2020,18,592,711,1303,2020-06-24 17:00:00,2020-06-24 00:00:00,LABORABLE
24,6,2020,19,650,712,1362,2020-06-24 18:00:00,2020-06-24 00:00:00,LABORABLE
24,6,2020,20,618,754,1372,2020-06-24 19:00:00,2020-06-24 00:00:00,LABORABLE
24,6,2020,21,604,716,1320,2020-06-24 20:00:00,2020-06-24 00:00:00,LABORABLE
24,6,2020,22,458,571,1029,2020-06-24 21:00:00,2020-06-24 00:00:00,LABORABLE
24,6,2020,23,366,438,804,2020-06-24 22:00:00,2020-06-24 00:00:00,LABORABLE
24,6,2020,24,266,271,537,2020-06-24 23:00:00,2020-06-24 00:00:00,LABORABLE
25,6,2020,1,183,226,409,2020-06-25 00:00:00,2020-06-25 00:00:00,LABORABLE
25,6,2020,2,123,153,276,2020-06-25 01:00:00,2020-06-25 00:00:00,LABORABLE
25,6,2020,3,76,101,177,2020-06-25 02:00:00,2020-06-25 00:00:00,LABORABLE
25,6,2020,4,63,69,132,2020-06-25 03:00:00,2020-06-25 00:00:00,LABORABLE
25,6,2020,5,77,61,138,2020-06-25 04:00:00,2020-06-25 00:00:00,LABORABLE
25,6,2020,6,147,86,233,2020-06-25 05:00:00,2020-06-25 00:00:00,LABORABLE
25,6,2020,7,370,197,567,2020-06-25 06:00:00,2020-06-25 00:00:00,LABORABLE
25,6,2020,8,587,401,988,2020-06-25 07:00:00,2020-06-25 00:00:00,LABORABLE
25,6,2020,9,578,527,1105,2020-06-25 08:00:00,2020-06-25 00:00:00,LABORABLE
25,6,2020,10,572,611,1183,2020-06-25 09:00:00,2020-06-25 00:00:00,LABORABLE
25,6,2020,11,429,635,1064,2020-06-25 10:00:00,2020-06-25 00:00:00,LABORABLE
25,6,2020,12,557,688,1245,2020-06-25 11:00:00,2020-06-25 00:00:00,LABORABLE
25,6,2020,13,616,711,1327,2020-06-25 12:00:00,2020-06-25 00:00:00,LABORABLE
25,6,2020,14,606,685,1291,2020-06-25 13:00:00,2020-06-25 00:00:00,LABORABLE
25,6,2020,15,590,559,1149,2020-06-25 14:00:00,2020-06-25 00:00:00,LABORABLE
25,6,2020,16,549,542,1091,2020-06-25 15:00:00,2020-06-25 00:00:00,LABORABLE
25,6,2020,17,498,589,1087,2020-06-25 16:00:00,2020-06-25 00:00:00,LABORABLE
25,6,2020,18,572,638,1210,2020-06-25 17:00:00,2020-06-25 00:00:00,LABORABLE
25,6,2020,19,567,687,1254,2020-06-25 18:00:00,2020-06-25 00:00:00,LABORABLE
25,6,2020,20,672,719,1391,2020-06-25 19:00:00,2020-06-25 00:00:00,LABORABLE
25,6,2020,21,603,699,1302,2020-06-25 20:00:00,2020-06-25 00:00:00,LABORABLE
25,6,2020,22,474,613,1087,2020-06-25 21:00:00,2020-06-25 00:00:00,LABORABLE
25,6,2020,23,432,497,929,2020-06-25 22:00:00,2020-06-25 00:00:00,LABORABLE
25,6,2020,24,262,292,554,2020-06-25 23:00:00,2020-06-25 00:00:00,LABORABLE
26,6,2020,1,198,282,480,2020-06-26 00:00:00,2020-06-26 00:00:00,LABORABLE
26,6,2020,2,148,179,327,2020-06-26 01:00:00,2020-06-26 00:00:00,LABORABLE
26,6,2020,3,102,146,248,2020-06-26 02:00:00,2020-06-26 00:00:00,LABORABLE
26,6,2020,4,66,101,167,2020-06-26 03:00:00,2020-06-26 00:00:00,LABORABLE
26,6,2020,5,77,82,159,2020-06-26 04:00:00,2020-06-26 00:00:00,LABORABLE
26,6,2020,6,149,89,238,2020-06-26 05:00:00,2020-06-26 00:00:00,LABORABLE
26,6,2020,7,361,172,533,2020-06-26 06:00:00,2020-06-26 00:00:00,LABORABLE
26,6,2020,8,603,383,986,2020-06-26 07:00:00,2020-06-26 00:00:00,LABORABLE
26,6,2020,9,544,526,1070,2020-06-26 08:00:00,2020-06-26 00:00:00,LABORABLE
26,6,2020,10,522,616,1138,2020-06-26 09:00:00,2020-06-26 00:00:00,LABORABLE
26,6,2020,11,552,666,1218,2020-06-26 10:00:00,2020-06-26 00:00:00,LABORABLE
26,6,2020,12,590,679,1269,2020-06-26 11:00:00,2020-06-26 00:00:00,LABORABLE
26,6,2020,13,573,738,1311,2020-06-26 12:00:00,2020-06-26 00:00:00,LABORABLE
26,6,2020,14,570,697,1267,2020-06-26 13:00:00,2020-06-26 00:00:00,LABORABLE
26,6,2020,15,629,635,1264,2020-06-26 14:00:00,2020-06-26 00:00:00,LABORABLE
26,6,2020,16,563,605,1168,2020-06-26 15:00:00,2020-06-26 00:00:00,LABORABLE
26,6,2020,17,510,634,1144,2020-06-26 16:00:00,2020-06-26 00:00:00,LABORABLE
26,6,2020,18,615,642,1257,2020-06-26 17:00:00,2020-06-26 00:00:00,LABORABLE
26,6,2020,19,617,701,1318,2020-06-26 18:00:00,2020-06-26 00:00:00,LABORABLE
26,6,2020,20,624,786,1410,2020-06-26 19:00:00,2020-06-26 00:00:00,LABORABLE
26,6,2020,21,593,756,1349,2020-06-26 20:00:00,2020-06-26 00:00:00,LABORABLE
26,6,2020,22,553,626,1179,2020-06-26 21:00:00,2020-06-26 00:00:00,LABORABLE
26,6,2020,23,448,564,1012,2020-06-26 22:00:00,2020-06-26 00:00:00,LABORABLE
26,6,2020,24,329,364,693,2020-06-26 23:00:00,2020-06-26 00:00:00,LABORABLE
27,6,2020,1,256,493,749,2020-06-27 00:00:00,2020-06-27 00:00:00,LABORABLE
27,6,2020,2,223,386,609,2020-06-27 01:00:00,2020-06-27 00:00:00,LABORABLE
27,6,2020,3,203,299,502,2020-06-27 02:00:00,2020-06-27 00:00:00,LABORABLE
27,6,2020,4,119,242,361,2020-06-27 03:00:00,2020-06-27 00:00:00,LABORABLE
27,6,2020,5,99,195,294,2020-06-27 04:00:00,2020-06-27 00:00:00,LABORABLE
27,6,2020,6,111,146,257,2020-06-27 05:00:00,2020-06-27 00:00:00,LABORABLE
27,6,2020,7,168,156,324,2020-06-27 06:00:00,2020-06-27 00:00:00,LABORABLE
27,6,2020,8,290,264,554,2020-06-27 07:00:00,2020-06-27 00:00:00,LABORABLE
27,6,2020,9,299,397,696,2020-06-27 08:00:00,2020-06-27 00:00:00,LABORABLE
27,6,2020,10,423,558,981,2020-06-27 09:00:00,2020-06-27 00:00:00,LABORABLE
27,6,2020,11,512,716,1228,2020-06-27 10:00:00,2020-06-27 00:00:00,LABORABLE
27,6,2020,12,564,863,1427,2020-06-27 11:00:00,2020-06-27 00:00:00,LABORABLE
27,6,2020,13,547,916,1463,2020-06-27 12:00:00,2020-06-27 00:00:00,LABORABLE
27,6,2020,14,597,906,1503,2020-06-27 13:00:00,2020-06-27 00:00:00,LABORABLE
27,6,2020,15,535,863,1398,2020-06-27 14:00:00,2020-06-27 00:00:00,LABORABLE
27,6,2020,16,408,763,1171,2020-06-27 15:00:00,2020-06-27 00:00:00,LABORABLE
27,6,2020,17,391,747,1138,2020-06-27 16:00:00,2020-06-27 00:00:00,LABORABLE
27,6,2020,18,439,765,1204,2020-06-27 17:00:00,2020-06-27 00:00:00,LABORABLE
27,6,2020,19,486,727,1213,2020-06-27 18:00:00,2020-06-27 00:00:00,LABORABLE
27,6,2020,20,523,797,1320,2020-06-27 19:00:00,2020-06-27 00:00:00,LABORABLE
27,6,2020,21,480,823,1303,2020-06-27 20:00:00,2020-06-27 00:00:00,LABORABLE
27,6,2020,22,444,711,1155,2020-06-27 21:00:00,2020-06-27 00:00:00,LABORABLE
27,6,2020,23,389,756,1145,2020-06-27 22:00:00,2020-06-27 00:00:00,LABORABLE
27,6,2020,24,338,524,862,2020-06-27 23:00:00,2020-06-27 00:00:00,LABORABLE
28,6,2020,1,303,529,832,2020-06-28 00:00:00,2020-06-28 00:00:00,LABORABLE
28,6,2020,2,243,401,644,2020-06-28 01:00:00,2020-06-28 00:00:00,LABORABLE
28,6,2020,3,214,366,580,2020-06-28 02:00:00,2020-06-28 00:00:00,LABORABLE
28,6,2020,4,139,251,390,2020-06-28 03:00:00,2020-06-28 00:00:00,LABORABLE
28,6,2020,5,87,156,243,2020-06-28 04:00:00,2020-06-28 00:00:00,LABORABLE
28,6,2020,6,86,152,238,2020-06-28 05:00:00,2020-06-28 00:00:00,LABORABLE
28,6,2020,7,104,145,249,2020-06-28 06:00:00,2020-06-28 00:00:00,LABORABLE
28,6,2020,8,142,166,308,2020-06-28 07:00:00,2020-06-28 00:00:00,LABORABLE
28,6,2020,9,191,247,438,2020-06-28 08:00:00,2020-06-28 00:00:00,LABORABLE
28,6,2020,10,307,452,759,2020-06-28 09:00:00,2020-06-28 00:00:00,LABORABLE
28,6,2020,11,353,518,871,2020-06-28 10:00:00,2020-06-28 00:00:00,LABORABLE
28,6,2020,12,462,639,1101,2020-06-28 11:00:00,2020-06-28 00:00:00,LABORABLE
28,6,2020,13,482,698,1180,2020-06-28 12:00:00,2020-06-28 00:00:00,LABORABLE
28,6,2020,14,468,808,1276,2020-06-28 13:00:00,2020-06-28 00:00:00,LABORABLE
28,6,2020,15,463,765,1228,2020-06-28 14:00:00,2020-06-28 00:00:00,LABORABLE
28,6,2020,16,361,616,977,2020-06-28 15:00:00,2020-06-28 00:00:00,LABORABLE
28,6,2020,17,320,638,958,2020-06-28 16:00:00,2020-06-28 00:00:00,LABORABLE
28,6,2020,18,373,647,1020,2020-06-28 17:00:00,2020-06-28 00:00:00,LABORABLE
28,6,2020,19,415,681,1096,2020-06-28 18:00:00,2020-06-28 00:00:00,LABORABLE
28,6,2020,20,476,782,1258,2020-06-28 19:00:00,2020-06-28 00:00:00,LABORABLE
28,6,2020,21,410,768,1178,2020-06-28 20:00:00,2020-06-28 00:00:00,LABORABLE
28,6,2020,22,431,702,1133,2020-06-28 21:00:00,2020-06-28 00:00:00,LABORABLE
28,6,2020,23,391,617,1008,2020-06-28 22:00:00,2020-06-28 00:00:00,LABORABLE
28,6,2020,24,314,393,707,2020-06-28 23:00:00,2020-06-28 00:00:00,LABORABLE
29,6,2020,1,260,333,593,2020-06-29 00:00:00,2020-06-29 00:00:00,LABORABLE
29,6,2020,2,137,191,328,2020-06-29 01:00:00,2020-06-29 00:00:00,LABORABLE
29,6,2020,3,95,143,238,2020-06-29 02:00:00,2020-06-29 00:00:00,LABORABLE
29,6,2020,4,74,91,165,2020-06-29 03:00:00,2020-06-29 00:00:00,LABORABLE
29,6,2020,5,68,62,130,2020-06-29 04:00:00,2020-06-29 00:00:00,LABORABLE
29,6,2020,6,148,95,243,2020-06-29 05:00:00,2020-06-29 00:00:00,LABORABLE
29,6,2020,7,370,194,564,2020-06-29 06:00:00,2020-06-29 00:00:00,LABORABLE
29,6,2020,8,619,357,976,2020-06-29 07:00:00,2020-06-29 00:00:00,LABORABLE
29,6,2020,9,583,556,1139,2020-06-29 08:00:00,2020-06-29 00:00:00,LABORABLE
29,6,2020,10,546,674,1220,2020-06-29 09:00:00,2020-06-29 00:00:00,LABORABLE
29,6,2020,11,490,699,1189,2020-06-29 10:00:00,2020-06-29 00:00:00,LABORABLE
29,6,2020,12,613,674,1287,2020-06-29 11:00:00,2020-06-29 00:00:00,LABORABLE
29,6,2020,13,604,691,1295,2020-06-29 12:00:00,2020-06-29 00:00:00,LABORABLE
29,6,2020,14,623,709,1332,2020-06-29 13:00:00,2020-06-29 00:00:00,LABORABLE
29,6,2020,15,582,587,1169,2020-06-29 14:00:00,2020-06-29 00:00:00,LABORABLE
29,6,2020,16,525,550,1075,2020-06-29 15:00:00,2020-06-29 00:00:00,LABORABLE
29,6,2020,17,533,603,1136,2020-06-29 16:00:00,2020-06-29 00:00:00,LABORABLE
29,6,2020,18,551,674,1225,2020-06-29 17:00:00,2020-06-29 00:00:00,LABORABLE
29,6,2020,19,630,718,1348,2020-06-29 18:00:00,2020-06-29 00:00:00,LABORABLE
29,6,2020,20,618,740,1358,2020-06-29 19:00:00,2020-06-29 00:00:00,LABORABLE
29,6,2020,21,574,706,1280,2020-06-29 20:00:00,2020-06-29 00:00:00,LABORABLE
29,6,2020,22,493,580,1073,2020-06-29 21:00:00,2020-06-29 00:00:00,LABORABLE
29,6,2020,23,374,464,838,2020-06-29 22:00:00,2020-06-29 00:00:00,LABORABLE
29,6,2020,24,223,267,490,2020-06-29 23:00:00,2020-06-29 00:00:00,LABORABLE
30,6,2020,1,205,281,486,2020-06-30 00:00:00,2020-06-30 00:00:00,LABORABLE
30,6,2020,2,113,172,285,2020-06-30 01:00:00,2020-06-30 00:00:00,LABORABLE
30,6,2020,3,87,128,215,2020-06-30 02:00:00,2020-06-30 00:00:00,LABORABLE
30,6,2020,4,75,66,141,2020-06-30 03:00:00,2020-06-30 00:00:00,LABORABLE
30,6,2020,5,80,65,145,2020-06-30 04:00:00,2020-06-30 00:00:00,LABORABLE
30,6,2020,6,147,90,237,2020-06-30 05:00:00,2020-06-30 00:00:00,LABORABLE
30,6,2020,7,380,179,559,2020-06-30 06:00:00,2020-06-30 00:00:00,LABORABLE
30,6,2020,8,617,379,996,2020-06-30 07:00:00,2020-06-30 00:00:00,LABORABLE
30,6,2020,9,605,537,1142,2020-06-30 08:00:00,2020-06-30 00:00:00,LABORABLE
30,6,2020,10,575,637,1212,2020-06-30 09:00:00,2020-06-30 00:00:00,LABORABLE
30,6,2020,11,553,638,1191,2020-06-30 10:00:00,2020-06-30 00:00:00,LABORABLE
30,6,2020,12,570,642,1212,2020-06-30 11:00:00,2020-06-30 00:00:00,LABORABLE
30,6,2020,13,557,681,1238,2020-06-30 12:00:00,2020-06-30 00:00:00,LABORABLE
30,6,2020,14,620,726,1346,2020-06-30 13:00:00,2020-06-30 00:00:00,LABORABLE
30,6,2020,15,582,626,1208,2020-06-30 14:00:00,2020-06-30 00:00:00,LABORABLE
30,6,2020,16,534,580,1114,2020-06-30 15:00:00,2020-06-30 00:00:00,LABORABLE
30,6,2020,17,483,607,1090,2020-06-30 16:00:00,2020-06-30 00:00:00,LABORABLE
30,6,2020,18,593,687,1280,2020-06-30 17:00:00,2020-06-30 00:00:00,LABORABLE
30,6,2020,19,580,722,1302,2020-06-30 18:00:00,2020-06-30 00:00:00,LABORABLE
30,6,2020,20,624,781,1405,2020-06-30 19:00:00,2020-06-30 00:00:00,LABORABLE
30,6,2020,21,613,711,1324,2020-06-30 20:00:00,2020-06-30 00:00:00,LABORABLE
30,6,2020,22,523,660,1183,2020-06-30 21:00:00,2020-06-30 00:00:00,LABORABLE
30,6,2020,23,349,481,830,2020-06-30 22:00:00,2020-06-30 00:00:00,LABORABLE
30,6,2020,24,277,280,557,2020-06-30 23:00:00,2020-06-30 00:00:00,LABORABLE
1,7,2020,1,201,297,498,2020-07-01 00:00:00,2020-01-07 00:00:00,LABORABLE
1,7,2020,2,143,186,329,2020-07-01 01:00:00,2020-01-07 00:00:00,LABORABLE
1,7,2020,3,83,132,215,2020-07-01 02:00:00,2020-01-07 00:00:00,LABORABLE
1,7,2020,4,83,99,182,2020-07-01 03:00:00,2020-01-07 00:00:00,LABORABLE
1,7,2020,5,80,93,173,2020-07-01 04:00:00,2020-01-07 00:00:00,LABORABLE
1,7,2020,6,157,161,318,2020-07-01 05:00:00,2020-01-07 00:00:00,LABORABLE
1,7,2020,7,397,340,737,2020-07-01 06:00:00,2020-01-07 00:00:00,LABORABLE
1,7,2020,8,641,552,1193,2020-07-01 07:00:00,2020-01-07 00:00:00,LABORABLE
1,7,2020,9,587,624,1211,2020-07-01 08:00:00,2020-01-07 00:00:00,LABORABLE
1,7,2020,10,552,682,1234,2020-07-01 09:00:00,2020-01-07 00:00:00,LABORABLE
1,7,2020,11,558,721,1279,2020-07-01 10:00:00,2020-01-07 00:00:00,LABORABLE
1,7,2020,12,444,731,1175,2020-07-01 11:00:00,2020-01-07 00:00:00,LABORABLE
1,7,2020,13,576,609,1185,2020-07-01 12:00:00,2020-01-07 00:00:00,LABORABLE
1,7,2020,14,592,770,1362,2020-07-01 13:00:00,2020-01-07 00:00:00,LABORABLE
1,7,2020,15,593,720,1313,2020-07-01 14:00:00,2020-01-07 00:00:00,LABORABLE
1,7,2020,16,514,659,1173,2020-07-01 15:00:00,2020-01-07 00:00:00,LABORABLE
1,7,2020,17,540,675,1215,2020-07-01 16:00:00,2020-01-07 00:00:00,LABORABLE
1,7,2020,18,616,720,1336,2020-07-01 17:00:00,2020-01-07 00:00:00,LABORABLE
1,7,2020,19,649,802,1451,2020-07-01 18:00:00,2020-01-07 00:00:00,LABORABLE
1,7,2020,20,607,833,1440,2020-07-01 19:00:00,2020-01-07 00:00:00,LABORABLE
1,7,2020,21,570,815,1385,2020-07-01 20:00:00,2020-01-07 00:00:00,LABORABLE
1,7,2020,22,505,632,1137,2020-07-01 21:00:00,2020-01-07 00:00:00,LABORABLE
1,7,2020,23,378,501,879,2020-07-01 22:00:00,2020-01-07 00:00:00,LABORABLE
1,7,2020,24,293,381,674,2020-07-01 23:00:00,2020-01-07 00:00:00,LABORABLE
2,7,2020,1,186,296,482,2020-07-02 00:00:00,2020-02-07 00:00:00,LABORABLE
2,7,2020,2,111,186,297,2020-07-02 01:00:00,2020-02-07 00:00:00,LABORABLE
2,7,2020,3,113,159,272,2020-07-02 02:00:00,2020-02-07 00:00:00,LABORABLE
2,7,2020,4,72,96,168,2020-07-02 03:00:00,2020-02-07 00:00:00,LABORABLE
2,7,2020,5,73,97,170,2020-07-02 04:00:00,2020-02-07 00:00:00,LABORABLE
2,7,2020,6,165,136,301,2020-07-02 05:00:00,2020-02-07 00:00:00,LABORABLE
2,7,2020,7,391,319,710,2020-07-02 06:00:00,2020-02-07 00:00:00,LABORABLE
2,7,2020,8,656,592,1248,2020-07-02 07:00:00,2020-02-07 00:00:00,LABORABLE
2,7,2020,9,601,637,1238,2020-07-02 08:00:00,2020-02-07 00:00:00,LABORABLE
2,7,2020,10,545,694,1239,2020-07-02 09:00:00,2020-02-07 00:00:00,LABORABLE
2,7,2020,11,571,653,1224,2020-07-02 10:00:00,2020-02-07 00:00:00,LABORABLE
2,7,2020,12,538,733,1271,2020-07-02 11:00:00,2020-02-07 00:00:00,LABORABLE
2,7,2020,13,575,795,1370,2020-07-02 12:00:00,2020-02-07 00:00:00,LABORABLE
2,7,2020,14,530,756,1286,2020-07-02 13:00:00,2020-02-07 00:00:00,LABORABLE
2,7,2020,15,603,756,1359,2020-07-02 14:00:00,2020-02-07 00:00:00,LABORABLE
2,7,2020,16,557,699,1256,2020-07-02 15:00:00,2020-02-07 00:00:00,LABORABLE
2,7,2020,17,539,670,1209,2020-07-02 16:00:00,2020-02-07 00:00:00,LABORABLE
2,7,2020,18,594,748,1342,2020-07-02 17:00:00,2020-02-07 00:00:00,LABORABLE
2,7,2020,19,619,844,1463,2020-07-02 18:00:00,2020-02-07 00:00:00,LABORABLE
2,7,2020,20,609,746,1355,2020-07-02 19:00:00,2020-02-07 00:00:00,LABORABLE
2,7,2020,21,642,776,1418,2020-07-02 20:00:00,2020-02-07 00:00:00,LABORABLE
2,7,2020,22,547,655,1202,2020-07-02 21:00:00,2020-02-07 00:00:00,LABORABLE
2,7,2020,23,439,500,939,2020-07-02 22:00:00,2020-02-07 00:00:00,LABORABLE
2,7,2020,24,270,365,635,2020-07-02 23:00:00,2020-02-07 00:00:00,LABORABLE
3,7,2020,1,277,325,602,2020-07-03 00:00:00,2020-03-07 00:00:00,LABORABLE
3,7,2020,2,139,205,344,2020-07-03 01:00:00,2020-03-07 00:00:00,LABORABLE
3,7,2020,3,125,175,300,2020-07-03 02:00:00,2020-03-07 00:00:00,LABORABLE
3,7,2020,4,95,126,221,2020-07-03 03:00:00,2020-03-07 00:00:00,LABORABLE
3,7,2020,5,90,104,194,2020-07-03 04:00:00,2020-03-07 00:00:00,LABORABLE
3,7,2020,6,162,142,304,2020-07-03 05:00:00,2020-03-07 00:00:00,LABORABLE
3,7,2020,7,407,327,734,2020-07-03 06:00:00,2020-03-07 00:00:00,LABORABLE
3,7,2020,8,624,574,1198,2020-07-03 07:00:00,2020-03-07 00:00:00,LABORABLE
3,7,2020,9,548,636,1184,2020-07-03 08:00:00,2020-03-07 00:00:00,LABORABLE
3,7,2020,10,543,668,1211,2020-07-03 09:00:00,2020-03-07 00:00:00,LABORABLE
3,7,2020,11,544,604,1148,2020-07-03 10:00:00,2020-03-07 00:00:00,LABORABLE
3,7,2020,12,563,775,1338,2020-07-03 11:00:00,2020-03-07 00:00:00,LABORABLE
3,7,2020,13,599,742,1341,2020-07-03 12:00:00,2020-03-07 00:00:00,LABORABLE
3,7,2020,14,580,752,1332,2020-07-03 13:00:00,2020-03-07 00:00:00,LABORABLE
3,7,2020,15,647,776,1423,2020-07-03 14:00:00,2020-03-07 00:00:00,LABORABLE
3,7,2020,16,550,658,1208,2020-07-03 15:00:00,2020-03-07 00:00:00,LABORABLE
3,7,2020,17,546,693,1239,2020-07-03 16:00:00,2020-03-07 00:00:00,LABORABLE
3,7,2020,18,596,720,1316,2020-07-03 17:00:00,2020-03-07 00:00:00,LABORABLE
3,7,2020,19,620,826,1446,2020-07-03 18:00:00,2020-03-07 00:00:00,LABORABLE
3,7,2020,20,670,790,1460,2020-07-03 19:00:00,2020-03-07 00:00:00,LABORABLE
3,7,2020,21,596,793,1389,2020-07-03 20:00:00,2020-03-07 00:00:00,LABORABLE
3,7,2020,22,555,729,1284,2020-07-03 21:00:00,2020-03-07 00:00:00,LABORABLE
3,7,2020,23,514,626,1140,2020-07-03 22:00:00,2020-03-07 00:00:00,LABORABLE
3,7,2020,24,384,476,860,2020-07-03 23:00:00,2020-03-07 00:00:00,LABORABLE
4,7,2020,1,308,425,733,2020-07-04 00:00:00,2020-04-07 00:00:00,LABORABLE
4,7,2020,2,263,305,568,2020-07-04 01:00:00,2020-04-07 00:00:00,LABORABLE
4,7,2020,3,201,287,488,2020-07-04 02:00:00,2020-04-07 00:00:00,LABORABLE
4,7,2020,4,123,202,325,2020-07-04 03:00:00,2020-04-07 00:00:00,LABORABLE
4,7,2020,5,118,188,306,2020-07-04 04:00:00,2020-04-07 00:00:00,LABORABLE
4,7,2020,6,118,183,301,2020-07-04 05:00:00,2020-04-07 00:00:00,LABORABLE
4,7,2020,7,196,231,427,2020-07-04 06:00:00,2020-04-07 00:00:00,LABORABLE
4,7,2020,8,279,295,574,2020-07-04 07:00:00,2020-04-07 00:00:00,LABORABLE
4,7,2020,9,346,395,741,2020-07-04 08:00:00,2020-04-07 00:00:00,LABORABLE
4,7,2020,10,434,511,945,2020-07-04 09:00:00,2020-04-07 00:00:00,LABORABLE
4,7,2020,11,534,540,1074,2020-07-04 10:00:00,2020-04-07 00:00:00,LABORABLE
4,7,2020,12,545,685,1230,2020-07-04 11:00:00,2020-04-07 00:00:00,LABORABLE
4,7,2020,13,588,691,1279,2020-07-04 12:00:00,2020-04-07 00:00:00,LABORABLE
4,7,2020,14,569,704,1273,2020-07-04 13:00:00,2020-04-07 00:00:00,LABORABLE
4,7,2020,15,538,737,1275,2020-07-04 14:00:00,2020-04-07 00:00:00,LABORABLE
4,7,2020,16,476,621,1097,2020-07-04 15:00:00,2020-04-07 00:00:00,LABORABLE
4,7,2020,17,381,646,1027,2020-07-04 16:00:00,2020-04-07 00:00:00,LABORABLE
4,7,2020,18,427,589,1016,2020-07-04 17:00:00,2020-04-07 00:00:00,LABORABLE
4,7,2020,19,502,660,1162,2020-07-04 18:00:00,2020-04-07 00:00:00,LABORABLE
4,7,2020,20,505,736,1241,2020-07-04 19:00:00,2020-04-07 00:00:00,LABORABLE
4,7,2020,21,547,703,1250,2020-07-04 20:00:00,2020-04-07 00:00:00,LABORABLE
4,7,2020,22,461,675,1136,2020-07-04 21:00:00,2020-04-07 00:00:00,LABORABLE
4,7,2020,23,450,558,1008,2020-07-04 22:00:00,2020-04-07 00:00:00,LABORABLE
4,7,2020,24,341,506,847,2020-07-04 23:00:00,2020-04-07 00:00:00,LABORABLE
5,7,2020,1,326,479,805,2020-07-05 00:00:00,2020-05-07 00:00:00,LABORABLE
5,7,2020,2,283,361,644,2020-07-05 01:00:00,2020-05-07 00:00:00,LABORABLE
5,7,2020,3,246,306,552,2020-07-05 02:00:00,2020-05-07 00:00:00,LABORABLE
5,7,2020,4,158,261,419,2020-07-05 03:00:00,2020-05-07 00:00:00,LABORABLE
5,7,2020,5,137,196,333,2020-07-05 04:00:00,2020-05-07 00:00:00,LABORABLE
5,7,2020,6,115,206,321,2020-07-05 05:00:00,2020-05-07 00:00:00,LABORABLE
5,7,2020,7,152,203,355,2020-07-05 06:00:00,2020-05-07 00:00:00,LABORABLE
5,7,2020,8,161,212,373,2020-07-05 07:00:00,2020-05-07 00:00:00,LABORABLE
5,7,2020,9,193,242,435,2020-07-05 08:00:00,2020-05-07 00:00:00,LABORABLE
5,7,2020,10,297,398,695,2020-07-05 09:00:00,2020-05-07 00:00:00,LABORABLE
5,7,2020,11,406,468,874,2020-07-05 10:00:00,2020-05-07 00:00:00,LABORABLE
5,7,2020,12,513,570,1083,2020-07-05 11:00:00,2020-05-07 00:00:00,LABORABLE
5,7,2020,13,466,568,1034,2020-07-05 12:00:00,2020-05-07 00:00:00,LABORABLE
5,7,2020,14,470,669,1139,2020-07-05 13:00:00,2020-05-07 00:00:00,LABORABLE
5,7,2020,15,469,608,1077,2020-07-05 14:00:00,2020-05-07 00:00:00,LABORABLE
5,7,2020,16,356,531,887,2020-07-05 15:00:00,2020-05-07 00:00:00,LABORABLE
5,7,2020,17,331,514,845,2020-07-05 16:00:00,2020-05-07 00:00:00,LABORABLE
5,7,2020,18,394,566,960,2020-07-05 17:00:00,2020-05-07 00:00:00,LABORABLE
5,7,2020,19,433,566,999,2020-07-05 18:00:00,2020-05-07 00:00:00,LABORABLE
5,7,2020,20,443,628,1071,2020-07-05 19:00:00,2020-05-07 00:00:00,LABORABLE
5,7,2020,21,420,656,1076,2020-07-05 20:00:00,2020-05-07 00:00:00,LABORABLE
5,7,2020,22,400,551,951,2020-07-05 21:00:00,2020-05-07 00:00:00,LABORABLE
5,7,2020,23,385,507,892,2020-07-05 22:00:00,2020-05-07 00:00:00,LABORABLE
5,7,2020,24,319,396,715,2020-07-05 23:00:00,2020-05-07 00:00:00,LABORABLE
6,7,2020,1,239,313,552,2020-07-06 00:00:00,2020-06-07 00:00:00,LABORABLE
6,7,2020,2,139,181,320,2020-07-06 01:00:00,2020-06-07 00:00:00,LABORABLE
6,7,2020,3,110,147,257,2020-07-06 02:00:00,2020-06-07 00:00:00,LABORABLE
6,7,2020,4,80,93,173,2020-07-06 03:00:00,2020-06-07 00:00:00,LABORABLE
6,7,2020,5,88,102,190,2020-07-06 04:00:00,2020-06-07 00:00:00,LABORABLE
6,7,2020,6,153,127,280,2020-07-06 05:00:00,2020-06-07 00:00:00,LABORABLE
6,7,2020,7,393,355,748,2020-07-06 06:00:00,2020-06-07 00:00:00,LABORABLE
6,7,2020,8,662,596,1258,2020-07-06 07:00:00,2020-06-07 00:00:00,LABORABLE
6,7,2020,9,568,613,1181,2020-07-06 08:00:00,2020-06-07 00:00:00,LABORABLE
6,7,2020,10,558,719,1277,2020-07-06 09:00:00,2020-06-07 00:00:00,LABORABLE
6,7,2020,11,550,682,1232,2020-07-06 10:00:00,2020-06-07 00:00:00,LABORABLE
6,7,2020,12,608,746,1354,2020-07-06 11:00:00,2020-06-07 00:00:00,LABORABLE
6,7,2020,13,564,792,1356,2020-07-06 12:00:00,2020-06-07 00:00:00,LABORABLE
6,7,2020,14,579,750,1329,2020-07-06 13:00:00,2020-06-07 00:00:00,LABORABLE
6,7,2020,15,599,731,1330,2020-07-06 14:00:00,2020-06-07 00:00:00,LABORABLE
6,7,2020,16,546,588,1134,2020-07-06 15:00:00,2020-06-07 00:00:00,LABORABLE
6,7,2020,17,512,660,1172,2020-07-06 16:00:00,2020-06-07 00:00:00,LABORABLE
6,7,2020,18,585,723,1308,2020-07-06 17:00:00,2020-06-07 00:00:00,LABORABLE
6,7,2020,19,594,759,1353,2020-07-06 18:00:00,2020-06-07 00:00:00,LABORABLE
6,7,2020,20,613,813,1426,2020-07-06 19:00:00,2020-06-07 00:00:00,LABORABLE
6,7,2020,21,565,768,1333,2020-07-06 20:00:00,2020-06-07 00:00:00,LABORABLE
6,7,2020,22,452,619,1071,2020-07-06 21:00:00,2020-06-07 00:00:00,LABORABLE
6,7,2020,23,369,460,829,2020-07-06 22:00:00,2020-06-07 00:00:00,LABORABLE
6,7,2020,24,260,341,601,2020-07-06 23:00:00,2020-06-07 00:00:00,LABORABLE
7,7,2020,1,164,234,398,2020-07-07 00:00:00,2020-07-07 00:00:00,LABORABLE
7,7,2020,2,103,169,272,2020-07-07 01:00:00,2020-07-07 00:00:00,LABORABLE
7,7,2020,3,77,145,222,2020-07-07 02:00:00,2020-07-07 00:00:00,LABORABLE
7,7,2020,4,66,109,175,2020-07-07 03:00:00,2020-07-07 00:00:00,LABORABLE
7,7,2020,5,76,117,193,2020-07-07 04:00:00,2020-07-07 00:00:00,LABORABLE
7,7,2020,6,147,144,291,2020-07-07 05:00:00,2020-07-07 00:00:00,LABORABLE
7,7,2020,7,392,330,722,2020-07-07 06:00:00,2020-07-07 00:00:00,LABORABLE
7,7,2020,8,623,580,1203,2020-07-07 07:00:00,2020-07-07 00:00:00,LABORABLE
7,7,2020,9,520,719,1239,2020-07-07 08:00:00,2020-07-07 00:00:00,LABORABLE
7,7,2020,10,577,733,1310,2020-07-07 09:00:00,2020-07-07 00:00:00,LABORABLE
7,7,2020,11,556,640,1196,2020-07-07 10:00:00,2020-07-07 00:00:00,LABORABLE
7,7,2020,12,478,634,1112,2020-07-07 11:00:00,2020-07-07 00:00:00,LABORABLE
7,7,2020,13,591,758,1349,2020-07-07 12:00:00,2020-07-07 00:00:00,LABORABLE
7,7,2020,14,588,792,1380,2020-07-07 13:00:00,2020-07-07 00:00:00,LABORABLE
7,7,2020,15,543,745,1288,2020-07-07 14:00:00,2020-07-07 00:00:00,LABORABLE
7,7,2020,16,513,701,1214,2020-07-07 15:00:00,2020-07-07 00:00:00,LABORABLE
7,7,2020,17,521,700,1221,2020-07-07 16:00:00,2020-07-07 00:00:00,LABORABLE
7,7,2020,18,583,701,1284,2020-07-07 17:00:00,2020-07-07 00:00:00,LABORABLE
7,7,2020,19,622,800,1422,2020-07-07 18:00:00,2020-07-07 00:00:00,LABORABLE
7,7,2020,20,623,765,1388,2020-07-07 19:00:00,2020-07-07 00:00:00,LABORABLE
7,7,2020,21,586,791,1377,2020-07-07 20:00:00,2020-07-07 00:00:00,LABORABLE
7,7,2020,22,491,676,1167,2020-07-07 21:00:00,2020-07-07 00:00:00,LABORABLE
7,7,2020,23,370,491,861,2020-07-07 22:00:00,2020-07-07 00:00:00,LABORABLE
7,7,2020,24,260,382,642,2020-07-07 23:00:00,2020-07-07 00:00:00,LABORABLE
8,7,2020,1,186,297,483,2020-07-08 00:00:00,2020-08-07 00:00:00,LABORABLE
8,7,2020,2,133,186,319,2020-07-08 01:00:00,2020-08-07 00:00:00,LABORABLE
8,7,2020,3,104,132,236,2020-07-08 02:00:00,2020-08-07 00:00:00,LABORABLE
8,7,2020,4,76,99,175,2020-07-08 03:00:00,2020-08-07 00:00:00,LABORABLE
8,7,2020,5,70,93,163,2020-07-08 04:00:00,2020-08-07 00:00:00,LABORABLE
8,7,2020,6,145,161,306,2020-07-08 05:00:00,2020-08-07 00:00:00,LABORABLE
8,7,2020,7,381,340,721,2020-07-08 06:00:00,2020-08-07 00:00:00,LABORABLE
8,7,2020,8,645,552,1197,2020-07-08 07:00:00,2020-08-07 00:00:00,LABORABLE
8,7,2020,9,521,624,1145,2020-07-08 08:00:00,2020-08-07 00:00:00,LABORABLE
8,7,2020,10,578,682,1260,2020-07-08 09:00:00,2020-08-07 00:00:00,LABORABLE
8,7,2020,11,605,721,1326,2020-07-08 10:00:00,2020-08-07 00:00:00,LABORABLE
8,7,2020,12,590,731,1321,2020-07-08 11:00:00,2020-08-07 00:00:00,LABORABLE
8,7,2020,13,455,609,1064,2020-07-08 12:00:00,2020-08-07 00:00:00,LABORABLE
8,7,2020,14,602,770,1372,2020-07-08 13:00:00,2020-08-07 00:00:00,LABORABLE
8,7,2020,15,589,720,1309,2020-07-08 14:00:00,2020-08-07 00:00:00,LABORABLE
8,7,2020,16,539,659,1198,2020-07-08 15:00:00,2020-08-07 00:00:00,LABORABLE
8,7,2020,17,525,675,1200,2020-07-08 16:00:00,2020-08-07 00:00:00,LABORABLE
8,7,2020,18,570,720,1290,2020-07-08 17:00:00,2020-08-07 00:00:00,LABORABLE
8,7,2020,19,645,802,1447,2020-07-08 18:00:00,2020-08-07 00:00:00,LABORABLE
8,7,2020,20,618,833,1451,2020-07-08 19:00:00,2020-08-07 00:00:00,LABORABLE
8,7,2020,21,566,815,1381,2020-07-08 20:00:00,2020-08-07 00:00:00,LABORABLE
8,7,2020,22,489,632,1121,2020-07-08 21:00:00,2020-08-07 00:00:00,LABORABLE
8,7,2020,23,388,501,889,2020-07-08 22:00:00,2020-08-07 00:00:00,LABORABLE
8,7,2020,24,266,381,647,2020-07-08 23:00:00,2020-08-07 00:00:00,LABORABLE
9,7,2020,1,223,296,519,2020-07-09 00:00:00,2020-09-07 00:00:00,LABORABLE
9,7,2020,2,118,186,304,2020-07-09 01:00:00,2020-09-07 00:00:00,LABORABLE
9,7,2020,3,87,159,246,2020-07-09 02:00:00,2020-09-07 00:00:00,LABORABLE
9,7,2020,4,71,96,167,2020-07-09 03:00:00,2020-09-07 00:00:00,LABORABLE
9,7,2020,5,93,97,190,2020-07-09 04:00:00,2020-09-07 00:00:00,LABORABLE
9,7,2020,6,143,136,279,2020-07-09 05:00:00,2020-09-07 00:00:00,LABORABLE
9,7,2020,7,385,319,704,2020-07-09 06:00:00,2020-09-07 00:00:00,LABORABLE
9,7,2020,8,626,592,1218,2020-07-09 07:00:00,2020-09-07 00:00:00,LABORABLE
9,7,2020,9,594,637,1231,2020-07-09 08:00:00,2020-09-07 00:00:00,LABORABLE
9,7,2020,10,588,694,1282,2020-07-09 09:00:00,2020-09-07 00:00:00,LABORABLE
9,7,2020,11,455,653,1108,2020-07-09 10:00:00,2020-09-07 00:00:00,LABORABLE
9,7,2020,12,572,733,1305,2020-07-09 11:00:00,2020-09-07 00:00:00,LABORABLE
9,7,2020,13,620,795,1415,2020-07-09 12:00:00,2020-09-07 00:00:00,LABORABLE
9,7,2020,14,606,756,1362,2020-07-09 13:00:00,2020-09-07 00:00:00,LABORABLE
9,7,2020,15,558,756,1314,2020-07-09 14:00:00,2020-09-07 00:00:00,LABORABLE
9,7,2020,16,545,699,1244,2020-07-09 15:00:00,2020-09-07 00:00:00,LABORABLE
9,7,2020,17,542,670,1212,2020-07-09 16:00:00,2020-09-07 00:00:00,LABORABLE
9,7,2020,18,590,748,1338,2020-07-09 17:00:00,2020-09-07 00:00:00,LABORABLE
9,7,2020,19,641,844,1485,2020-07-09 18:00:00,2020-09-07 00:00:00,LABORABLE
9,7,2020,20,642,746,1388,2020-07-09 19:00:00,2020-09-07 00:00:00,LABORABLE
9,7,2020,21,594,776,1370,2020-07-09 20:00:00,2020-09-07 00:00:00,LABORABLE
9,7,2020,22,506,655,1161,2020-07-09 21:00:00,2020-09-07 00:00:00,LABORABLE
9,7,2020,23,431,500,931,2020-07-09 22:00:00,2020-09-07 00:00:00,LABORABLE
9,7,2020,24,307,365,672,2020-07-09 23:00:00,2020-09-07 00:00:00,LABORABLE
10,7,2020,1,206,325,531,2020-07-10 00:00:00,2020-10-07 00:00:00,LABORABLE
10,7,2020,2,139,205,344,2020-07-10 01:00:00,2020-10-07 00:00:00,LABORABLE
10,7,2020,3,110,175,285,2020-07-10 02:00:00,2020-10-07 00:00:00,LABORABLE
10,7,2020,4,66,126,192,2020-07-10 03:00:00,2020-10-07 00:00:00,LABORABLE
10,7,2020,5,89,104,193,2020-07-10 04:00:00,2020-10-07 00:00:00,LABORABLE
10,7,2020,6,150,142,292,2020-07-10 05:00:00,2020-10-07 00:00:00,LABORABLE
10,7,2020,7,385,327,712,2020-07-10 06:00:00,2020-10-07 00:00:00,LABORABLE
10,7,2020,8,620,574,1194,2020-07-10 07:00:00,2020-10-07 00:00:00,LABORABLE
10,7,2020,9,577,636,1213,2020-07-10 08:00:00,2020-10-07 00:00:00,LABORABLE
10,7,2020,10,543,668,1211,2020-07-10 09:00:00,2020-10-07 00:00:00,LABORABLE
10,7,2020,11,438,604,1042,2020-07-10 10:00:00,2020-10-07 00:00:00,LABORABLE
10,7,2020,12,592,775,1367,2020-07-10 11:00:00,2020-10-07 00:00:00,LABORABLE
10,7,2020,13,596,742,1338,2020-07-10 12:00:00,2020-10-07 00:00:00,LABORABLE
10,7,2020,14,604,752,1356,2020-07-10 13:00:00,2020-10-07 00:00:00,LABORABLE
10,7,2020,15,596,776,1372,2020-07-10 14:00:00,2020-10-07 00:00:00,LABORABLE
10,7,2020,16,554,658,1212,2020-07-10 15:00:00,2020-10-07 00:00:00,LABORABLE
10,7,2020,17,549,693,1242,2020-07-10 16:00:00,2020-10-07 00:00:00,LABORABLE
10,7,2020,18,586,720,1306,2020-07-10 17:00:00,2020-10-07 00:00:00,LABORABLE
10,7,2020,19,605,826,1431,2020-07-10 18:00:00,2020-10-07 00:00:00,LABORABLE
10,7,2020,20,639,790,1429,2020-07-10 19:00:00,2020-10-07 00:00:00,LABORABLE
10,7,2020,21,618,793,1411,2020-07-10 20:00:00,2020-10-07 00:00:00,LABORABLE
10,7,2020,22,558,729,1287,2020-07-10 21:00:00,2020-10-07 00:00:00,LABORABLE
10,7,2020,23,434,626,1060,2020-07-10 22:00:00,2020-10-07 00:00:00,LABORABLE
10,7,2020,24,378,476,854,2020-07-10 23:00:00,2020-10-07 00:00:00,LABORABLE
11,7,2020,1,289,425,714,2020-07-11 00:00:00,2020-11-07 00:00:00,LABORABLE
11,7,2020,2,246,305,551,2020-07-11 01:00:00,2020-11-07 00:00:00,LABORABLE
11,7,2020,3,212,287,499,2020-07-11 02:00:00,2020-11-07 00:00:00,LABORABLE
11,7,2020,4,138,202,340,2020-07-11 03:00:00,2020-11-07 00:00:00,LABORABLE
11,7,2020,5,135,188,323,2020-07-11 04:00:00,2020-11-07 00:00:00,LABORABLE
11,7,2020,6,148,183,331,2020-07-11 05:00:00,2020-11-07 00:00:00,LABORABLE
11,7,2020,7,190,231,421,2020-07-11 06:00:00,2020-11-07 00:00:00,LABORABLE
11,7,2020,8,268,295,563,2020-07-11 07:00:00,2020-11-07 00:00:00,LABORABLE
11,7,2020,9,321,395,716,2020-07-11 08:00:00,2020-11-07 00:00:00,LABORABLE
11,7,2020,10,445,511,956,2020-07-11 09:00:00,2020-11-07 00:00:00,LABORABLE
11,7,2020,11,504,540,1044,2020-07-11 10:00:00,2020-11-07 00:00:00,LABORABLE
11,7,2020,12,572,685,1257,2020-07-11 11:00:00,2020-11-07 00:00:00,LABORABLE
11,7,2020,13,583,691,1274,2020-07-11 12:00:00,2020-11-07 00:00:00,LABORABLE
11,7,2020,14,521,704,1225,2020-07-11 13:00:00,2020-11-07 00:00:00,LABORABLE
11,7,2020,15,535,737,1272,2020-07-11 14:00:00,2020-11-07 00:00:00,LABORABLE
11,7,2020,16,442,621,1063,2020-07-11 15:00:00,2020-11-07 00:00:00,LABORABLE
11,7,2020,17,386,646,1032,2020-07-11 16:00:00,2020-11-07 00:00:00,LABORABLE
11,7,2020,18,426,589,1015,2020-07-11 17:00:00,2020-11-07 00:00:00,LABORABLE
11,7,2020,19,521,660,1181,2020-07-11 18:00:00,2020-11-07 00:00:00,LABORABLE
11,7,2020,20,529,736,1265,2020-07-11 19:00:00,2020-11-07 00:00:00,LABORABLE
11,7,2020,21,472,703,1175,2020-07-11 20:00:00,2020-11-07 00:00:00,LABORABLE
11,7,2020,22,469,675,1144,2020-07-11 21:00:00,2020-11-07 00:00:00,LABORABLE
11,7,2020,23,433,558,991,2020-07-11 22:00:00,2020-11-07 00:00:00,LABORABLE
11,7,2020,24,365,506,871,2020-07-11 23:00:00,2020-11-07 00:00:00,LABORABLE
12,7,2020,1,347,479,826,2020-07-12 00:00:00,2020-12-07 00:00:00,LABORABLE
12,7,2020,2,283,361,644,2020-07-12 01:00:00,2020-12-07 00:00:00,LABORABLE
12,7,2020,3,185,306,491,2020-07-12 02:00:00,2020-12-07 00:00:00,LABORABLE
12,7,2020,4,143,261,404,2020-07-12 03:00:00,2020-12-07 00:00:00,LABORABLE
12,7,2020,5,124,196,320,2020-07-12 04:00:00,2020-12-07 00:00:00,LABORABLE
12,7,2020,6,97,206,303,2020-07-12 05:00:00,2020-12-07 00:00:00,LABORABLE
12,7,2020,7,148,203,351,2020-07-12 06:00:00,2020-12-07 00:00:00,LABORABLE
12,7,2020,8,142,212,354,2020-07-12 07:00:00,2020-12-07 00:00:00,LABORABLE
12,7,2020,9,172,242,414,2020-07-12 08:00:00,2020-12-07 00:00:00,LABORABLE
12,7,2020,10,265,398,663,2020-07-12 09:00:00,2020-12-07 00:00:00,LABORABLE
12,7,2020,11,403,468,871,2020-07-12 10:00:00,2020-12-07 00:00:00,LABORABLE
12,7,2020,12,436,570,1006,2020-07-12 11:00:00,2020-12-07 00:00:00,LABORABLE
12,7,2020,13,488,568,1056,2020-07-12 12:00:00,2020-12-07 00:00:00,LABORABLE
12,7,2020,14,481,669,1150,2020-07-12 13:00:00,2020-12-07 00:00:00,LABORABLE
12,7,2020,15,433,608,1041,2020-07-12 14:00:00,2020-12-07 00:00:00,LABORABLE
12,7,2020,16,369,531,900,2020-07-12 15:00:00,2020-12-07 00:00:00,LABORABLE
12,7,2020,17,359,514,873,2020-07-12 16:00:00,2020-12-07 00:00:00,LABORABLE
12,7,2020,18,427,566,993,2020-07-12 17:00:00,2020-12-07 00:00:00,LABORABLE
12,7,2020,19,434,566,1000,2020-07-12 18:00:00,2020-12-07 00:00:00,LABORABLE
12,7,2020,20,468,628,1096,2020-07-12 19:00:00,2020-12-07 00:00:00,LABORABLE
12,7,2020,21,408,656,1064,2020-07-12 20:00:00,2020-12-07 00:00:00,LABORABLE
12,7,2020,22,451,551,1002,2020-07-12 21:00:00,2020-12-07 00:00:00,LABORABLE
12,7,2020,23,355,507,862,2020-07-12 22:00:00,2020-12-07 00:00:00,LABORABLE
12,7,2020,24,290,396,686,2020-07-12 23:00:00,2020-12-07 00:00:00,LABORABLE
13,7,2020,1,0,313,313,2020-07-13 00:00:00,2020-07-13 00:00:00,LABORABLE
13,7,2020,2,0,181,181,2020-07-13 01:00:00,2020-07-13 00:00:00,LABORABLE
13,7,2020,3,0,147,147,2020-07-13 02:00:00,2020-07-13 00:00:00,LABORABLE
13,7,2020,4,0,93,93,2020-07-13 03:00:00,2020-07-13 00:00:00,LABORABLE
13,7,2020,5,0,102,102,2020-07-13 04:00:00,2020-07-13 00:00:00,LABORABLE
13,7,2020,6,0,127,127,2020-07-13 05:00:00,2020-07-13 00:00:00,LABORABLE
13,7,2020,7,0,355,355,2020-07-13 06:00:00,2020-07-13 00:00:00,LABORABLE
13,7,2020,8,0,596,596,2020-07-13 07:00:00,2020-07-13 00:00:00,LABORABLE
13,7,2020,9,476,613,1089,2020-07-13 08:00:00,2020-07-13 00:00:00,LABORABLE
13,7,2020,10,558,719,1277,2020-07-13 09:00:00,2020-07-13 00:00:00,LABORABLE
13,7,2020,11,498,682,1180,2020-07-13 10:00:00,2020-07-13 00:00:00,LABORABLE
13,7,2020,12,564,746,1310,2020-07-13 11:00:00,2020-07-13 00:00:00,LABORABLE
13,7,2020,13,521,792,1313,2020-07-13 12:00:00,2020-07-13 00:00:00,LABORABLE
13,7,2020,14,612,750,1362,2020-07-13 13:00:00,2020-07-13 00:00:00,LABORABLE
13,7,2020,15,587,731,1318,2020-07-13 14:00:00,2020-07-13 00:00:00,LABORABLE
13,7,2020,16,514,588,1102,2020-07-13 15:00:00,2020-07-13 00:00:00,LABORABLE
13,7,2020,17,520,660,1180,2020-07-13 16:00:00,2020-07-13 00:00:00,LABORABLE
13,7,2020,18,569,723,1292,2020-07-13 17:00:00,2020-07-13 00:00:00,LABORABLE
13,7,2020,19,648,759,1407,2020-07-13 18:00:00,2020-07-13 00:00:00,LABORABLE
13,7,2020,20,617,813,1430,2020-07-13 19:00:00,2020-07-13 00:00:00,LABORABLE
13,7,2020,21,557,768,1325,2020-07-13 20:00:00,2020-07-13 00:00:00,LABORABLE
13,7,2020,22,464,619,1083,2020-07-13 21:00:00,2020-07-13 00:00:00,LABORABLE
13,7,2020,23,391,460,851,2020-07-13 22:00:00,2020-07-13 00:00:00,LABORABLE
13,7,2020,24,217,341,558,2020-07-13 23:00:00,2020-07-13 00:00:00,LABORABLE
14,7,2020,1,157,214,371,2020-07-14 00:00:00,2020-07-14 00:00:00,LABORABLE
14,7,2020,2,121,165,286,2020-07-14 01:00:00,2020-07-14 00:00:00,LABORABLE
14,7,2020,3,105,132,237,2020-07-14 02:00:00,2020-07-14 00:00:00,LABORABLE
14,7,2020,4,61,94,155,2020-07-14 03:00:00,2020-07-14 00:00:00,LABORABLE
14,7,2020,5,84,122,206,2020-07-14 04:00:00,2020-07-14 00:00:00,LABORABLE
14,7,2020,6,146,153,299,2020-07-14 05:00:00,2020-07-14 00:00:00,LABORABLE
14,7,2020,7,362,340,702,2020-07-14 06:00:00,2020-07-14 00:00:00,LABORABLE
14,7,2020,8,647,547,1194,2020-07-14 07:00:00,2020-07-14 00:00:00,LABORABLE
14,7,2020,9,568,655,1223,2020-07-14 08:00:00,2020-07-14 00:00:00,LABORABLE
14,7,2020,10,586,704,1290,2020-07-14 09:00:00,2020-07-14 00:00:00,LABORABLE
14,7,2020,11,403,524,927,2020-07-14 10:00:00,2020-07-14 00:00:00,LABORABLE
14,7,2020,12,556,751,1307,2020-07-14 11:00:00,2020-07-14 00:00:00,LABORABLE
14,7,2020,13,616,764,1380,2020-07-14 12:00:00,2020-07-14 00:00:00,LABORABLE
14,7,2020,14,575,791,1366,2020-07-14 13:00:00,2020-07-14 00:00:00,LABORABLE
14,7,2020,15,623,740,1363,2020-07-14 14:00:00,2020-07-14 00:00:00,LABORABLE
14,7,2020,16,530,647,1177,2020-07-14 15:00:00,2020-07-14 00:00:00,LABORABLE
14,7,2020,17,503,730,1233,2020-07-14 16:00:00,2020-07-14 00:00:00,LABORABLE
14,7,2020,18,522,763,1285,2020-07-14 17:00:00,2020-07-14 00:00:00,LABORABLE
14,7,2020,19,613,786,1399,2020-07-14 18:00:00,2020-07-14 00:00:00,LABORABLE
14,7,2020,20,624,792,1416,2020-07-14 19:00:00,2020-07-14 00:00:00,LABORABLE
14,7,2020,21,553,802,1355,2020-07-14 20:00:00,2020-07-14 00:00:00,LABORABLE
14,7,2020,22,518,613,1131,2020-07-14 21:00:00,2020-07-14 00:00:00,LABORABLE
14,7,2020,23,380,495,875,2020-07-14 22:00:00,2020-07-14 00:00:00,LABORABLE
14,7,2020,24,277,366,643,2020-07-14 23:00:00,2020-07-14 00:00:00,LABORABLE
15,7,2020,1,215,288,503,2020-07-15 00:00:00,2020-07-15 00:00:00,LABORABLE
15,7,2020,2,118,190,308,2020-07-15 01:00:00,2020-07-15 00:00:00,LABORABLE
15,7,2020,3,89,137,226,2020-07-15 02:00:00,2020-07-15 00:00:00,LABORABLE
15,7,2020,4,69,93,162,2020-07-15 03:00:00,2020-07-15 00:00:00,LABORABLE
15,7,2020,5,75,92,167,2020-07-15 04:00:00,2020-07-15 00:00:00,LABORABLE
15,7,2020,6,142,142,284,2020-07-15 05:00:00,2020-07-15 00:00:00,LABORABLE
15,7,2020,7,386,317,703,2020-07-15 06:00:00,2020-07-15 00:00:00,LABORABLE
15,7,2020,8,604,550,1154,2020-07-15 07:00:00,2020-07-15 00:00:00,LABORABLE
15,7,2020,9,549,647,1196,2020-07-15 08:00:00,2020-07-15 00:00:00,LABORABLE
15,7,2020,10,549,695,1244,2020-07-15 09:00:00,2020-07-15 00:00:00,LABORABLE
15,7,2020,11,517,670,1187,2020-07-15 10:00:00,2020-07-15 00:00:00,LABORABLE
15,7,2020,12,554,733,1287,2020-07-15 11:00:00,2020-07-15 00:00:00,LABORABLE
15,7,2020,13,497,652,1149,2020-07-15 12:00:00,2020-07-15 00:00:00,LABORABLE
15,7,2020,14,574,813,1387,2020-07-15 13:00:00,2020-07-15 00:00:00,LABORABLE
15,7,2020,15,603,741,1344,2020-07-15 14:00:00,2020-07-15 00:00:00,LABORABLE
15,7,2020,16,506,610,1116,2020-07-15 15:00:00,2020-07-15 00:00:00,LABORABLE
15,7,2020,17,532,722,1254,2020-07-15 16:00:00,2020-07-15 00:00:00,LABORABLE
15,7,2020,18,577,755,1332,2020-07-15 17:00:00,2020-07-15 00:00:00,LABORABLE
15,7,2020,19,624,834,1458,2020-07-15 18:00:00,2020-07-15 00:00:00,LABORABLE
15,7,2020,20,629,786,1415,2020-07-15 19:00:00,2020-07-15 00:00:00,LABORABLE
15,7,2020,21,535,815,1350,2020-07-15 20:00:00,2020-07-15 00:00:00,LABORABLE
15,7,2020,22,529,630,1159,2020-07-15 21:00:00,2020-07-15 00:00:00,LABORABLE
15,7,2020,23,408,541,949,2020-07-15 22:00:00,2020-07-15 00:00:00,LABORABLE
15,7,2020,24,269,388,657,2020-07-15 23:00:00,2020-07-15 00:00:00,LABORABLE
16,7,2020,1,219,294,513,2020-07-16 00:00:00,2020-07-16 00:00:00,LABORABLE
16,7,2020,2,131,202,333,2020-07-16 01:00:00,2020-07-16 00:00:00,LABORABLE
16,7,2020,3,83,156,239,2020-07-16 02:00:00,2020-07-16 00:00:00,LABORABLE
16,7,2020,4,75,105,180,2020-07-16 03:00:00,2020-07-16 00:00:00,LABORABLE
16,7,2020,5,82,107,189,2020-07-16 04:00:00,2020-07-16 00:00:00,LABORABLE
16,7,2020,6,155,147,302,2020-07-16 05:00:00,2020-07-16 00:00:00,LABORABLE
16,7,2020,7,385,321,706,2020-07-16 06:00:00,2020-07-16 00:00:00,LABORABLE
16,7,2020,8,611,551,1162,2020-07-16 07:00:00,2020-07-16 00:00:00,LABORABLE
16,7,2020,9,561,615,1176,2020-07-16 08:00:00,2020-07-16 00:00:00,LABORABLE
16,7,2020,10,584,676,1260,2020-07-16 09:00:00,2020-07-16 00:00:00,LABORABLE
16,7,2020,11,524,717,1241,2020-07-16 10:00:00,2020-07-16 00:00:00,LABORABLE
16,7,2020,12,544,785,1329,2020-07-16 11:00:00,2020-07-16 00:00:00,LABORABLE
16,7,2020,13,578,764,1342,2020-07-16 12:00:00,2020-07-16 00:00:00,LABORABLE
16,7,2020,14,591,822,1413,2020-07-16 13:00:00,2020-07-16 00:00:00,LABORABLE
16,7,2020,15,625,717,1342,2020-07-16 14:00:00,2020-07-16 00:00:00,LABORABLE
16,7,2020,16,539,737,1276,2020-07-16 15:00:00,2020-07-16 00:00:00,LABORABLE
16,7,2020,17,531,689,1220,2020-07-16 16:00:00,2020-07-16 00:00:00,LABORABLE
16,7,2020,18,589,709,1298,2020-07-16 17:00:00,2020-07-16 00:00:00,LABORABLE
16,7,2020,19,630,756,1386,2020-07-16 18:00:00,2020-07-16 00:00:00,LABORABLE
16,7,2020,20,575,787,1362,2020-07-16 19:00:00,2020-07-16 00:00:00,LABORABLE
16,7,2020,21,552,714,1266,2020-07-16 20:00:00,2020-07-16 00:00:00,LABORABLE
16,7,2020,22,516,605,1121,2020-07-16 21:00:00,2020-07-16 00:00:00,LABORABLE
16,7,2020,23,364,514,878,2020-07-16 22:00:00,2020-07-16 00:00:00,LABORABLE
16,7,2020,24,283,378,661,2020-07-16 23:00:00,2020-07-16 00:00:00,LABORABLE
17,7,2020,1,211,355,566,2020-07-17 00:00:00,2020-07-17 00:00:00,LABORABLE
17,7,2020,2,168,214,382,2020-07-17 01:00:00,2020-07-17 00:00:00,LABORABLE
17,7,2020,3,112,184,296,2020-07-17 02:00:00,2020-07-17 00:00:00,LABORABLE
17,7,2020,4,92,152,244,2020-07-17 03:00:00,2020-07-17 00:00:00,LABORABLE
17,7,2020,5,91,122,213,2020-07-17 04:00:00,2020-07-17 00:00:00,LABORABLE
17,7,2020,6,163,147,310,2020-07-17 05:00:00,2020-07-17 00:00:00,LABORABLE
17,7,2020,7,398,350,748,2020-07-17 06:00:00,2020-07-17 00:00:00,LABORABLE
17,7,2020,8,559,557,1116,2020-07-17 07:00:00,2020-07-17 00:00:00,LABORABLE
17,7,2020,9,532,601,1133,2020-07-17 08:00:00,2020-07-17 00:00:00,LABORABLE
17,7,2020,10,582,656,1238,2020-07-17 09:00:00,2020-07-17 00:00:00,LABORABLE
17,7,2020,11,607,683,1290,2020-07-17 10:00:00,2020-07-17 00:00:00,LABORABLE
17,7,2020,12,539,722,1261,2020-07-17 11:00:00,2020-07-17 00:00:00,LABORABLE
17,7,2020,13,566,797,1363,2020-07-17 12:00:00,2020-07-17 00:00:00,LABORABLE
17,7,2020,14,623,730,1353,2020-07-17 13:00:00,2020-07-17 00:00:00,LABORABLE
17,7,2020,15,601,798,1399,2020-07-17 14:00:00,2020-07-17 00:00:00,LABORABLE
17,7,2020,16,530,697,1227,2020-07-17 15:00:00,2020-07-17 00:00:00,LABORABLE
17,7,2020,17,550,661,1211,2020-07-17 16:00:00,2020-07-17 00:00:00,LABORABLE
17,7,2020,18,529,701,1230,2020-07-17 17:00:00,2020-07-17 00:00:00,LABORABLE
17,7,2020,19,623,815,1438,2020-07-17 18:00:00,2020-07-17 00:00:00,LABORABLE
17,7,2020,20,665,811,1476,2020-07-17 19:00:00,2020-07-17 00:00:00,LABORABLE
17,7,2020,21,612,854,1466,2020-07-17 20:00:00,2020-07-17 00:00:00,LABORABLE
17,7,2020,22,572,770,1342,2020-07-17 21:00:00,2020-07-17 00:00:00,LABORABLE
17,7,2020,23,460,625,1085,2020-07-17 22:00:00,2020-07-17 00:00:00,LABORABLE
17,7,2020,24,347,496,843,2020-07-17 23:00:00,2020-07-17 00:00:00,LABORABLE
18,7,2020,1,309,400,709,2020-07-18 00:00:00,2020-07-18 00:00:00,LABORABLE
18,7,2020,2,238,342,580,2020-07-18 01:00:00,2020-07-18 00:00:00,LABORABLE
18,7,2020,3,186,259,445,2020-07-18 02:00:00,2020-07-18 00:00:00,LABORABLE
18,7,2020,4,144,186,330,2020-07-18 03:00:00,2020-07-18 00:00:00,LABORABLE
18,7,2020,5,112,173,285,2020-07-18 04:00:00,2020-07-18 00:00:00,LABORABLE
18,7,2020,6,106,179,285,2020-07-18 05:00:00,2020-07-18 00:00:00,LABORABLE
18,7,2020,7,201,206,407,2020-07-18 06:00:00,2020-07-18 00:00:00,LABORABLE
18,7,2020,8,286,304,590,2020-07-18 07:00:00,2020-07-18 00:00:00,LABORABLE
18,7,2020,9,294,378,672,2020-07-18 08:00:00,2020-07-18 00:00:00,LABORABLE
18,7,2020,10,408,489,897,2020-07-18 09:00:00,2020-07-18 00:00:00,LABORABLE
18,7,2020,11,476,507,983,2020-07-18 10:00:00,2020-07-18 00:00:00,LABORABLE
18,7,2020,12,528,705,1233,2020-07-18 11:00:00,2020-07-18 00:00:00,LABORABLE
18,7,2020,13,578,686,1264,2020-07-18 12:00:00,2020-07-18 00:00:00,LABORABLE
18,7,2020,14,534,733,1267,2020-07-18 13:00:00,2020-07-18 00:00:00,LABORABLE
18,7,2020,15,546,773,1319,2020-07-18 14:00:00,2020-07-18 00:00:00,LABORABLE
18,7,2020,16,404,623,1027,2020-07-18 15:00:00,2020-07-18 00:00:00,LABORABLE
18,7,2020,17,370,630,1000,2020-07-18 16:00:00,2020-07-18 00:00:00,LABORABLE
18,7,2020,18,440,603,1043,2020-07-18 17:00:00,2020-07-18 00:00:00,LABORABLE
18,7,2020,19,468,615,1083,2020-07-18 18:00:00,2020-07-18 00:00:00,LABORABLE
18,7,2020,20,499,719,1218,2020-07-18 19:00:00,2020-07-18 00:00:00,LABORABLE
18,7,2020,21,479,702,1181,2020-07-18 20:00:00,2020-07-18 00:00:00,LABORABLE
18,7,2020,22,439,675,1114,2020-07-18 21:00:00,2020-07-18 00:00:00,LABORABLE
18,7,2020,23,441,557,998,2020-07-18 22:00:00,2020-07-18 00:00:00,LABORABLE
18,7,2020,24,335,504,839,2020-07-18 23:00:00,2020-07-18 00:00:00,LABORABLE
19,7,2020,1,349,477,826,2020-07-19 00:00:00,2020-07-19 00:00:00,LABORABLE
19,7,2020,2,270,390,660,2020-07-19 01:00:00,2020-07-19 00:00:00,LABORABLE
19,7,2020,3,222,322,544,2020-07-19 02:00:00,2020-07-19 00:00:00,LABORABLE
19,7,2020,4,164,288,452,2020-07-19 03:00:00,2020-07-19 00:00:00,LABORABLE
19,7,2020,5,115,212,327,2020-07-19 04:00:00,2020-07-19 00:00:00,LABORABLE
19,7,2020,6,115,194,309,2020-07-19 05:00:00,2020-07-19 00:00:00,LABORABLE
19,7,2020,7,160,223,383,2020-07-19 06:00:00,2020-07-19 00:00:00,LABORABLE
19,7,2020,8,158,223,381,2020-07-19 07:00:00,2020-07-19 00:00:00,LABORABLE
19,7,2020,9,190,253,443,2020-07-19 08:00:00,2020-07-19 00:00:00,LABORABLE
19,7,2020,10,301,376,677,2020-07-19 09:00:00,2020-07-19 00:00:00,LABORABLE
19,7,2020,11,393,464,857,2020-07-19 10:00:00,2020-07-19 00:00:00,LABORABLE
19,7,2020,12,434,551,985,2020-07-19 11:00:00,2020-07-19 00:00:00,LABORABLE
19,7,2020,13,413,580,993,2020-07-19 12:00:00,2020-07-19 00:00:00,LABORABLE
19,7,2020,14,466,663,1129,2020-07-19 13:00:00,2020-07-19 00:00:00,LABORABLE
19,7,2020,15,424,617,1041,2020-07-19 14:00:00,2020-07-19 00:00:00,LABORABLE
19,7,2020,16,319,549,868,2020-07-19 15:00:00,2020-07-19 00:00:00,LABORABLE
19,7,2020,17,334,493,827,2020-07-19 16:00:00,2020-07-19 00:00:00,LABORABLE
19,7,2020,18,374,509,883,2020-07-19 17:00:00,2020-07-19 00:00:00,LABORABLE
19,7,2020,19,360,575,935,2020-07-19 18:00:00,2020-07-19 00:00:00,LABORABLE
19,7,2020,20,445,591,1036,2020-07-19 19:00:00,2020-07-19 00:00:00,LABORABLE
19,7,2020,21,392,604,996,2020-07-19 20:00:00,2020-07-19 00:00:00,LABORABLE
19,7,2020,22,403,530,933,2020-07-19 21:00:00,2020-07-19 00:00:00,LABORABLE
19,7,2020,23,398,500,898,2020-07-19 22:00:00,2020-07-19 00:00:00,LABORABLE
19,7,2020,24,320,423,743,2020-07-19 23:00:00,2020-07-19 00:00:00,LABORABLE
20,7,2020,1,202,297,499,2020-07-20 00:00:00,2020-07-20 00:00:00,LABORABLE
20,7,2020,2,148,198,346,2020-07-20 01:00:00,2020-07-20 00:00:00,LABORABLE
20,7,2020,3,97,172,269,2020-07-20 02:00:00,2020-07-20 00:00:00,LABORABLE
20,7,2020,4,83,118,201,2020-07-20 03:00:00,2020-07-20 00:00:00,LABORABLE
20,7,2020,5,73,90,163,2020-07-20 04:00:00,2020-07-20 00:00:00,LABORABLE
20,7,2020,6,157,159,316,2020-07-20 05:00:00,2020-07-20 00:00:00,LABORABLE
20,7,2020,7,370,362,732,2020-07-20 06:00:00,2020-07-20 00:00:00,LABORABLE
20,7,2020,8,618,526,1144,2020-07-20 07:00:00,2020-07-20 00:00:00,LABORABLE
20,7,2020,9,582,588,1170,2020-07-20 08:00:00,2020-07-20 00:00:00,LABORABLE
20,7,2020,10,580,678,1258,2020-07-20 09:00:00,2020-07-20 00:00:00,LABORABLE
20,7,2020,11,508,668,1176,2020-07-20 10:00:00,2020-07-20 00:00:00,LABORABLE
20,7,2020,12,546,726,1272,2020-07-20 11:00:00,2020-07-20 00:00:00,LABORABLE
20,7,2020,13,535,736,1271,2020-07-20 12:00:00,2020-07-20 00:00:00,LABORABLE
20,7,2020,14,546,747,1293,2020-07-20 13:00:00,2020-07-20 00:00:00,LABORABLE
20,7,2020,15,548,672,1220,2020-07-20 14:00:00,2020-07-20 00:00:00,LABORABLE
20,7,2020,16,535,661,1196,2020-07-20 15:00:00,2020-07-20 00:00:00,LABORABLE
20,7,2020,17,549,690,1239,2020-07-20 16:00:00,2020-07-20 00:00:00,LABORABLE
20,7,2020,18,569,707,1276,2020-07-20 17:00:00,2020-07-20 00:00:00,LABORABLE
20,7,2020,19,617,777,1394,2020-07-20 18:00:00,2020-07-20 00:00:00,LABORABLE
20,7,2020,20,622,823,1445,2020-07-20 19:00:00,2020-07-20 00:00:00,LABORABLE
20,7,2020,21,531,803,1334,2020-07-20 20:00:00,2020-07-20 00:00:00,LABORABLE
20,7,2020,22,432,574,1006,2020-07-20 21:00:00,2020-07-20 00:00:00,LABORABLE
20,7,2020,23,336,504,840,2020-07-20 22:00:00,2020-07-20 00:00:00,LABORABLE
20,7,2020,24,229,346,575,2020-07-20 23:00:00,2020-07-20 00:00:00,LABORABLE
21,7,2020,1,167,248,415,2020-07-21 00:00:00,2020-07-21 00:00:00,LABORABLE
21,7,2020,2,106,185,291,2020-07-21 01:00:00,2020-07-21 00:00:00,LABORABLE
21,7,2020,3,81,169,250,2020-07-21 02:00:00,2020-07-21 00:00:00,LABORABLE
21,7,2020,4,65,98,163,2020-07-21 03:00:00,2020-07-21 00:00:00,LABORABLE
21,7,2020,5,71,83,154,2020-07-21 04:00:00,2020-07-21 00:00:00,LABORABLE
21,7,2020,6,151,164,315,2020-07-21 05:00:00,2020-07-21 00:00:00,LABORABLE
21,7,2020,7,405,344,749,2020-07-21 06:00:00,2020-07-21 00:00:00,LABORABLE
21,7,2020,8,557,543,1100,2020-07-21 07:00:00,2020-07-21 00:00:00,LABORABLE
21,7,2020,9,552,589,1141,2020-07-21 08:00:00,2020-07-21 00:00:00,LABORABLE
21,7,2020,10,595,670,1265,2020-07-21 09:00:00,2020-07-21 00:00:00,LABORABLE
21,7,2020,11,529,642,1171,2020-07-21 10:00:00,2020-07-21 00:00:00,LABORABLE
21,7,2020,12,595,733,1328,2020-07-21 11:00:00,2020-07-21 00:00:00,LABORABLE
21,7,2020,13,589,754,1343,2020-07-21 12:00:00,2020-07-21 00:00:00,LABORABLE
21,7,2020,14,441,556,997,2020-07-21 13:00:00,2020-07-21 00:00:00,LABORABLE
21,7,2020,15,484,560,1044,2020-07-21 14:00:00,2020-07-21 00:00:00,LABORABLE
21,7,2020,16,571,655,1226,2020-07-21 15:00:00,2020-07-21 00:00:00,LABORABLE
21,7,2020,17,508,705,1213,2020-07-21 16:00:00,2020-07-21 00:00:00,LABORABLE
21,7,2020,18,585,702,1287,2020-07-21 17:00:00,2020-07-21 00:00:00,LABORABLE
21,7,2020,19,626,787,1413,2020-07-21 18:00:00,2020-07-21 00:00:00,LABORABLE
21,7,2020,20,611,789,1400,2020-07-21 19:00:00,2020-07-21 00:00:00,LABORABLE
21,7,2020,21,560,781,1341,2020-07-21 20:00:00,2020-07-21 00:00:00,LABORABLE
21,7,2020,22,430,634,1064,2020-07-21 21:00:00,2020-07-21 00:00:00,LABORABLE
21,7,2020,23,359,429,788,2020-07-21 22:00:00,2020-07-21 00:00:00,LABORABLE
21,7,2020,24,260,375,635,2020-07-21 23:00:00,2020-07-21 00:00:00,LABORABLE
22,7,2020,1,186,257,443,2020-07-22 00:00:00,2020-07-22 00:00:00,LABORABLE
22,7,2020,2,121,181,302,2020-07-22 01:00:00,2020-07-22 00:00:00,LABORABLE
22,7,2020,3,99,147,246,2020-07-22 02:00:00,2020-07-22 00:00:00,LABORABLE
22,7,2020,4,69,119,188,2020-07-22 03:00:00,2020-07-22 00:00:00,LABORABLE
22,7,2020,5,86,78,164,2020-07-22 04:00:00,2020-07-22 00:00:00,LABORABLE
22,7,2020,6,166,147,313,2020-07-22 05:00:00,2020-07-22 00:00:00,LABORABLE
22,7,2020,7,399,355,754,2020-07-22 06:00:00,2020-07-22 00:00:00,LABORABLE
22,7,2020,8,581,533,1114,2020-07-22 07:00:00,2020-07-22 00:00:00,LABORABLE
22,7,2020,9,547,624,1171,2020-07-22 08:00:00,2020-07-22 00:00:00,LABORABLE
22,7,2020,10,574,661,1235,2020-07-22 09:00:00,2020-07-22 00:00:00,LABORABLE
22,7,2020,11,531,706,1237,2020-07-22 10:00:00,2020-07-22 00:00:00,LABORABLE
22,7,2020,12,560,693,1253,2020-07-22 11:00:00,2020-07-22 00:00:00,LABORABLE
22,7,2020,13,551,817,1368,2020-07-22 12:00:00,2020-07-22 00:00:00,LABORABLE
22,7,2020,14,592,744,1336,2020-07-22 13:00:00,2020-07-22 00:00:00,LABORABLE
22,7,2020,15,523,646,1169,2020-07-22 14:00:00,2020-07-22 00:00:00,LABORABLE
22,7,2020,16,550,636,1186,2020-07-22 15:00:00,2020-07-22 00:00:00,LABORABLE
22,7,2020,17,521,666,1187,2020-07-22 16:00:00,2020-07-22 00:00:00,LABORABLE
22,7,2020,18,413,574,987,2020-07-22 17:00:00,2020-07-22 00:00:00,LABORABLE
22,7,2020,19,637,773,1410,2020-07-22 18:00:00,2020-07-22 00:00:00,LABORABLE
22,7,2020,20,607,771,1378,2020-07-22 19:00:00,2020-07-22 00:00:00,LABORABLE
22,7,2020,21,557,770,1327,2020-07-22 20:00:00,2020-07-22 00:00:00,LABORABLE
22,7,2020,22,522,621,1143,2020-07-22 21:00:00,2020-07-22 00:00:00,LABORABLE
22,7,2020,23,390,483,873,2020-07-22 22:00:00,2020-07-22 00:00:00,LABORABLE
22,7,2020,24,246,372,618,2020-07-22 23:00:00,2020-07-22 00:00:00,LABORABLE
23,7,2020,1,198,280,478,2020-07-23 00:00:00,2020-07-23 00:00:00,LABORABLE
23,7,2020,2,136,178,314,2020-07-23 01:00:00,2020-07-23 00:00:00,LABORABLE
23,7,2020,3,93,132,225,2020-07-23 02:00:00,2020-07-23 00:00:00,LABORABLE
23,7,2020,4,63,88,151,2020-07-23 03:00:00,2020-07-23 00:00:00,LABORABLE
23,7,2020,5,85,102,187,2020-07-23 04:00:00,2020-07-23 00:00:00,LABORABLE
23,7,2020,6,171,161,332,2020-07-23 05:00:00,2020-07-23 00:00:00,LABORABLE
23,7,2020,7,383,359,742,2020-07-23 06:00:00,2020-07-23 00:00:00,LABORABLE
23,7,2020,8,597,502,1099,2020-07-23 07:00:00,2020-07-23 00:00:00,LABORABLE
23,7,2020,9,583,654,1237,2020-07-23 08:00:00,2020-07-23 00:00:00,LABORABLE
23,7,2020,10,571,682,1253,2020-07-23 09:00:00,2020-07-23 00:00:00,LABORABLE
23,7,2020,11,554,648,1202,2020-07-23 10:00:00,2020-07-23 00:00:00,LABORABLE
23,7,2020,12,601,681,1282,2020-07-23 11:00:00,2020-07-23 00:00:00,LABORABLE
23,7,2020,13,605,793,1398,2020-07-23 12:00:00,2020-07-23 00:00:00,LABORABLE
23,7,2020,14,602,765,1367,2020-07-23 13:00:00,2020-07-23 00:00:00,LABORABLE
23,7,2020,15,616,729,1345,2020-07-23 14:00:00,2020-07-23 00:00:00,LABORABLE
23,7,2020,16,577,670,1247,2020-07-23 15:00:00,2020-07-23 00:00:00,LABORABLE
23,7,2020,17,577,708,1285,2020-07-23 16:00:00,2020-07-23 00:00:00,LABORABLE
23,7,2020,18,592,729,1321,2020-07-23 17:00:00,2020-07-23 00:00:00,LABORABLE
23,7,2020,19,658,806,1464,2020-07-23 18:00:00,2020-07-23 00:00:00,LABORABLE
23,7,2020,20,636,786,1422,2020-07-23 19:00:00,2020-07-23 00:00:00,LABORABLE
23,7,2020,21,621,818,1439,2020-07-23 20:00:00,2020-07-23 00:00:00,LABORABLE
23,7,2020,22,521,601,1122,2020-07-23 21:00:00,2020-07-23 00:00:00,LABORABLE
23,7,2020,23,416,571,987,2020-07-23 22:00:00,2020-07-23 00:00:00,LABORABLE
23,7,2020,24,290,365,655,2020-07-23 23:00:00,2020-07-23 00:00:00,LABORABLE
24,7,2020,1,219,311,530,2020-07-24 00:00:00,2020-07-24 00:00:00,LABORABLE
24,7,2020,2,179,238,417,2020-07-24 01:00:00,2020-07-24 00:00:00,LABORABLE
24,7,2020,3,106,184,290,2020-07-24 02:00:00,2020-07-24 00:00:00,LABORABLE
24,7,2020,4,92,125,217,2020-07-24 03:00:00,2020-07-24 00:00:00,LABORABLE
24,7,2020,5,94,115,209,2020-07-24 04:00:00,2020-07-24 00:00:00,LABORABLE
24,7,2020,6,163,156,319,2020-07-24 05:00:00,2020-07-24 00:00:00,LABORABLE
24,7,2020,7,383,344,727,2020-07-24 06:00:00,2020-07-24 00:00:00,LABORABLE
24,7,2020,8,605,569,1174,2020-07-24 07:00:00,2020-07-24 00:00:00,LABORABLE
24,7,2020,9,595,593,1188,2020-07-24 08:00:00,2020-07-24 00:00:00,LABORABLE
24,7,2020,10,575,719,1294,2020-07-24 09:00:00,2020-07-24 00:00:00,LABORABLE
24,7,2020,11,575,674,1249,2020-07-24 10:00:00,2020-07-24 00:00:00,LABORABLE
24,7,2020,12,599,690,1289,2020-07-24 11:00:00,2020-07-24 00:00:00,LABORABLE
24,7,2020,13,618,718,1336,2020-07-24 12:00:00,2020-07-24 00:00:00,LABORABLE
24,7,2020,14,659,827,1486,2020-07-24 13:00:00,2020-07-24 00:00:00,LABORABLE
24,7,2020,15,657,782,1439,2020-07-24 14:00:00,2020-07-24 00:00:00,LABORABLE
24,7,2020,16,589,657,1246,2020-07-24 15:00:00,2020-07-24 00:00:00,LABORABLE
24,7,2020,17,568,663,1231,2020-07-24 16:00:00,2020-07-24 00:00:00,LABORABLE
24,7,2020,18,618,784,1402,2020-07-24 17:00:00,2020-07-24 00:00:00,LABORABLE
24,7,2020,19,628,825,1453,2020-07-24 18:00:00,2020-07-24 00:00:00,LABORABLE
24,7,2020,20,609,798,1407,2020-07-24 19:00:00,2020-07-24 00:00:00,LABORABLE
24,7,2020,21,606,857,1463,2020-07-24 20:00:00,2020-07-24 00:00:00,LABORABLE
24,7,2020,22,549,715,1264,2020-07-24 21:00:00,2020-07-24 00:00:00,LABORABLE
24,7,2020,23,447,564,1011,2020-07-24 22:00:00,2020-07-24 00:00:00,LABORABLE
24,7,2020,24,369,504,873,2020-07-24 23:00:00,2020-07-24 00:00:00,LABORABLE
25,7,2020,1,290,411,701,2020-07-25 00:00:00,2020-07-25 00:00:00,LABORABLE
25,7,2020,2,260,310,570,2020-07-25 01:00:00,2020-07-25 00:00:00,LABORABLE
25,7,2020,3,209,270,479,2020-07-25 02:00:00,2020-07-25 00:00:00,LABORABLE
25,7,2020,4,152,227,379,2020-07-25 03:00:00,2020-07-25 00:00:00,LABORABLE
25,7,2020,5,132,190,322,2020-07-25 04:00:00,2020-07-25 00:00:00,LABORABLE
25,7,2020,6,130,178,308,2020-07-25 05:00:00,2020-07-25 00:00:00,LABORABLE
25,7,2020,7,183,213,396,2020-07-25 06:00:00,2020-07-25 00:00:00,LABORABLE
25,7,2020,8,273,284,557,2020-07-25 07:00:00,2020-07-25 00:00:00,LABORABLE
25,7,2020,9,327,380,707,2020-07-25 08:00:00,2020-07-25 00:00:00,LABORABLE
25,7,2020,10,439,515,954,2020-07-25 09:00:00,2020-07-25 00:00:00,LABORABLE
25,7,2020,11,476,548,1024,2020-07-25 10:00:00,2020-07-25 00:00:00,LABORABLE
25,7,2020,12,542,717,1259,2020-07-25 11:00:00,2020-07-25 00:00:00,LABORABLE
25,7,2020,13,544,695,1239,2020-07-25 12:00:00,2020-07-25 00:00:00,LABORABLE
25,7,2020,14,555,739,1294,2020-07-25 13:00:00,2020-07-25 00:00:00,LABORABLE
25,7,2020,15,508,702,1210,2020-07-25 14:00:00,2020-07-25 00:00:00,LABORABLE
25,7,2020,16,428,591,1019,2020-07-25 15:00:00,2020-07-25 00:00:00,LABORABLE
25,7,2020,17,381,560,941,2020-07-25 16:00:00,2020-07-25 00:00:00,LABORABLE
25,7,2020,18,431,609,1040,2020-07-25 17:00:00,2020-07-25 00:00:00,LABORABLE
25,7,2020,19,463,618,1081,2020-07-25 18:00:00,2020-07-25 00:00:00,LABORABLE
25,7,2020,20,522,699,1221,2020-07-25 19:00:00,2020-07-25 00:00:00,LABORABLE
25,7,2020,21,477,702,1179,2020-07-25 20:00:00,2020-07-25 00:00:00,LABORABLE
25,7,2020,22,484,602,1086,2020-07-25 21:00:00,2020-07-25 00:00:00,LABORABLE
25,7,2020,23,438,574,1012,2020-07-25 22:00:00,2020-07-25 00:00:00,LABORABLE
25,7,2020,24,290,496,786,2020-07-25 23:00:00,2020-07-25 00:00:00,LABORABLE
26,7,2020,1,336,468,804,2020-07-26 00:00:00,2020-07-26 00:00:00,LABORABLE
26,7,2020,2,303,392,695,2020-07-26 01:00:00,2020-07-26 00:00:00,LABORABLE
26,7,2020,3,232,309,541,2020-07-26 02:00:00,2020-07-26 00:00:00,LABORABLE
26,7,2020,4,174,291,465,2020-07-26 03:00:00,2020-07-26 00:00:00,LABORABLE
26,7,2020,5,125,224,349,2020-07-26 04:00:00,2020-07-26 00:00:00,LABORABLE
26,7,2020,6,120,197,317,2020-07-26 05:00:00,2020-07-26 00:00:00,LABORABLE
26,7,2020,7,150,221,371,2020-07-26 06:00:00,2020-07-26 00:00:00,LABORABLE
26,7,2020,8,170,230,400,2020-07-26 07:00:00,2020-07-26 00:00:00,LABORABLE
26,7,2020,9,195,262,457,2020-07-26 08:00:00,2020-07-26 00:00:00,LABORABLE
26,7,2020,10,333,377,710,2020-07-26 09:00:00,2020-07-26 00:00:00,LABORABLE
26,7,2020,11,388,490,878,2020-07-26 10:00:00,2020-07-26 00:00:00,LABORABLE
26,7,2020,12,446,550,996,2020-07-26 11:00:00,2020-07-26 00:00:00,LABORABLE
26,7,2020,13,464,626,1090,2020-07-26 12:00:00,2020-07-26 00:00:00,LABORABLE
26,7,2020,14,488,629,1117,2020-07-26 13:00:00,2020-07-26 00:00:00,LABORABLE
26,7,2020,15,420,609,1029,2020-07-26 14:00:00,2020-07-26 00:00:00,LABORABLE
26,7,2020,16,344,542,886,2020-07-26 15:00:00,2020-07-26 00:00:00,LABORABLE
26,7,2020,17,315,492,807,2020-07-26 16:00:00,2020-07-26 00:00:00,LABORABLE
26,7,2020,18,346,514,860,2020-07-26 17:00:00,2020-07-26 00:00:00,LABORABLE
26,7,2020,19,406,539,945,2020-07-26 18:00:00,2020-07-26 00:00:00,LABORABLE
26,7,2020,20,444,617,1061,2020-07-26 19:00:00,2020-07-26 00:00:00,LABORABLE
26,7,2020,21,434,550,984,2020-07-26 20:00:00,2020-07-26 00:00:00,LABORABLE
26,7,2020,22,454,581,1035,2020-07-26 21:00:00,2020-07-26 00:00:00,LABORABLE
26,7,2020,23,382,542,924,2020-07-26 22:00:00,2020-07-26 00:00:00,LABORABLE
26,7,2020,24,320,370,690,2020-07-26 23:00:00,2020-07-26 00:00:00,LABORABLE
27,7,2020,1,239,323,562,2020-07-27 00:00:00,2020-07-27 00:00:00,LABORABLE
27,7,2020,2,132,221,353,2020-07-27 01:00:00,2020-07-27 00:00:00,LABORABLE
27,7,2020,3,115,161,276,2020-07-27 02:00:00,2020-07-27 00:00:00,LABORABLE
27,7,2020,4,54,101,155,2020-07-27 03:00:00,2020-07-27 00:00:00,LABORABLE
27,7,2020,5,79,105,184,2020-07-27 04:00:00,2020-07-27 00:00:00,LABORABLE
27,7,2020,6,173,144,317,2020-07-27 05:00:00,2020-07-27 00:00:00,LABORABLE
27,7,2020,7,402,372,774,2020-07-27 06:00:00,2020-07-27 00:00:00,LABORABLE
27,7,2020,8,593,567,1160,2020-07-27 07:00:00,2020-07-27 00:00:00,LABORABLE
27,7,2020,9,587,624,1211,2020-07-27 08:00:00,2020-07-27 00:00:00,LABORABLE
27,7,2020,10,551,697,1248,2020-07-27 09:00:00,2020-07-27 00:00:00,LABORABLE
27,7,2020,11,537,668,1205,2020-07-27 10:00:00,2020-07-27 00:00:00,LABORABLE
27,7,2020,12,454,607,1061,2020-07-27 11:00:00,2020-07-27 00:00:00,LABORABLE
27,7,2020,13,602,768,1370,2020-07-27 12:00:00,2020-07-27 00:00:00,LABORABLE
27,7,2020,14,584,713,1297,2020-07-27 13:00:00,2020-07-27 00:00:00,LABORABLE
27,7,2020,15,571,700,1271,2020-07-27 14:00:00,2020-07-27 00:00:00,LABORABLE
27,7,2020,16,521,667,1188,2020-07-27 15:00:00,2020-07-27 00:00:00,LABORABLE
27,7,2020,17,489,689,1178,2020-07-27 16:00:00,2020-07-27 00:00:00,LABORABLE
27,7,2020,18,517,656,1173,2020-07-27 17:00:00,2020-07-27 00:00:00,LABORABLE
27,7,2020,19,615,750,1365,2020-07-27 18:00:00,2020-07-27 00:00:00,LABORABLE
27,7,2020,20,593,829,1422,2020-07-27 19:00:00,2020-07-27 00:00:00,LABORABLE
27,7,2020,21,562,690,1252,2020-07-27 20:00:00,2020-07-27 00:00:00,LABORABLE
27,7,2020,22,495,668,1163,2020-07-27 21:00:00,2020-07-27 00:00:00,LABORABLE
27,7,2020,23,375,520,895,2020-07-27 22:00:00,2020-07-27 00:00:00,LABORABLE
27,7,2020,24,240,363,603,2020-07-27 23:00:00,2020-07-27 00:00:00,LABORABLE
28,7,2020,1,201,267,468,2020-07-28 00:00:00,2020-07-28 00:00:00,LABORABLE
28,7,2020,2,120,198,318,2020-07-28 01:00:00,2020-07-28 00:00:00,LABORABLE
28,7,2020,3,70,134,204,2020-07-28 02:00:00,2020-07-28 00:00:00,LABORABLE
28,7,2020,4,74,100,174,2020-07-28 03:00:00,2020-07-28 00:00:00,LABORABLE
28,7,2020,5,82,97,179,2020-07-28 04:00:00,2020-07-28 00:00:00,LABORABLE
28,7,2020,6,158,125,283,2020-07-28 05:00:00,2020-07-28 00:00:00,LABORABLE
28,7,2020,7,394,334,728,2020-07-28 06:00:00,2020-07-28 00:00:00,LABORABLE
28,7,2020,8,584,565,1149,2020-07-28 07:00:00,2020-07-28 00:00:00,LABORABLE
28,7,2020,9,544,651,1195,2020-07-28 08:00:00,2020-07-28 00:00:00,LABORABLE
28,7,2020,10,580,671,1251,2020-07-28 09:00:00,2020-07-28 00:00:00,LABORABLE
28,7,2020,11,599,667,1266,2020-07-28 10:00:00,2020-07-28 00:00:00,LABORABLE
28,7,2020,12,549,722,1271,2020-07-28 11:00:00,2020-07-28 00:00:00,LABORABLE
28,7,2020,13,474,670,1144,2020-07-28 12:00:00,2020-07-28 00:00:00,LABORABLE
28,7,2020,14,550,745,1295,2020-07-28 13:00:00,2020-07-28 00:00:00,LABORABLE
28,7,2020,15,576,714,1290,2020-07-28 14:00:00,2020-07-28 00:00:00,LABORABLE
28,7,2020,16,521,634,1155,2020-07-28 15:00:00,2020-07-28 00:00:00,LABORABLE
28,7,2020,17,503,638,1141,2020-07-28 16:00:00,2020-07-28 00:00:00,LABORABLE
28,7,2020,18,542,702,1244,2020-07-28 17:00:00,2020-07-28 00:00:00,LABORABLE
28,7,2020,19,645,781,1426,2020-07-28 18:00:00,2020-07-28 00:00:00,LABORABLE
28,7,2020,20,616,781,1397,2020-07-28 19:00:00,2020-07-28 00:00:00,LABORABLE
28,7,2020,21,519,763,1282,2020-07-28 20:00:00,2020-07-28 00:00:00,LABORABLE
28,7,2020,22,510,639,1149,2020-07-28 21:00:00,2020-07-28 00:00:00,LABORABLE
28,7,2020,23,367,489,856,2020-07-28 22:00:00,2020-07-28 00:00:00,LABORABLE
28,7,2020,24,301,380,681,2020-07-28 23:00:00,2020-07-28 00:00:00,LABORABLE
29,7,2020,1,208,314,522,2020-07-29 00:00:00,2020-07-29 00:00:00,LABORABLE
29,7,2020,2,131,211,342,2020-07-29 01:00:00,2020-07-29 00:00:00,LABORABLE
29,7,2020,3,91,168,259,2020-07-29 02:00:00,2020-07-29 00:00:00,LABORABLE
29,7,2020,4,83,115,198,2020-07-29 03:00:00,2020-07-29 00:00:00,LABORABLE
29,7,2020,5,78,99,177,2020-07-29 04:00:00,2020-07-29 00:00:00,LABORABLE
29,7,2020,6,166,158,324,2020-07-29 05:00:00,2020-07-29 00:00:00,LABORABLE
29,7,2020,7,391,317,708,2020-07-29 06:00:00,2020-07-29 00:00:00,LABORABLE
29,7,2020,8,591,565,1156,2020-07-29 07:00:00,2020-07-29 00:00:00,LABORABLE
29,7,2020,9,559,615,1174,2020-07-29 08:00:00,2020-07-29 00:00:00,LABORABLE
29,7,2020,10,582,712,1294,2020-07-29 09:00:00,2020-07-29 00:00:00,LABORABLE
29,7,2020,11,516,655,1171,2020-07-29 10:00:00,2020-07-29 00:00:00,LABORABLE
29,7,2020,12,542,802,1344,2020-07-29 11:00:00,2020-07-29 00:00:00,LABORABLE
29,7,2020,13,553,731,1284,2020-07-29 12:00:00,2020-07-29 00:00:00,LABORABLE
29,7,2020,14,544,734,1278,2020-07-29 13:00:00,2020-07-29 00:00:00,LABORABLE
29,7,2020,15,570,693,1263,2020-07-29 14:00:00,2020-07-29 00:00:00,LABORABLE
29,7,2020,16,558,604,1162,2020-07-29 15:00:00,2020-07-29 00:00:00,LABORABLE
29,7,2020,17,459,624,1083,2020-07-29 16:00:00,2020-07-29 00:00:00,LABORABLE
29,7,2020,18,551,741,1292,2020-07-29 17:00:00,2020-07-29 00:00:00,LABORABLE
29,7,2020,19,653,781,1434,2020-07-29 18:00:00,2020-07-29 00:00:00,LABORABLE
29,7,2020,20,642,769,1411,2020-07-29 19:00:00,2020-07-29 00:00:00,LABORABLE
29,7,2020,21,567,769,1336,2020-07-29 20:00:00,2020-07-29 00:00:00,LABORABLE
29,7,2020,22,490,621,1111,2020-07-29 21:00:00,2020-07-29 00:00:00,LABORABLE
29,7,2020,23,452,511,963,2020-07-29 22:00:00,2020-07-29 00:00:00,LABORABLE
29,7,2020,24,315,394,709,2020-07-29 23:00:00,2020-07-29 00:00:00,LABORABLE
30,7,2020,1,215,312,527,2020-07-30 00:00:00,2020-07-30 00:00:00,LABORABLE
30,7,2020,2,162,231,393,2020-07-30 01:00:00,2020-07-30 00:00:00,LABORABLE
30,7,2020,3,104,151,255,2020-07-30 02:00:00,2020-07-30 00:00:00,LABORABLE
30,7,2020,4,76,112,188,2020-07-30 03:00:00,2020-07-30 00:00:00,LABORABLE
30,7,2020,5,79,98,177,2020-07-30 04:00:00,2020-07-30 00:00:00,LABORABLE
30,7,2020,6,149,145,294,2020-07-30 05:00:00,2020-07-30 00:00:00,LABORABLE
30,7,2020,7,391,318,709,2020-07-30 06:00:00,2020-07-30 00:00:00,LABORABLE
30,7,2020,8,620,555,1175,2020-07-30 07:00:00,2020-07-30 00:00:00,LABORABLE
30,7,2020,9,553,666,1219,2020-07-30 08:00:00,2020-07-30 00:00:00,LABORABLE
30,7,2020,10,558,662,1220,2020-07-30 09:00:00,2020-07-30 00:00:00,LABORABLE
30,7,2020,11,508,700,1208,2020-07-30 10:00:00,2020-07-30 00:00:00,LABORABLE
30,7,2020,12,575,737,1312,2020-07-30 11:00:00,2020-07-30 00:00:00,LABORABLE
30,7,2020,13,594,701,1295,2020-07-30 12:00:00,2020-07-30 00:00:00,LABORABLE
30,7,2020,14,610,783,1393,2020-07-30 13:00:00,2020-07-30 00:00:00,LABORABLE
30,7,2020,15,600,688,1288,2020-07-30 14:00:00,2020-07-30 00:00:00,LABORABLE
30,7,2020,16,587,619,1206,2020-07-30 15:00:00,2020-07-30 00:00:00,LABORABLE
30,7,2020,17,522,739,1261,2020-07-30 16:00:00,2020-07-30 00:00:00,LABORABLE
30,7,2020,18,611,753,1364,2020-07-30 17:00:00,2020-07-30 00:00:00,LABORABLE
30,7,2020,19,636,811,1447,2020-07-30 18:00:00,2020-07-30 00:00:00,LABORABLE
30,7,2020,20,666,840,1506,2020-07-30 19:00:00,2020-07-30 00:00:00,LABORABLE
30,7,2020,21,621,778,1399,2020-07-30 20:00:00,2020-07-30 00:00:00,LABORABLE
30,7,2020,22,529,654,1183,2020-07-30 21:00:00,2020-07-30 00:00:00,LABORABLE
30,7,2020,23,402,545,947,2020-07-30 22:00:00,2020-07-30 00:00:00,LABORABLE
30,7,2020,24,306,384,690,2020-07-30 23:00:00,2020-07-30 00:00:00,LABORABLE
31,7,2020,1,251,339,590,2020-07-31 00:00:00,2020-07-31 00:00:00,LABORABLE
31,7,2020,2,167,248,415,2020-07-31 01:00:00,2020-07-31 00:00:00,LABORABLE
31,7,2020,3,111,193,304,2020-07-31 02:00:00,2020-07-31 00:00:00,LABORABLE
31,7,2020,4,71,78,149,2020-07-31 03:00:00,2020-07-31 00:00:00,LABORABLE
31,7,2020,5,80,106,186,2020-07-31 04:00:00,2020-07-31 00:00:00,LABORABLE
31,7,2020,6,150,141,291,2020-07-31 05:00:00,2020-07-31 00:00:00,LABORABLE
31,7,2020,7,391,316,707,2020-07-31 06:00:00,2020-07-31 00:00:00,LABORABLE
31,7,2020,8,563,544,1107,2020-07-31 07:00:00,2020-07-31 00:00:00,LABORABLE
31,7,2020,9,531,583,1114,2020-07-31 08:00:00,2020-07-31 00:00:00,LABORABLE
31,7,2020,10,558,645,1203,2020-07-31 09:00:00,2020-07-31 00:00:00,LABORABLE
31,7,2020,11,569,729,1298,2020-07-31 10:00:00,2020-07-31 00:00:00,LABORABLE
31,7,2020,12,597,737,1334,2020-07-31 11:00:00,2020-07-31 00:00:00,LABORABLE
31,7,2020,13,478,602,1080,2020-07-31 12:00:00,2020-07-31 00:00:00,LABORABLE
31,7,2020,14,652,748,1400,2020-07-31 13:00:00,2020-07-31 00:00:00,LABORABLE
31,7,2020,15,653,759,1412,2020-07-31 14:00:00,2020-07-31 00:00:00,LABORABLE
31,7,2020,16,600,675,1275,2020-07-31 15:00:00,2020-07-31 00:00:00,LABORABLE
31,7,2020,17,553,721,1274,2020-07-31 16:00:00,2020-07-31 00:00:00,LABORABLE
31,7,2020,18,583,754,1337,2020-07-31 17:00:00,2020-07-31 00:00:00,LABORABLE
31,7,2020,19,593,769,1362,2020-07-31 18:00:00,2020-07-31 00:00:00,LABORABLE
31,7,2020,20,659,836,1495,2020-07-31 19:00:00,2020-07-31 00:00:00,LABORABLE
31,7,2020,21,627,844,1471,2020-07-31 20:00:00,2020-07-31 00:00:00,LABORABLE
31,7,2020,22,613,785,1398,2020-07-31 21:00:00,2020-07-31 00:00:00,LABORABLE
31,7,2020,23,520,606,1126,2020-07-31 22:00:00,2020-07-31 00:00:00,LABORABLE
31,7,2020,24,368,479,847,2020-07-31 23:00:00,2020-07-31 00:00:00,LABORABLE
1,8,2020,1,341,474,815,2020-08-01 00:00:00,2020-01-08 00:00:00,LABORABLE
1,8,2020,2,258,349,607,2020-08-01 01:00:00,2020-01-08 00:00:00,LABORABLE
1,8,2020,3,196,240,436,2020-08-01 02:00:00,2020-01-08 00:00:00,LABORABLE
1,8,2020,4,110,168,278,2020-08-01 03:00:00,2020-01-08 00:00:00,LABORABLE
1,8,2020,5,120,141,261,2020-08-01 04:00:00,2020-01-08 00:00:00,LABORABLE
1,8,2020,6,136,130,266,2020-08-01 05:00:00,2020-01-08 00:00:00,LABORABLE
1,8,2020,7,188,191,379,2020-08-01 06:00:00,2020-01-08 00:00:00,LABORABLE
1,8,2020,8,281,276,557,2020-08-01 07:00:00,2020-01-08 00:00:00,LABORABLE
1,8,2020,9,356,383,739,2020-08-01 08:00:00,2020-01-08 00:00:00,LABORABLE
1,8,2020,10,416,508,924,2020-08-01 09:00:00,2020-01-08 00:00:00,LABORABLE
1,8,2020,11,533,628,1161,2020-08-01 10:00:00,2020-01-08 00:00:00,LABORABLE
1,8,2020,12,603,693,1296,2020-08-01 11:00:00,2020-01-08 00:00:00,LABORABLE
1,8,2020,13,606,765,1371,2020-08-01 12:00:00,2020-01-08 00:00:00,LABORABLE
1,8,2020,14,580,773,1353,2020-08-01 13:00:00,2020-01-08 00:00:00,LABORABLE
1,8,2020,15,541,729,1270,2020-08-01 14:00:00,2020-01-08 00:00:00,LABORABLE
1,8,2020,16,479,618,1097,2020-08-01 15:00:00,2020-01-08 00:00:00,LABORABLE
1,8,2020,17,396,547,943,2020-08-01 16:00:00,2020-01-08 00:00:00,LABORABLE
1,8,2020,18,421,618,1039,2020-08-01 17:00:00,2020-01-08 00:00:00,LABORABLE
1,8,2020,19,525,645,1170,2020-08-01 18:00:00,2020-01-08 00:00:00,LABORABLE
1,8,2020,20,545,726,1271,2020-08-01 19:00:00,2020-01-08 00:00:00,LABORABLE
1,8,2020,21,531,683,1214,2020-08-01 20:00:00,2020-01-08 00:00:00,LABORABLE
1,8,2020,22,470,711,1181,2020-08-01 21:00:00,2020-01-08 00:00:00,LABORABLE
1,8,2020,23,463,585,1048,2020-08-01 22:00:00,2020-01-08 00:00:00,LABORABLE
1,8,2020,24,365,486,851,2020-08-01 23:00:00,2020-01-08 00:00:00,LABORABLE
2,8,2020,1,312,467,779,2020-08-02 00:00:00,2020-02-08 00:00:00,LABORABLE
2,8,2020,2,301,364,665,2020-08-02 01:00:00,2020-02-08 00:00:00,LABORABLE
2,8,2020,3,224,319,543,2020-08-02 02:00:00,2020-02-08 00:00:00,LABORABLE
2,8,2020,4,141,223,364,2020-08-02 03:00:00,2020-02-08 00:00:00,LABORABLE
2,8,2020,5,89,164,253,2020-08-02 04:00:00,2020-02-08 00:00:00,LABORABLE
2,8,2020,6,80,146,226,2020-08-02 05:00:00,2020-02-08 00:00:00,LABORABLE
2,8,2020,7,119,131,250,2020-08-02 06:00:00,2020-02-08 00:00:00,LABORABLE
2,8,2020,8,154,185,339,2020-08-02 07:00:00,2020-02-08 00:00:00,LABORABLE
2,8,2020,9,235,238,473,2020-08-02 08:00:00,2020-02-08 00:00:00,LABORABLE
2,8,2020,10,288,388,676,2020-08-02 09:00:00,2020-02-08 00:00:00,LABORABLE
2,8,2020,11,359,436,795,2020-08-02 10:00:00,2020-02-08 00:00:00,LABORABLE
2,8,2020,12,469,523,992,2020-08-02 11:00:00,2020-02-08 00:00:00,LABORABLE
2,8,2020,13,501,577,1078,2020-08-02 12:00:00,2020-02-08 00:00:00,LABORABLE
2,8,2020,14,521,657,1178,2020-08-02 13:00:00,2020-02-08 00:00:00,LABORABLE
2,8,2020,15,458,636,1094,2020-08-02 14:00:00,2020-02-08 00:00:00,LABORABLE
2,8,2020,16,366,495,861,2020-08-02 15:00:00,2020-02-08 00:00:00,LABORABLE
2,8,2020,17,340,510,850,2020-08-02 16:00:00,2020-02-08 00:00:00,LABORABLE
2,8,2020,18,354,559,913,2020-08-02 17:00:00,2020-02-08 00:00:00,LABORABLE
2,8,2020,19,442,551,993,2020-08-02 18:00:00,2020-02-08 00:00:00,LABORABLE
2,8,2020,20,469,635,1104,2020-08-02 19:00:00,2020-02-08 00:00:00,LABORABLE
2,8,2020,21,472,594,1066,2020-08-02 20:00:00,2020-02-08 00:00:00,LABORABLE
2,8,2020,22,431,583,1014,2020-08-02 21:00:00,2020-02-08 00:00:00,LABORABLE
2,8,2020,23,405,511,916,2020-08-02 22:00:00,2020-02-08 00:00:00,LABORABLE
2,8,2020,24,283,440,723,2020-08-02 23:00:00,2020-02-08 00:00:00,LABORABLE
3,8,2020,1,231,267,498,2020-08-03 00:00:00,2020-03-08 00:00:00,LABORABLE
3,8,2020,2,159,215,374,2020-08-03 01:00:00,2020-03-08 00:00:00,LABORABLE
3,8,2020,3,118,185,303,2020-08-03 02:00:00,2020-03-08 00:00:00,LABORABLE
3,8,2020,4,66,99,165,2020-08-03 03:00:00,2020-03-08 00:00:00,LABORABLE
3,8,2020,5,51,92,143,2020-08-03 04:00:00,2020-03-08 00:00:00,LABORABLE
3,8,2020,6,150,106,256,2020-08-03 05:00:00,2020-03-08 00:00:00,LABORABLE
3,8,2020,7,379,291,670,2020-08-03 06:00:00,2020-03-08 00:00:00,LABORABLE
3,8,2020,8,512,452,964,2020-08-03 07:00:00,2020-03-08 00:00:00,LABORABLE
3,8,2020,9,480,518,998,2020-08-03 08:00:00,2020-03-08 00:00:00,LABORABLE
3,8,2020,10,518,608,1126,2020-08-03 09:00:00,2020-03-08 00:00:00,LABORABLE
3,8,2020,11,514,594,1108,2020-08-03 10:00:00,2020-03-08 00:00:00,LABORABLE
3,8,2020,12,519,747,1266,2020-08-03 11:00:00,2020-03-08 00:00:00,LABORABLE
3,8,2020,13,528,644,1172,2020-08-03 12:00:00,2020-03-08 00:00:00,LABORABLE
3,8,2020,14,547,758,1305,2020-08-03 13:00:00,2020-03-08 00:00:00,LABORABLE
3,8,2020,15,543,634,1177,2020-08-03 14:00:00,2020-03-08 00:00:00,LABORABLE
3,8,2020,16,485,643,1128,2020-08-03 15:00:00,2020-03-08 00:00:00,LABORABLE
3,8,2020,17,478,606,1084,2020-08-03 16:00:00,2020-03-08 00:00:00,LABORABLE
3,8,2020,18,527,621,1148,2020-08-03 17:00:00,2020-03-08 00:00:00,LABORABLE
3,8,2020,19,634,738,1372,2020-08-03 18:00:00,2020-03-08 00:00:00,LABORABLE
3,8,2020,20,600,760,1360,2020-08-03 19:00:00,2020-03-08 00:00:00,LABORABLE
3,8,2020,21,544,680,1224,2020-08-03 20:00:00,2020-03-08 00:00:00,LABORABLE
3,8,2020,22,474,454,928,2020-08-03 21:00:00,2020-03-08 00:00:00,LABORABLE
3,8,2020,23,384,530,914,2020-08-03 22:00:00,2020-03-08 00:00:00,LABORABLE
3,8,2020,24,222,360,582,2020-08-03 23:00:00,2020-03-08 00:00:00,LABORABLE
4,8,2020,1,159,241,400,2020-08-04 00:00:00,2020-04-08 00:00:00,LABORABLE
4,8,2020,2,124,173,297,2020-08-04 01:00:00,2020-04-08 00:00:00,LABORABLE
4,8,2020,3,78,141,219,2020-08-04 02:00:00,2020-04-08 00:00:00,LABORABLE
4,8,2020,4,59,85,144,2020-08-04 03:00:00,2020-04-08 00:00:00,LABORABLE
4,8,2020,5,70,68,138,2020-08-04 04:00:00,2020-04-08 00:00:00,LABORABLE
4,8,2020,6,130,105,235,2020-08-04 05:00:00,2020-04-08 00:00:00,LABORABLE
4,8,2020,7,388,302,690,2020-08-04 06:00:00,2020-04-08 00:00:00,LABORABLE
4,8,2020,8,526,457,983,2020-08-04 07:00:00,2020-04-08 00:00:00,LABORABLE
4,8,2020,9,476,561,1037,2020-08-04 08:00:00,2020-04-08 00:00:00,LABORABLE
4,8,2020,10,521,596,1117,2020-08-04 09:00:00,2020-04-08 00:00:00,LABORABLE
4,8,2020,11,557,595,1152,2020-08-04 10:00:00,2020-04-08 00:00:00,LABORABLE
4,8,2020,12,551,641,1192,2020-08-04 11:00:00,2020-04-08 00:00:00,LABORABLE
4,8,2020,13,552,669,1221,2020-08-04 12:00:00,2020-04-08 00:00:00,LABORABLE
4,8,2020,14,553,719,1272,2020-08-04 13:00:00,2020-04-08 00:00:00,LABORABLE
4,8,2020,15,533,665,1198,2020-08-04 14:00:00,2020-04-08 00:00:00,LABORABLE
4,8,2020,16,533,609,1142,2020-08-04 15:00:00,2020-04-08 00:00:00,LABORABLE
4,8,2020,17,478,663,1141,2020-08-04 16:00:00,2020-04-08 00:00:00,LABORABLE
4,8,2020,18,526,607,1133,2020-08-04 17:00:00,2020-04-08 00:00:00,LABORABLE
4,8,2020,19,635,727,1362,2020-08-04 18:00:00,2020-04-08 00:00:00,LABORABLE
4,8,2020,20,567,767,1334,2020-08-04 19:00:00,2020-04-08 00:00:00,LABORABLE
4,8,2020,21,533,688,1221,2020-08-04 20:00:00,2020-04-08 00:00:00,LABORABLE
4,8,2020,22,508,567,1075,2020-08-04 21:00:00,2020-04-08 00:00:00,LABORABLE
4,8,2020,23,403,497,900,2020-08-04 22:00:00,2020-04-08 00:00:00,LABORABLE
4,8,2020,24,243,349,592,2020-08-04 23:00:00,2020-04-08 00:00:00,LABORABLE
5,8,2020,1,188,261,449,2020-08-05 00:00:00,2020-05-08 00:00:00,LABORABLE
5,8,2020,2,144,162,306,2020-08-05 01:00:00,2020-05-08 00:00:00,LABORABLE
5,8,2020,3,90,155,245,2020-08-05 02:00:00,2020-05-08 00:00:00,LABORABLE
5,8,2020,4,54,84,138,2020-08-05 03:00:00,2020-05-08 00:00:00,LABORABLE
5,8,2020,5,62,76,138,2020-08-05 04:00:00,2020-05-08 00:00:00,LABORABLE
5,8,2020,6,147,111,258,2020-08-05 05:00:00,2020-05-08 00:00:00,LABORABLE
5,8,2020,7,366,301,667,2020-08-05 06:00:00,2020-05-08 00:00:00,LABORABLE
5,8,2020,8,499,431,930,2020-08-05 07:00:00,2020-05-08 00:00:00,LABORABLE
5,8,2020,9,482,526,1008,2020-08-05 08:00:00,2020-05-08 00:00:00,LABORABLE
5,8,2020,10,515,602,1117,2020-08-05 09:00:00,2020-05-08 00:00:00,LABORABLE
5,8,2020,11,532,596,1128,2020-08-05 10:00:00,2020-05-08 00:00:00,LABORABLE
5,8,2020,12,512,697,1209,2020-08-05 11:00:00,2020-05-08 00:00:00,LABORABLE
5,8,2020,13,569,733,1302,2020-08-05 12:00:00,2020-05-08 00:00:00,LABORABLE
5,8,2020,14,559,763,1322,2020-08-05 13:00:00,2020-05-08 00:00:00,LABORABLE
5,8,2020,15,591,699,1290,2020-08-05 14:00:00,2020-05-08 00:00:00,LABORABLE
5,8,2020,16,510,626,1136,2020-08-05 15:00:00,2020-05-08 00:00:00,LABORABLE
5,8,2020,17,459,675,1134,2020-08-05 16:00:00,2020-05-08 00:00:00,LABORABLE
5,8,2020,18,550,646,1196,2020-08-05 17:00:00,2020-05-08 00:00:00,LABORABLE
5,8,2020,19,608,765,1373,2020-08-05 18:00:00,2020-05-08 00:00:00,LABORABLE
5,8,2020,20,614,762,1376,2020-08-05 19:00:00,2020-05-08 00:00:00,LABORABLE
5,8,2020,21,536,694,1230,2020-08-05 20:00:00,2020-05-08 00:00:00,LABORABLE
5,8,2020,22,489,640,1129,2020-08-05 21:00:00,2020-05-08 00:00:00,LABORABLE
5,8,2020,23,415,516,931,2020-08-05 22:00:00,2020-05-08 00:00:00,LABORABLE
5,8,2020,24,304,348,652,2020-08-05 23:00:00,2020-05-08 00:00:00,LABORABLE
6,8,2020,1,196,248,444,2020-08-06 00:00:00,2020-06-08 00:00:00,LABORABLE
6,8,2020,2,147,163,310,2020-08-06 01:00:00,2020-06-08 00:00:00,LABORABLE
6,8,2020,3,101,132,233,2020-08-06 02:00:00,2020-06-08 00:00:00,LABORABLE
6,8,2020,4,68,94,162,2020-08-06 03:00:00,2020-06-08 00:00:00,LABORABLE
6,8,2020,5,80,68,148,2020-08-06 04:00:00,2020-06-08 00:00:00,LABORABLE
6,8,2020,6,141,129,270,2020-08-06 05:00:00,2020-06-08 00:00:00,LABORABLE
6,8,2020,7,376,317,693,2020-08-06 06:00:00,2020-06-08 00:00:00,LABORABLE
6,8,2020,8,518,473,991,2020-08-06 07:00:00,2020-06-08 00:00:00,LABORABLE
6,8,2020,9,509,521,1030,2020-08-06 08:00:00,2020-06-08 00:00:00,LABORABLE
6,8,2020,10,482,604,1086,2020-08-06 09:00:00,2020-06-08 00:00:00,LABORABLE
6,8,2020,11,489,579,1068,2020-08-06 10:00:00,2020-06-08 00:00:00,LABORABLE
6,8,2020,12,559,629,1188,2020-08-06 11:00:00,2020-06-08 00:00:00,LABORABLE
6,8,2020,13,438,562,1000,2020-08-06 12:00:00,2020-06-08 00:00:00,LABORABLE
6,8,2020,14,581,687,1268,2020-08-06 13:00:00,2020-06-08 00:00:00,LABORABLE
6,8,2020,15,536,657,1193,2020-08-06 14:00:00,2020-06-08 00:00:00,LABORABLE
6,8,2020,16,533,622,1155,2020-08-06 15:00:00,2020-06-08 00:00:00,LABORABLE
6,8,2020,17,450,644,1094,2020-08-06 16:00:00,2020-06-08 00:00:00,LABORABLE
6,8,2020,18,530,640,1170,2020-08-06 17:00:00,2020-06-08 00:00:00,LABORABLE
6,8,2020,19,605,697,1302,2020-08-06 18:00:00,2020-06-08 00:00:00,LABORABLE
6,8,2020,20,607,738,1345,2020-08-06 19:00:00,2020-06-08 00:00:00,LABORABLE
6,8,2020,21,570,760,1330,2020-08-06 20:00:00,2020-06-08 00:00:00,LABORABLE
6,8,2020,22,518,654,1172,2020-08-06 21:00:00,2020-06-08 00:00:00,LABORABLE
6,8,2020,23,419,526,945,2020-08-06 22:00:00,2020-06-08 00:00:00,LABORABLE
6,8,2020,24,277,390,667,2020-08-06 23:00:00,2020-06-08 00:00:00,LABORABLE
7,8,2020,1,213,283,496,2020-08-07 00:00:00,2020-07-08 00:00:00,LABORABLE
7,8,2020,2,162,223,385,2020-08-07 01:00:00,2020-07-08 00:00:00,LABORABLE
7,8,2020,3,117,187,304,2020-08-07 02:00:00,2020-07-08 00:00:00,LABORABLE
7,8,2020,4,83,126,209,2020-08-07 03:00:00,2020-07-08 00:00:00,LABORABLE
7,8,2020,5,86,91,177,2020-08-07 04:00:00,2020-07-08 00:00:00,LABORABLE
7,8,2020,6,147,129,276,2020-08-07 05:00:00,2020-07-08 00:00:00,LABORABLE
7,8,2020,7,372,301,673,2020-08-07 06:00:00,2020-07-08 00:00:00,LABORABLE
7,8,2020,8,513,432,945,2020-08-07 07:00:00,2020-07-08 00:00:00,LABORABLE
7,8,2020,9,522,549,1071,2020-08-07 08:00:00,2020-07-08 00:00:00,LABORABLE
7,8,2020,10,534,627,1161,2020-08-07 09:00:00,2020-07-08 00:00:00,LABORABLE
7,8,2020,11,540,547,1087,2020-08-07 10:00:00,2020-07-08 00:00:00,LABORABLE
7,8,2020,12,571,697,1268,2020-08-07 11:00:00,2020-07-08 00:00:00,LABORABLE
7,8,2020,13,564,695,1259,2020-08-07 12:00:00,2020-07-08 00:00:00,LABORABLE
7,8,2020,14,584,728,1312,2020-08-07 13:00:00,2020-07-08 00:00:00,LABORABLE
7,8,2020,15,601,737,1338,2020-08-07 14:00:00,2020-07-08 00:00:00,LABORABLE
7,8,2020,16,512,608,1120,2020-08-07 15:00:00,2020-07-08 00:00:00,LABORABLE
7,8,2020,17,517,678,1195,2020-08-07 16:00:00,2020-07-08 00:00:00,LABORABLE
7,8,2020,18,502,619,1121,2020-08-07 17:00:00,2020-07-08 00:00:00,LABORABLE
7,8,2020,19,562,709,1271,2020-08-07 18:00:00,2020-07-08 00:00:00,LABORABLE
7,8,2020,20,614,743,1357,2020-08-07 19:00:00,2020-07-08 00:00:00,LABORABLE
7,8,2020,21,632,764,1396,2020-08-07 20:00:00,2020-07-08 00:00:00,LABORABLE
7,8,2020,22,512,668,1180,2020-08-07 21:00:00,2020-07-08 00:00:00,LABORABLE
7,8,2020,23,399,541,940,2020-08-07 22:00:00,2020-07-08 00:00:00,LABORABLE
7,8,2020,24,336,471,807,2020-08-07 23:00:00,2020-07-08 00:00:00,LABORABLE
8,8,2020,1,243,355,598,2020-08-08 00:00:00,2020-08-08 00:00:00,LABORABLE
8,8,2020,2,228,288,516,2020-08-08 01:00:00,2020-08-08 00:00:00,LABORABLE
8,8,2020,3,150,278,428,2020-08-08 02:00:00,2020-08-08 00:00:00,LABORABLE
8,8,2020,4,110,146,256,2020-08-08 03:00:00,2020-08-08 00:00:00,LABORABLE
8,8,2020,5,94,134,228,2020-08-08 04:00:00,2020-08-08 00:00:00,LABORABLE
8,8,2020,6,101,138,239,2020-08-08 05:00:00,2020-08-08 00:00:00,LABORABLE
8,8,2020,7,153,158,311,2020-08-08 06:00:00,2020-08-08 00:00:00,LABORABLE
8,8,2020,8,268,248,516,2020-08-08 07:00:00,2020-08-08 00:00:00,LABORABLE
8,8,2020,9,315,394,709,2020-08-08 08:00:00,2020-08-08 00:00:00,LABORABLE
8,8,2020,10,416,464,880,2020-08-08 09:00:00,2020-08-08 00:00:00,LABORABLE
8,8,2020,11,433,543,976,2020-08-08 10:00:00,2020-08-08 00:00:00,LABORABLE
8,8,2020,12,527,660,1187,2020-08-08 11:00:00,2020-08-08 00:00:00,LABORABLE
8,8,2020,13,529,688,1217,2020-08-08 12:00:00,2020-08-08 00:00:00,LABORABLE
8,8,2020,14,536,749,1285,2020-08-08 13:00:00,2020-08-08 00:00:00,LABORABLE
8,8,2020,15,524,749,1273,2020-08-08 14:00:00,2020-08-08 00:00:00,LABORABLE
8,8,2020,16,430,599,1029,2020-08-08 15:00:00,2020-08-08 00:00:00,LABORABLE
8,8,2020,17,414,614,1028,2020-08-08 16:00:00,2020-08-08 00:00:00,LABORABLE
8,8,2020,18,450,617,1067,2020-08-08 17:00:00,2020-08-08 00:00:00,LABORABLE
8,8,2020,19,451,642,1093,2020-08-08 18:00:00,2020-08-08 00:00:00,LABORABLE
8,8,2020,20,500,689,1189,2020-08-08 19:00:00,2020-08-08 00:00:00,LABORABLE
8,8,2020,21,484,672,1156,2020-08-08 20:00:00,2020-08-08 00:00:00,LABORABLE
8,8,2020,22,413,581,994,2020-08-08 21:00:00,2020-08-08 00:00:00,LABORABLE
8,8,2020,23,425,548,973,2020-08-08 22:00:00,2020-08-08 00:00:00,LABORABLE
8,8,2020,24,339,475,814,2020-08-08 23:00:00,2020-08-08 00:00:00,LABORABLE
9,8,2020,1,298,417,715,2020-08-09 00:00:00,2020-09-08 00:00:00,LABORABLE
9,8,2020,2,291,377,668,2020-08-09 01:00:00,2020-09-08 00:00:00,LABORABLE
9,8,2020,3,213,317,530,2020-08-09 02:00:00,2020-09-08 00:00:00,LABORABLE
9,8,2020,4,128,198,326,2020-08-09 03:00:00,2020-09-08 00:00:00,LABORABLE
9,8,2020,5,84,160,244,2020-08-09 04:00:00,2020-09-08 00:00:00,LABORABLE
9,8,2020,6,85,125,210,2020-08-09 05:00:00,2020-09-08 00:00:00,LABORABLE
9,8,2020,7,101,113,214,2020-08-09 06:00:00,2020-09-08 00:00:00,LABORABLE
9,8,2020,8,151,159,310,2020-08-09 07:00:00,2020-09-08 00:00:00,LABORABLE
9,8,2020,9,188,212,400,2020-08-09 08:00:00,2020-09-08 00:00:00,LABORABLE
9,8,2020,10,293,366,659,2020-08-09 09:00:00,2020-09-08 00:00:00,LABORABLE
9,8,2020,11,352,420,772,2020-08-09 10:00:00,2020-09-08 00:00:00,LABORABLE
9,8,2020,12,436,473,909,2020-08-09 11:00:00,2020-09-08 00:00:00,LABORABLE
9,8,2020,13,407,598,1005,2020-08-09 12:00:00,2020-09-08 00:00:00,LABORABLE
9,8,2020,14,418,648,1066,2020-08-09 13:00:00,2020-09-08 00:00:00,LABORABLE
9,8,2020,15,423,562,985,2020-08-09 14:00:00,2020-09-08 00:00:00,LABORABLE
9,8,2020,16,359,483,842,2020-08-09 15:00:00,2020-09-08 00:00:00,LABORABLE
9,8,2020,17,336,476,812,2020-08-09 16:00:00,2020-09-08 00:00:00,LABORABLE
9,8,2020,18,324,515,839,2020-08-09 17:00:00,2020-09-08 00:00:00,LABORABLE
9,8,2020,19,396,528,924,2020-08-09 18:00:00,2020-09-08 00:00:00,LABORABLE
9,8,2020,20,395,574,969,2020-08-09 19:00:00,2020-09-08 00:00:00,LABORABLE
9,8,2020,21,456,585,1041,2020-08-09 20:00:00,2020-09-08 00:00:00,LABORABLE
9,8,2020,22,391,553,944,2020-08-09 21:00:00,2020-09-08 00:00:00,LABORABLE
9,8,2020,23,409,493,902,2020-08-09 22:00:00,2020-09-08 00:00:00,LABORABLE
9,8,2020,24,265,407,672,2020-08-09 23:00:00,2020-09-08 00:00:00,LABORABLE
10,8,2020,1,218,314,532,2020-08-10 00:00:00,2020-10-08 00:00:00,LABORABLE
10,8,2020,2,162,218,380,2020-08-10 01:00:00,2020-10-08 00:00:00,LABORABLE
10,8,2020,3,128,184,312,2020-08-10 02:00:00,2020-10-08 00:00:00,LABORABLE
10,8,2020,4,69,105,174,2020-08-10 03:00:00,2020-10-08 00:00:00,LABORABLE
10,8,2020,5,79,95,174,2020-08-10 04:00:00,2020-10-08 00:00:00,LABORABLE
10,8,2020,6,141,150,291,2020-08-10 05:00:00,2020-10-08 00:00:00,LABORABLE
10,8,2020,7,346,281,627,2020-08-10 06:00:00,2020-10-08 00:00:00,LABORABLE
10,8,2020,8,486,445,931,2020-08-10 07:00:00,2020-10-08 00:00:00,LABORABLE
10,8,2020,9,479,486,965,2020-08-10 08:00:00,2020-10-08 00:00:00,LABORABLE
10,8,2020,10,471,569,1040,2020-08-10 09:00:00,2020-10-08 00:00:00,LABORABLE
10,8,2020,11,468,587,1055,2020-08-10 10:00:00,2020-10-08 00:00:00,LABORABLE
10,8,2020,12,339,465,804,2020-08-10 11:00:00,2020-10-08 00:00:00,LABORABLE
10,8,2020,13,545,705,1250,2020-08-10 12:00:00,2020-10-08 00:00:00,LABORABLE
10,8,2020,14,574,741,1315,2020-08-10 13:00:00,2020-10-08 00:00:00,LABORABLE
10,8,2020,15,533,677,1210,2020-08-10 14:00:00,2020-10-08 00:00:00,LABORABLE
10,8,2020,16,498,632,1130,2020-08-10 15:00:00,2020-10-08 00:00:00,LABORABLE
10,8,2020,17,461,590,1051,2020-08-10 16:00:00,2020-10-08 00:00:00,LABORABLE
10,8,2020,18,536,613,1149,2020-08-10 17:00:00,2020-10-08 00:00:00,LABORABLE
10,8,2020,19,590,689,1279,2020-08-10 18:00:00,2020-10-08 00:00:00,LABORABLE
10,8,2020,20,542,703,1245,2020-08-10 19:00:00,2020-10-08 00:00:00,LABORABLE
10,8,2020,21,508,687,1195,2020-08-10 20:00:00,2020-10-08 00:00:00,LABORABLE
10,8,2020,22,457,576,1033,2020-08-10 21:00:00,2020-10-08 00:00:00,LABORABLE
10,8,2020,23,339,416,755,2020-08-10 22:00:00,2020-10-08 00:00:00,LABORABLE
10,8,2020,24,207,300,507,2020-08-10 23:00:00,2020-10-08 00:00:00,LABORABLE
11,8,2020,1,151,224,375,2020-08-11 00:00:00,2020-11-08 00:00:00,LABORABLE
11,8,2020,2,112,161,273,2020-08-11 01:00:00,2020-11-08 00:00:00,LABORABLE
11,8,2020,3,84,120,204,2020-08-11 02:00:00,2020-11-08 00:00:00,LABORABLE
11,8,2020,4,54,76,130,2020-08-11 03:00:00,2020-11-08 00:00:00,LABORABLE
11,8,2020,5,75,71,146,2020-08-11 04:00:00,2020-11-08 00:00:00,LABORABLE
11,8,2020,6,130,102,232,2020-08-11 05:00:00,2020-11-08 00:00:00,LABORABLE
11,8,2020,7,357,276,633,2020-08-11 06:00:00,2020-11-08 00:00:00,LABORABLE
11,8,2020,8,495,450,945,2020-08-11 07:00:00,2020-11-08 00:00:00,LABORABLE
11,8,2020,9,487,527,1014,2020-08-11 08:00:00,2020-11-08 00:00:00,LABORABLE
11,8,2020,10,476,530,1006,2020-08-11 09:00:00,2020-11-08 00:00:00,LABORABLE
11,8,2020,11,474,620,1094,2020-08-11 10:00:00,2020-11-08 00:00:00,LABORABLE
11,8,2020,12,419,486,905,2020-08-11 11:00:00,2020-11-08 00:00:00,LABORABLE
11,8,2020,13,536,632,1168,2020-08-11 12:00:00,2020-11-08 00:00:00,LABORABLE
11,8,2020,14,532,678,1210,2020-08-11 13:00:00,2020-11-08 00:00:00,LABORABLE
11,8,2020,15,571,643,1214,2020-08-11 14:00:00,2020-11-08 00:00:00,LABORABLE
11,8,2020,16,501,588,1089,2020-08-11 15:00:00,2020-11-08 00:00:00,LABORABLE
11,8,2020,17,485,571,1056,2020-08-11 16:00:00,2020-11-08 00:00:00,LABORABLE
11,8,2020,18,503,548,1051,2020-08-11 17:00:00,2020-11-08 00:00:00,LABORABLE
11,8,2020,19,572,675,1247,2020-08-11 18:00:00,2020-11-08 00:00:00,LABORABLE
11,8,2020,20,535,710,1245,2020-08-11 19:00:00,2020-11-08 00:00:00,LABORABLE
11,8,2020,21,432,653,1085,2020-08-11 20:00:00,2020-11-08 00:00:00,LABORABLE
11,8,2020,22,386,498,884,2020-08-11 21:00:00,2020-11-08 00:00:00,LABORABLE
11,8,2020,23,300,394,694,2020-08-11 22:00:00,2020-11-08 00:00:00,LABORABLE
11,8,2020,24,224,295,519,2020-08-11 23:00:00,2020-11-08 00:00:00,LABORABLE
12,8,2020,1,268,196,464,2020-08-12 00:00:00,2020-12-08 00:00:00,LABORABLE
12,8,2020,2,215,103,318,2020-08-12 01:00:00,2020-12-08 00:00:00,LABORABLE
12,8,2020,3,146,112,258,2020-08-12 02:00:00,2020-12-08 00:00:00,LABORABLE
12,8,2020,4,92,74,166,2020-08-12 03:00:00,2020-12-08 00:00:00,LABORABLE
12,8,2020,5,95,55,150,2020-08-12 04:00:00,2020-12-08 00:00:00,LABORABLE
12,8,2020,6,100,127,227,2020-08-12 05:00:00,2020-12-08 00:00:00,LABORABLE
12,8,2020,7,141,263,404,2020-08-12 06:00:00,2020-12-08 00:00:00,LABORABLE
12,8,2020,8,248,439,687,2020-08-12 07:00:00,2020-12-08 00:00:00,LABORABLE
12,8,2020,9,304,516,820,2020-08-12 08:00:00,2020-12-08 00:00:00,LABORABLE
12,8,2020,10,364,572,936,2020-08-12 09:00:00,2020-12-08 00:00:00,LABORABLE
12,8,2020,11,400,553,953,2020-08-12 10:00:00,2020-12-08 00:00:00,LABORABLE
12,8,2020,12,511,521,1032,2020-08-12 11:00:00,2020-12-08 00:00:00,LABORABLE
12,8,2020,13,545,685,1230,2020-08-12 12:00:00,2020-12-08 00:00:00,LABORABLE
12,8,2020,14,469,673,1142,2020-08-12 13:00:00,2020-12-08 00:00:00,LABORABLE
12,8,2020,15,474,643,1117,2020-08-12 14:00:00,2020-12-08 00:00:00,LABORABLE
12,8,2020,16,376,665,1041,2020-08-12 15:00:00,2020-12-08 00:00:00,LABORABLE
12,8,2020,17,347,632,979,2020-08-12 16:00:00,2020-12-08 00:00:00,LABORABLE
12,8,2020,18,403,672,1075,2020-08-12 17:00:00,2020-12-08 00:00:00,LABORABLE
12,8,2020,19,457,703,1160,2020-08-12 18:00:00,2020-12-08 00:00:00,LABORABLE
12,8,2020,20,467,720,1187,2020-08-12 19:00:00,2020-12-08 00:00:00,LABORABLE
12,8,2020,21,418,720,1138,2020-08-12 20:00:00,2020-12-08 00:00:00,LABORABLE
12,8,2020,22,465,645,1110,2020-08-12 21:00:00,2020-12-08 00:00:00,LABORABLE
12,8,2020,23,382,445,827,2020-08-12 22:00:00,2020-12-08 00:00:00,LABORABLE
12,8,2020,24,306,328,634,2020-08-12 23:00:00,2020-12-08 00:00:00,LABORABLE
13,8,2020,1,171,260,431,2020-08-13 00:00:00,2020-08-13 00:00:00,LABORABLE
13,8,2020,2,138,162,300,2020-08-13 01:00:00,2020-08-13 00:00:00,LABORABLE
13,8,2020,3,99,136,235,2020-08-13 02:00:00,2020-08-13 00:00:00,LABORABLE
13,8,2020,4,74,96,170,2020-08-13 03:00:00,2020-08-13 00:00:00,LABORABLE
13,8,2020,5,64,81,145,2020-08-13 04:00:00,2020-08-13 00:00:00,LABORABLE
13,8,2020,6,127,118,245,2020-08-13 05:00:00,2020-08-13 00:00:00,LABORABLE
13,8,2020,7,348,268,616,2020-08-13 06:00:00,2020-08-13 00:00:00,LABORABLE
13,8,2020,8,496,436,932,2020-08-13 07:00:00,2020-08-13 00:00:00,LABORABLE
13,8,2020,9,509,479,988,2020-08-13 08:00:00,2020-08-13 00:00:00,LABORABLE
13,8,2020,10,480,540,1020,2020-08-13 09:00:00,2020-08-13 00:00:00,LABORABLE
13,8,2020,11,499,545,1044,2020-08-13 10:00:00,2020-08-13 00:00:00,LABORABLE
13,8,2020,12,509,628,1137,2020-08-13 11:00:00,2020-08-13 00:00:00,LABORABLE
13,8,2020,13,588,668,1256,2020-08-13 12:00:00,2020-08-13 00:00:00,LABORABLE
13,8,2020,14,507,646,1153,2020-08-13 13:00:00,2020-08-13 00:00:00,LABORABLE
13,8,2020,15,517,654,1171,2020-08-13 14:00:00,2020-08-13 00:00:00,LABORABLE
13,8,2020,16,508,598,1106,2020-08-13 15:00:00,2020-08-13 00:00:00,LABORABLE
13,8,2020,17,486,636,1122,2020-08-13 16:00:00,2020-08-13 00:00:00,LABORABLE
13,8,2020,18,479,620,1099,2020-08-13 17:00:00,2020-08-13 00:00:00,LABORABLE
13,8,2020,19,557,715,1272,2020-08-13 18:00:00,2020-08-13 00:00:00,LABORABLE
13,8,2020,20,588,710,1298,2020-08-13 19:00:00,2020-08-13 00:00:00,LABORABLE
13,8,2020,21,517,701,1218,2020-08-13 20:00:00,2020-08-13 00:00:00,LABORABLE
13,8,2020,22,479,613,1092,2020-08-13 21:00:00,2020-08-13 00:00:00,LABORABLE
13,8,2020,23,358,464,822,2020-08-13 22:00:00,2020-08-13 00:00:00,LABORABLE
13,8,2020,24,283,370,653,2020-08-13 23:00:00,2020-08-13 00:00:00,LABORABLE
14,8,2020,1,179,264,443,2020-08-14 00:00:00,2020-08-14 00:00:00,LABORABLE
14,8,2020,2,166,176,342,2020-08-14 01:00:00,2020-08-14 00:00:00,LABORABLE
14,8,2020,3,113,165,278,2020-08-14 02:00:00,2020-08-14 00:00:00,LABORABLE
14,8,2020,4,75,105,180,2020-08-14 03:00:00,2020-08-14 00:00:00,LABORABLE
14,8,2020,5,73,68,141,2020-08-14 04:00:00,2020-08-14 00:00:00,LABORABLE
14,8,2020,6,139,122,261,2020-08-14 05:00:00,2020-08-14 00:00:00,LABORABLE
14,8,2020,7,309,255,564,2020-08-14 06:00:00,2020-08-14 00:00:00,LABORABLE
14,8,2020,8,444,405,849,2020-08-14 07:00:00,2020-08-14 00:00:00,LABORABLE
14,8,2020,9,480,483,963,2020-08-14 08:00:00,2020-08-14 00:00:00,LABORABLE
14,8,2020,10,479,572,1051,2020-08-14 09:00:00,2020-08-14 00:00:00,LABORABLE
14,8,2020,11,458,611,1069,2020-08-14 10:00:00,2020-08-14 00:00:00,LABORABLE
14,8,2020,12,541,666,1207,2020-08-14 11:00:00,2020-08-14 00:00:00,LABORABLE
14,8,2020,13,555,702,1257,2020-08-14 12:00:00,2020-08-14 00:00:00,LABORABLE
14,8,2020,14,598,688,1286,2020-08-14 13:00:00,2020-08-14 00:00:00,LABORABLE
14,8,2020,15,568,706,1274,2020-08-14 14:00:00,2020-08-14 00:00:00,LABORABLE
14,8,2020,16,530,628,1158,2020-08-14 15:00:00,2020-08-14 00:00:00,LABORABLE
14,8,2020,17,473,612,1085,2020-08-14 16:00:00,2020-08-14 00:00:00,LABORABLE
14,8,2020,18,545,699,1244,2020-08-14 17:00:00,2020-08-14 00:00:00,LABORABLE
14,8,2020,19,574,700,1274,2020-08-14 18:00:00,2020-08-14 00:00:00,LABORABLE
14,8,2020,20,601,757,1358,2020-08-14 19:00:00,2020-08-14 00:00:00,LABORABLE
14,8,2020,21,551,775,1326,2020-08-14 20:00:00,2020-08-14 00:00:00,LABORABLE
14,8,2020,22,504,667,1171,2020-08-14 21:00:00,2020-08-14 00:00:00,LABORABLE
14,8,2020,23,406,533,939,2020-08-14 22:00:00,2020-08-14 00:00:00,LABORABLE
14,8,2020,24,336,420,756,2020-08-14 23:00:00,2020-08-14 00:00:00,LABORABLE
15,8,2020,1,251,354,605,2020-08-15 00:00:00,2020-08-15 00:00:00,FESTIVO
15,8,2020,2,219,327,546,2020-08-15 01:00:00,2020-08-15 00:00:00,FESTIVO
15,8,2020,3,181,256,437,2020-08-15 02:00:00,2020-08-15 00:00:00,FESTIVO
15,8,2020,4,125,157,282,2020-08-15 03:00:00,2020-08-15 00:00:00,FESTIVO
15,8,2020,5,101,140,241,2020-08-15 04:00:00,2020-08-15 00:00:00,FESTIVO
15,8,2020,6,93,122,215,2020-08-15 05:00:00,2020-08-15 00:00:00,FESTIVO
15,8,2020,7,146,139,285,2020-08-15 06:00:00,2020-08-15 00:00:00,FESTIVO
15,8,2020,8,221,217,438,2020-08-15 07:00:00,2020-08-15 00:00:00,FESTIVO
15,8,2020,9,258,281,539,2020-08-15 08:00:00,2020-08-15 00:00:00,FESTIVO
15,8,2020,10,345,427,772,2020-08-15 09:00:00,2020-08-15 00:00:00,FESTIVO
15,8,2020,11,427,489,916,2020-08-15 10:00:00,2020-08-15 00:00:00,FESTIVO
15,8,2020,12,460,594,1054,2020-08-15 11:00:00,2020-08-15 00:00:00,FESTIVO
15,8,2020,13,498,707,1205,2020-08-15 12:00:00,2020-08-15 00:00:00,FESTIVO
15,8,2020,14,500,699,1199,2020-08-15 13:00:00,2020-08-15 00:00:00,FESTIVO
15,8,2020,15,473,627,1100,2020-08-15 14:00:00,2020-08-15 00:00:00,FESTIVO
15,8,2020,16,378,535,913,2020-08-15 15:00:00,2020-08-15 00:00:00,FESTIVO
15,8,2020,17,353,548,901,2020-08-15 16:00:00,2020-08-15 00:00:00,FESTIVO
15,8,2020,18,400,569,969,2020-08-15 17:00:00,2020-08-15 00:00:00,FESTIVO
15,8,2020,19,428,616,1044,2020-08-15 18:00:00,2020-08-15 00:00:00,FESTIVO
15,8,2020,20,406,639,1045,2020-08-15 19:00:00,2020-08-15 00:00:00,FESTIVO
15,8,2020,21,440,633,1073,2020-08-15 20:00:00,2020-08-15 00:00:00,FESTIVO
15,8,2020,22,426,626,1052,2020-08-15 21:00:00,2020-08-15 00:00:00,FESTIVO
15,8,2020,23,388,537,925,2020-08-15 22:00:00,2020-08-15 00:00:00,FESTIVO
15,8,2020,24,309,465,774,2020-08-15 23:00:00,2020-08-15 00:00:00,FESTIVO
16,8,2020,1,254,375,629,2020-08-16 00:00:00,2020-08-16 00:00:00,LABORABLE
16,8,2020,2,261,339,600,2020-08-16 01:00:00,2020-08-16 00:00:00,LABORABLE
16,8,2020,3,162,267,429,2020-08-16 02:00:00,2020-08-16 00:00:00,LABORABLE
16,8,2020,4,102,154,256,2020-08-16 03:00:00,2020-08-16 00:00:00,LABORABLE
16,8,2020,5,78,142,220,2020-08-16 04:00:00,2020-08-16 00:00:00,LABORABLE
16,8,2020,6,71,106,177,2020-08-16 05:00:00,2020-08-16 00:00:00,LABORABLE
16,8,2020,7,114,127,241,2020-08-16 06:00:00,2020-08-16 00:00:00,LABORABLE
16,8,2020,8,139,144,283,2020-08-16 07:00:00,2020-08-16 00:00:00,LABORABLE
16,8,2020,9,192,209,401,2020-08-16 08:00:00,2020-08-16 00:00:00,LABORABLE
16,8,2020,10,280,373,653,2020-08-16 09:00:00,2020-08-16 00:00:00,LABORABLE
16,8,2020,11,328,415,743,2020-08-16 10:00:00,2020-08-16 00:00:00,LABORABLE
16,8,2020,12,383,516,899,2020-08-16 11:00:00,2020-08-16 00:00:00,LABORABLE
16,8,2020,13,409,581,990,2020-08-16 12:00:00,2020-08-16 00:00:00,LABORABLE
16,8,2020,14,443,578,1021,2020-08-16 13:00:00,2020-08-16 00:00:00,LABORABLE
16,8,2020,15,430,644,1074,2020-08-16 14:00:00,2020-08-16 00:00:00,LABORABLE
16,8,2020,16,341,522,863,2020-08-16 15:00:00,2020-08-16 00:00:00,LABORABLE
16,8,2020,17,355,520,875,2020-08-16 16:00:00,2020-08-16 00:00:00,LABORABLE
16,8,2020,18,321,514,835,2020-08-16 17:00:00,2020-08-16 00:00:00,LABORABLE
16,8,2020,19,395,564,959,2020-08-16 18:00:00,2020-08-16 00:00:00,LABORABLE
16,8,2020,20,407,613,1020,2020-08-16 19:00:00,2020-08-16 00:00:00,LABORABLE
16,8,2020,21,429,549,978,2020-08-16 20:00:00,2020-08-16 00:00:00,LABORABLE
16,8,2020,22,426,530,956,2020-08-16 21:00:00,2020-08-16 00:00:00,LABORABLE
16,8,2020,23,365,497,862,2020-08-16 22:00:00,2020-08-16 00:00:00,LABORABLE
16,8,2020,24,291,350,641,2020-08-16 23:00:00,2020-08-16 00:00:00,LABORABLE
17,8,2020,1,176,228,404,2020-08-17 00:00:00,2020-08-17 00:00:00,LABORABLE
17,8,2020,2,148,209,357,2020-08-17 01:00:00,2020-08-17 00:00:00,LABORABLE
17,8,2020,3,92,147,239,2020-08-17 02:00:00,2020-08-17 00:00:00,LABORABLE
17,8,2020,4,66,87,153,2020-08-17 03:00:00,2020-08-17 00:00:00,LABORABLE
17,8,2020,5,57,69,126,2020-08-17 04:00:00,2020-08-17 00:00:00,LABORABLE
17,8,2020,6,116,115,231,2020-08-17 05:00:00,2020-08-17 00:00:00,LABORABLE
17,8,2020,7,319,233,552,2020-08-17 06:00:00,2020-08-17 00:00:00,LABORABLE
17,8,2020,8,470,442,912,2020-08-17 07:00:00,2020-08-17 00:00:00,LABORABLE
17,8,2020,9,446,531,977,2020-08-17 08:00:00,2020-08-17 00:00:00,LABORABLE
17,8,2020,10,462,561,1023,2020-08-17 09:00:00,2020-08-17 00:00:00,LABORABLE
17,8,2020,11,462,582,1044,2020-08-17 10:00:00,2020-08-17 00:00:00,LABORABLE
17,8,2020,12,479,620,1099,2020-08-17 11:00:00,2020-08-17 00:00:00,LABORABLE
17,8,2020,13,522,685,1207,2020-08-17 12:00:00,2020-08-17 00:00:00,LABORABLE
17,8,2020,14,534,657,1191,2020-08-17 13:00:00,2020-08-17 00:00:00,LABORABLE
17,8,2020,15,514,629,1143,2020-08-17 14:00:00,2020-08-17 00:00:00,LABORABLE
17,8,2020,16,460,554,1014,2020-08-17 15:00:00,2020-08-17 00:00:00,LABORABLE
17,8,2020,17,422,639,1061,2020-08-17 16:00:00,2020-08-17 00:00:00,LABORABLE
17,8,2020,18,509,563,1072,2020-08-17 17:00:00,2020-08-17 00:00:00,LABORABLE
17,8,2020,19,570,741,1311,2020-08-17 18:00:00,2020-08-17 00:00:00,LABORABLE
17,8,2020,20,533,745,1278,2020-08-17 19:00:00,2020-08-17 00:00:00,LABORABLE
17,8,2020,21,478,677,1155,2020-08-17 20:00:00,2020-08-17 00:00:00,LABORABLE
17,8,2020,22,424,537,961,2020-08-17 21:00:00,2020-08-17 00:00:00,LABORABLE
17,8,2020,23,344,407,751,2020-08-17 22:00:00,2020-08-17 00:00:00,LABORABLE
17,8,2020,24,248,301,549,2020-08-17 23:00:00,2020-08-17 00:00:00,LABORABLE
18,8,2020,1,144,220,364,2020-08-18 00:00:00,2020-08-18 00:00:00,LABORABLE
18,8,2020,2,105,149,254,2020-08-18 01:00:00,2020-08-18 00:00:00,LABORABLE
18,8,2020,3,67,102,169,2020-08-18 02:00:00,2020-08-18 00:00:00,LABORABLE
18,8,2020,4,54,81,135,2020-08-18 03:00:00,2020-08-18 00:00:00,LABORABLE
18,8,2020,5,61,75,136,2020-08-18 04:00:00,2020-08-18 00:00:00,LABORABLE
18,8,2020,6,126,112,238,2020-08-18 05:00:00,2020-08-18 00:00:00,LABORABLE
18,8,2020,7,327,273,600,2020-08-18 06:00:00,2020-08-18 00:00:00,LABORABLE
18,8,2020,8,481,494,975,2020-08-18 07:00:00,2020-08-18 00:00:00,LABORABLE
18,8,2020,9,444,544,988,2020-08-18 08:00:00,2020-08-18 00:00:00,LABORABLE
18,8,2020,10,484,558,1042,2020-08-18 09:00:00,2020-08-18 00:00:00,LABORABLE
18,8,2020,11,491,588,1079,2020-08-18 10:00:00,2020-08-18 00:00:00,LABORABLE
18,8,2020,12,393,528,921,2020-08-18 11:00:00,2020-08-18 00:00:00,LABORABLE
18,8,2020,13,550,681,1231,2020-08-18 12:00:00,2020-08-18 00:00:00,LABORABLE
18,8,2020,14,535,674,1209,2020-08-18 13:00:00,2020-08-18 00:00:00,LABORABLE
18,8,2020,15,540,661,1201,2020-08-18 14:00:00,2020-08-18 00:00:00,LABORABLE
18,8,2020,16,470,592,1062,2020-08-18 15:00:00,2020-08-18 00:00:00,LABORABLE
18,8,2020,17,378,584,962,2020-08-18 16:00:00,2020-08-18 00:00:00,LABORABLE
18,8,2020,18,489,644,1133,2020-08-18 17:00:00,2020-08-18 00:00:00,LABORABLE
18,8,2020,19,560,734,1294,2020-08-18 18:00:00,2020-08-18 00:00:00,LABORABLE
18,8,2020,20,520,690,1210,2020-08-18 19:00:00,2020-08-18 00:00:00,LABORABLE
18,8,2020,21,482,677,1159,2020-08-18 20:00:00,2020-08-18 00:00:00,LABORABLE
18,8,2020,22,393,506,899,2020-08-18 21:00:00,2020-08-18 00:00:00,LABORABLE
18,8,2020,23,319,367,686,2020-08-18 22:00:00,2020-08-18 00:00:00,LABORABLE
18,8,2020,24,255,310,565,2020-08-18 23:00:00,2020-08-18 00:00:00,LABORABLE
19,8,2020,1,165,203,368,2020-08-19 00:00:00,2020-08-19 00:00:00,LABORABLE
19,8,2020,2,126,148,274,2020-08-19 01:00:00,2020-08-19 00:00:00,LABORABLE
19,8,2020,3,76,128,204,2020-08-19 02:00:00,2020-08-19 00:00:00,LABORABLE
19,8,2020,4,56,68,124,2020-08-19 03:00:00,2020-08-19 00:00:00,LABORABLE
19,8,2020,5,59,83,142,2020-08-19 04:00:00,2020-08-19 00:00:00,LABORABLE
19,8,2020,6,119,137,256,2020-08-19 05:00:00,2020-08-19 00:00:00,LABORABLE
19,8,2020,7,329,265,594,2020-08-19 06:00:00,2020-08-19 00:00:00,LABORABLE
19,8,2020,8,464,418,882,2020-08-19 07:00:00,2020-08-19 00:00:00,LABORABLE
19,8,2020,9,488,487,975,2020-08-19 08:00:00,2020-08-19 00:00:00,LABORABLE
19,8,2020,10,462,527,989,2020-08-19 09:00:00,2020-08-19 00:00:00,LABORABLE
19,8,2020,11,470,563,1033,2020-08-19 10:00:00,2020-08-19 00:00:00,LABORABLE
19,8,2020,12,533,635,1168,2020-08-19 11:00:00,2020-08-19 00:00:00,LABORABLE
19,8,2020,13,497,689,1186,2020-08-19 12:00:00,2020-08-19 00:00:00,LABORABLE
19,8,2020,14,517,607,1124,2020-08-19 13:00:00,2020-08-19 00:00:00,LABORABLE
19,8,2020,15,528,623,1151,2020-08-19 14:00:00,2020-08-19 00:00:00,LABORABLE
19,8,2020,16,437,524,961,2020-08-19 15:00:00,2020-08-19 00:00:00,LABORABLE
19,8,2020,17,427,543,970,2020-08-19 16:00:00,2020-08-19 00:00:00,LABORABLE
19,8,2020,18,506,633,1139,2020-08-19 17:00:00,2020-08-19 00:00:00,LABORABLE
19,8,2020,19,533,648,1181,2020-08-19 18:00:00,2020-08-19 00:00:00,LABORABLE
19,8,2020,20,589,699,1288,2020-08-19 19:00:00,2020-08-19 00:00:00,LABORABLE
19,8,2020,21,499,659,1158,2020-08-19 20:00:00,2020-08-19 00:00:00,LABORABLE
19,8,2020,22,414,527,941,2020-08-19 21:00:00,2020-08-19 00:00:00,LABORABLE
19,8,2020,23,333,410,743,2020-08-19 22:00:00,2020-08-19 00:00:00,LABORABLE
19,8,2020,24,288,298,586,2020-08-19 23:00:00,2020-08-19 00:00:00,LABORABLE
20,8,2020,1,166,219,385,2020-08-20 00:00:00,2020-08-20 00:00:00,LABORABLE
20,8,2020,2,125,151,276,2020-08-20 01:00:00,2020-08-20 00:00:00,LABORABLE
20,8,2020,3,76,148,224,2020-08-20 02:00:00,2020-08-20 00:00:00,LABORABLE
20,8,2020,4,52,78,130,2020-08-20 03:00:00,2020-08-20 00:00:00,LABORABLE
20,8,2020,5,0,70,70,2020-08-20 04:00:00,2020-08-20 00:00:00,LABORABLE
20,8,2020,6,0,124,124,2020-08-20 05:00:00,2020-08-20 00:00:00,LABORABLE
20,8,2020,7,0,272,272,2020-08-20 06:00:00,2020-08-20 00:00:00,LABORABLE
20,8,2020,8,155,486,641,2020-08-20 07:00:00,2020-08-20 00:00:00,LABORABLE
20,8,2020,9,442,474,916,2020-08-20 08:00:00,2020-08-20 00:00:00,LABORABLE
20,8,2020,10,510,542,1052,2020-08-20 09:00:00,2020-08-20 00:00:00,LABORABLE
20,8,2020,11,472,581,1053,2020-08-20 10:00:00,2020-08-20 00:00:00,LABORABLE
20,8,2020,12,523,654,1177,2020-08-20 11:00:00,2020-08-20 00:00:00,LABORABLE
20,8,2020,13,526,683,1209,2020-08-20 12:00:00,2020-08-20 00:00:00,LABORABLE
20,8,2020,14,537,631,1168,2020-08-20 13:00:00,2020-08-20 00:00:00,LABORABLE
20,8,2020,15,513,648,1161,2020-08-20 14:00:00,2020-08-20 00:00:00,LABORABLE
20,8,2020,16,430,564,994,2020-08-20 15:00:00,2020-08-20 00:00:00,LABORABLE
20,8,2020,17,442,596,1038,2020-08-20 16:00:00,2020-08-20 00:00:00,LABORABLE
20,8,2020,18,486,625,1111,2020-08-20 17:00:00,2020-08-20 00:00:00,LABORABLE
20,8,2020,19,550,719,1269,2020-08-20 18:00:00,2020-08-20 00:00:00,LABORABLE
20,8,2020,20,583,718,1301,2020-08-20 19:00:00,2020-08-20 00:00:00,LABORABLE
20,8,2020,21,498,664,1162,2020-08-20 20:00:00,2020-08-20 00:00:00,LABORABLE
20,8,2020,22,398,514,912,2020-08-20 21:00:00,2020-08-20 00:00:00,LABORABLE
20,8,2020,23,359,432,791,2020-08-20 22:00:00,2020-08-20 00:00:00,LABORABLE
20,8,2020,24,269,314,583,2020-08-20 23:00:00,2020-08-20 00:00:00,LABORABLE
21,8,2020,1,189,259,448,2020-08-21 00:00:00,2020-08-21 00:00:00,LABORABLE
21,8,2020,2,102,178,280,2020-08-21 01:00:00,2020-08-21 00:00:00,LABORABLE
21,8,2020,3,88,124,212,2020-08-21 02:00:00,2020-08-21 00:00:00,LABORABLE
21,8,2020,4,66,79,145,2020-08-21 03:00:00,2020-08-21 00:00:00,LABORABLE
21,8,2020,5,68,79,147,2020-08-21 04:00:00,2020-08-21 00:00:00,LABORABLE
21,8,2020,6,116,108,224,2020-08-21 05:00:00,2020-08-21 00:00:00,LABORABLE
21,8,2020,7,316,268,584,2020-08-21 06:00:00,2020-08-21 00:00:00,LABORABLE
21,8,2020,8,502,434,936,2020-08-21 07:00:00,2020-08-21 00:00:00,LABORABLE
21,8,2020,9,437,489,926,2020-08-21 08:00:00,2020-08-21 00:00:00,LABORABLE
21,8,2020,10,463,568,1031,2020-08-21 09:00:00,2020-08-21 00:00:00,LABORABLE
21,8,2020,11,491,593,1084,2020-08-21 10:00:00,2020-08-21 00:00:00,LABORABLE
21,8,2020,12,466,627,1093,2020-08-21 11:00:00,2020-08-21 00:00:00,LABORABLE
21,8,2020,13,538,658,1196,2020-08-21 12:00:00,2020-08-21 00:00:00,LABORABLE
21,8,2020,14,523,671,1194,2020-08-21 13:00:00,2020-08-21 00:00:00,LABORABLE
21,8,2020,15,528,661,1189,2020-08-21 14:00:00,2020-08-21 00:00:00,LABORABLE
21,8,2020,16,433,604,1037,2020-08-21 15:00:00,2020-08-21 00:00:00,LABORABLE
21,8,2020,17,459,638,1097,2020-08-21 16:00:00,2020-08-21 00:00:00,LABORABLE
21,8,2020,18,506,636,1142,2020-08-21 17:00:00,2020-08-21 00:00:00,LABORABLE
21,8,2020,19,581,716,1297,2020-08-21 18:00:00,2020-08-21 00:00:00,LABORABLE
21,8,2020,20,552,720,1272,2020-08-21 19:00:00,2020-08-21 00:00:00,LABORABLE
21,8,2020,21,532,730,1262,2020-08-21 20:00:00,2020-08-21 00:00:00,LABORABLE
21,8,2020,22,450,618,1068,2020-08-21 21:00:00,2020-08-21 00:00:00,LABORABLE
21,8,2020,23,367,502,869,2020-08-21 22:00:00,2020-08-21 00:00:00,LABORABLE
21,8,2020,24,296,386,682,2020-08-21 23:00:00,2020-08-21 00:00:00,LABORABLE
22,8,2020,1,268,297,565,2020-08-22 00:00:00,2020-08-22 00:00:00,LABORABLE
22,8,2020,2,215,254,469,2020-08-22 01:00:00,2020-08-22 00:00:00,LABORABLE
22,8,2020,3,146,198,344,2020-08-22 02:00:00,2020-08-22 00:00:00,LABORABLE
22,8,2020,4,92,113,205,2020-08-22 03:00:00,2020-08-22 00:00:00,LABORABLE
22,8,2020,5,95,102,197,2020-08-22 04:00:00,2020-08-22 00:00:00,LABORABLE
22,8,2020,6,100,133,233,2020-08-22 05:00:00,2020-08-22 00:00:00,LABORABLE
22,8,2020,7,141,164,305,2020-08-22 06:00:00,2020-08-22 00:00:00,LABORABLE
22,8,2020,8,248,250,498,2020-08-22 07:00:00,2020-08-22 00:00:00,LABORABLE
22,8,2020,9,304,329,633,2020-08-22 08:00:00,2020-08-22 00:00:00,LABORABLE
22,8,2020,10,364,419,783,2020-08-22 09:00:00,2020-08-22 00:00:00,LABORABLE
22,8,2020,11,400,538,938,2020-08-22 10:00:00,2020-08-22 00:00:00,LABORABLE
22,8,2020,12,511,642,1153,2020-08-22 11:00:00,2020-08-22 00:00:00,LABORABLE
22,8,2020,13,545,646,1191,2020-08-22 12:00:00,2020-08-22 00:00:00,LABORABLE
22,8,2020,14,469,670,1139,2020-08-22 13:00:00,2020-08-22 00:00:00,LABORABLE
22,8,2020,15,474,614,1088,2020-08-22 14:00:00,2020-08-22 00:00:00,LABORABLE
22,8,2020,16,376,521,897,2020-08-22 15:00:00,2020-08-22 00:00:00,LABORABLE
22,8,2020,17,347,547,894,2020-08-22 16:00:00,2020-08-22 00:00:00,LABORABLE
22,8,2020,18,403,550,953,2020-08-22 17:00:00,2020-08-22 00:00:00,LABORABLE
22,8,2020,19,457,583,1040,2020-08-22 18:00:00,2020-08-22 00:00:00,LABORABLE
22,8,2020,20,467,684,1151,2020-08-22 19:00:00,2020-08-22 00:00:00,LABORABLE
22,8,2020,21,418,692,1110,2020-08-22 20:00:00,2020-08-22 00:00:00,LABORABLE
22,8,2020,22,465,575,1040,2020-08-22 21:00:00,2020-08-22 00:00:00,LABORABLE
22,8,2020,23,382,449,831,2020-08-22 22:00:00,2020-08-22 00:00:00,LABORABLE
22,8,2020,24,306,422,728,2020-08-22 23:00:00,2020-08-22 00:00:00,LABORABLE
23,8,2020,1,246,333,579,2020-08-23 00:00:00,2020-08-23 00:00:00,LABORABLE
23,8,2020,2,221,298,519,2020-08-23 01:00:00,2020-08-23 00:00:00,LABORABLE
23,8,2020,3,173,246,419,2020-08-23 02:00:00,2020-08-23 00:00:00,LABORABLE
23,8,2020,4,112,183,295,2020-08-23 03:00:00,2020-08-23 00:00:00,LABORABLE
23,8,2020,5,82,115,197,2020-08-23 04:00:00,2020-08-23 00:00:00,LABORABLE
23,8,2020,6,81,109,190,2020-08-23 05:00:00,2020-08-23 00:00:00,LABORABLE
23,8,2020,7,81,133,214,2020-08-23 06:00:00,2020-08-23 00:00:00,LABORABLE
23,8,2020,8,126,121,247,2020-08-23 07:00:00,2020-08-23 00:00:00,LABORABLE
23,8,2020,9,165,221,386,2020-08-23 08:00:00,2020-08-23 00:00:00,LABORABLE
23,8,2020,10,262,319,581,2020-08-23 09:00:00,2020-08-23 00:00:00,LABORABLE
23,8,2020,11,346,411,757,2020-08-23 10:00:00,2020-08-23 00:00:00,LABORABLE
23,8,2020,12,395,481,876,2020-08-23 11:00:00,2020-08-23 00:00:00,LABORABLE
23,8,2020,13,407,523,930,2020-08-23 12:00:00,2020-08-23 00:00:00,LABORABLE
23,8,2020,14,394,577,971,2020-08-23 13:00:00,2020-08-23 00:00:00,LABORABLE
23,8,2020,15,423,557,980,2020-08-23 14:00:00,2020-08-23 00:00:00,LABORABLE
23,8,2020,16,305,518,823,2020-08-23 15:00:00,2020-08-23 00:00:00,LABORABLE
23,8,2020,17,292,438,730,2020-08-23 16:00:00,2020-08-23 00:00:00,LABORABLE
23,8,2020,18,348,504,852,2020-08-23 17:00:00,2020-08-23 00:00:00,LABORABLE
23,8,2020,19,385,516,901,2020-08-23 18:00:00,2020-08-23 00:00:00,LABORABLE
23,8,2020,20,441,544,985,2020-08-23 19:00:00,2020-08-23 00:00:00,LABORABLE
23,8,2020,21,446,574,1020,2020-08-23 20:00:00,2020-08-23 00:00:00,LABORABLE
23,8,2020,22,409,512,921,2020-08-23 21:00:00,2020-08-23 00:00:00,LABORABLE
23,8,2020,23,336,440,776,2020-08-23 22:00:00,2020-08-23 00:00:00,LABORABLE
23,8,2020,24,294,381,675,2020-08-23 23:00:00,2020-08-23 00:00:00,LABORABLE
24,8,2020,1,221,253,474,2020-08-24 00:00:00,2020-08-24 00:00:00,LABORABLE
24,8,2020,2,162,202,364,2020-08-24 01:00:00,2020-08-24 00:00:00,LABORABLE
24,8,2020,3,111,177,288,2020-08-24 02:00:00,2020-08-24 00:00:00,LABORABLE
24,8,2020,4,58,84,142,2020-08-24 03:00:00,2020-08-24 00:00:00,LABORABLE
24,8,2020,5,77,88,165,2020-08-24 04:00:00,2020-08-24 00:00:00,LABORABLE
24,8,2020,6,128,126,254,2020-08-24 05:00:00,2020-08-24 00:00:00,LABORABLE
24,8,2020,7,331,240,571,2020-08-24 06:00:00,2020-08-24 00:00:00,LABORABLE
24,8,2020,8,498,470,968,2020-08-24 07:00:00,2020-08-24 00:00:00,LABORABLE
24,8,2020,9,490,577,1067,2020-08-24 08:00:00,2020-08-24 00:00:00,LABORABLE
24,8,2020,10,473,609,1082,2020-08-24 09:00:00,2020-08-24 00:00:00,LABORABLE
24,8,2020,11,448,653,1101,2020-08-24 10:00:00,2020-08-24 00:00:00,LABORABLE
24,8,2020,12,490,654,1144,2020-08-24 11:00:00,2020-08-24 00:00:00,LABORABLE
24,8,2020,13,529,684,1213,2020-08-24 12:00:00,2020-08-24 00:00:00,LABORABLE
24,8,2020,14,433,601,1034,2020-08-24 13:00:00,2020-08-24 00:00:00,LABORABLE
24,8,2020,15,501,607,1108,2020-08-24 14:00:00,2020-08-24 00:00:00,LABORABLE
24,8,2020,16,480,494,974,2020-08-24 15:00:00,2020-08-24 00:00:00,LABORABLE
24,8,2020,17,422,518,940,2020-08-24 16:00:00,2020-08-24 00:00:00,LABORABLE
24,8,2020,18,486,606,1092,2020-08-24 17:00:00,2020-08-24 00:00:00,LABORABLE
24,8,2020,19,593,693,1286,2020-08-24 18:00:00,2020-08-24 00:00:00,LABORABLE
24,8,2020,20,558,736,1294,2020-08-24 19:00:00,2020-08-24 00:00:00,LABORABLE
24,8,2020,21,504,712,1216,2020-08-24 20:00:00,2020-08-24 00:00:00,LABORABLE
24,8,2020,22,433,542,975,2020-08-24 21:00:00,2020-08-24 00:00:00,LABORABLE
24,8,2020,23,345,398,743,2020-08-24 22:00:00,2020-08-24 00:00:00,LABORABLE
24,8,2020,24,212,303,515,2020-08-24 23:00:00,2020-08-24 00:00:00,LABORABLE
25,8,2020,1,138,224,362,2020-08-25 00:00:00,2020-08-25 00:00:00,LABORABLE
25,8,2020,2,94,121,215,2020-08-25 01:00:00,2020-08-25 00:00:00,LABORABLE
25,8,2020,3,71,108,179,2020-08-25 02:00:00,2020-08-25 00:00:00,LABORABLE
25,8,2020,4,51,83,134,2020-08-25 03:00:00,2020-08-25 00:00:00,LABORABLE
25,8,2020,5,61,87,148,2020-08-25 04:00:00,2020-08-25 00:00:00,LABORABLE
25,8,2020,6,139,114,253,2020-08-25 05:00:00,2020-08-25 00:00:00,LABORABLE
25,8,2020,7,334,265,599,2020-08-25 06:00:00,2020-08-25 00:00:00,LABORABLE
25,8,2020,8,473,479,952,2020-08-25 07:00:00,2020-08-25 00:00:00,LABORABLE
25,8,2020,9,490,580,1070,2020-08-25 08:00:00,2020-08-25 00:00:00,LABORABLE
25,8,2020,10,477,588,1065,2020-08-25 09:00:00,2020-08-25 00:00:00,LABORABLE
25,8,2020,11,478,560,1038,2020-08-25 10:00:00,2020-08-25 00:00:00,LABORABLE
25,8,2020,12,529,671,1200,2020-08-25 11:00:00,2020-08-25 00:00:00,LABORABLE
25,8,2020,13,567,709,1276,2020-08-25 12:00:00,2020-08-25 00:00:00,LABORABLE
25,8,2020,14,543,671,1214,2020-08-25 13:00:00,2020-08-25 00:00:00,LABORABLE
25,8,2020,15,525,612,1137,2020-08-25 14:00:00,2020-08-25 00:00:00,LABORABLE
25,8,2020,16,482,574,1056,2020-08-25 15:00:00,2020-08-25 00:00:00,LABORABLE
25,8,2020,17,449,629,1078,2020-08-25 16:00:00,2020-08-25 00:00:00,LABORABLE
25,8,2020,18,473,686,1159,2020-08-25 17:00:00,2020-08-25 00:00:00,LABORABLE
25,8,2020,19,544,709,1253,2020-08-25 18:00:00,2020-08-25 00:00:00,LABORABLE
25,8,2020,20,553,727,1280,2020-08-25 19:00:00,2020-08-25 00:00:00,LABORABLE
25,8,2020,21,500,665,1165,2020-08-25 20:00:00,2020-08-25 00:00:00,LABORABLE
25,8,2020,22,424,547,971,2020-08-25 21:00:00,2020-08-25 00:00:00,LABORABLE
25,8,2020,23,325,392,717,2020-08-25 22:00:00,2020-08-25 00:00:00,LABORABLE
25,8,2020,24,246,329,575,2020-08-25 23:00:00,2020-08-25 00:00:00,LABORABLE
26,8,2020,1,167,217,384,2020-08-26 00:00:00,2020-08-26 00:00:00,LABORABLE
26,8,2020,2,137,141,278,2020-08-26 01:00:00,2020-08-26 00:00:00,LABORABLE
26,8,2020,3,87,95,182,2020-08-26 02:00:00,2020-08-26 00:00:00,LABORABLE
26,8,2020,4,61,60,121,2020-08-26 03:00:00,2020-08-26 00:00:00,LABORABLE
26,8,2020,5,56,64,120,2020-08-26 04:00:00,2020-08-26 00:00:00,LABORABLE
26,8,2020,6,132,134,266,2020-08-26 05:00:00,2020-08-26 00:00:00,LABORABLE
26,8,2020,7,340,273,613,2020-08-26 06:00:00,2020-08-26 00:00:00,LABORABLE
26,8,2020,8,471,456,927,2020-08-26 07:00:00,2020-08-26 00:00:00,LABORABLE
26,8,2020,9,472,551,1023,2020-08-26 08:00:00,2020-08-26 00:00:00,LABORABLE
26,8,2020,10,510,614,1124,2020-08-26 09:00:00,2020-08-26 00:00:00,LABORABLE
26,8,2020,11,345,453,798,2020-08-26 10:00:00,2020-08-26 00:00:00,LABORABLE
26,8,2020,12,507,675,1182,2020-08-26 11:00:00,2020-08-26 00:00:00,LABORABLE
26,8,2020,13,567,698,1265,2020-08-26 12:00:00,2020-08-26 00:00:00,LABORABLE
26,8,2020,14,544,659,1203,2020-08-26 13:00:00,2020-08-26 00:00:00,LABORABLE
26,8,2020,15,499,681,1180,2020-08-26 14:00:00,2020-08-26 00:00:00,LABORABLE
26,8,2020,16,481,620,1101,2020-08-26 15:00:00,2020-08-26 00:00:00,LABORABLE
26,8,2020,17,471,619,1090,2020-08-26 16:00:00,2020-08-26 00:00:00,LABORABLE
26,8,2020,18,494,629,1123,2020-08-26 17:00:00,2020-08-26 00:00:00,LABORABLE
26,8,2020,19,559,693,1252,2020-08-26 18:00:00,2020-08-26 00:00:00,LABORABLE
26,8,2020,20,534,691,1225,2020-08-26 19:00:00,2020-08-26 00:00:00,LABORABLE
26,8,2020,21,553,660,1213,2020-08-26 20:00:00,2020-08-26 00:00:00,LABORABLE
26,8,2020,22,438,526,964,2020-08-26 21:00:00,2020-08-26 00:00:00,LABORABLE
26,8,2020,23,342,388,730,2020-08-26 22:00:00,2020-08-26 00:00:00,LABORABLE
26,8,2020,24,269,266,535,2020-08-26 23:00:00,2020-08-26 00:00:00,LABORABLE
27,8,2020,1,177,210,387,2020-08-27 00:00:00,2020-08-27 00:00:00,LABORABLE
27,8,2020,2,142,158,300,2020-08-27 01:00:00,2020-08-27 00:00:00,LABORABLE
27,8,2020,3,84,131,215,2020-08-27 02:00:00,2020-08-27 00:00:00,LABORABLE
27,8,2020,4,60,81,141,2020-08-27 03:00:00,2020-08-27 00:00:00,LABORABLE
27,8,2020,5,79,70,149,2020-08-27 04:00:00,2020-08-27 00:00:00,LABORABLE
27,8,2020,6,137,124,261,2020-08-27 05:00:00,2020-08-27 00:00:00,LABORABLE
27,8,2020,7,310,272,582,2020-08-27 06:00:00,2020-08-27 00:00:00,LABORABLE
27,8,2020,8,537,486,1023,2020-08-27 07:00:00,2020-08-27 00:00:00,LABORABLE
27,8,2020,9,483,518,1001,2020-08-27 08:00:00,2020-08-27 00:00:00,LABORABLE
27,8,2020,10,456,621,1077,2020-08-27 09:00:00,2020-08-27 00:00:00,LABORABLE
27,8,2020,11,424,641,1065,2020-08-27 10:00:00,2020-08-27 00:00:00,LABORABLE
27,8,2020,12,520,703,1223,2020-08-27 11:00:00,2020-08-27 00:00:00,LABORABLE
27,8,2020,13,558,700,1258,2020-08-27 12:00:00,2020-08-27 00:00:00,LABORABLE
27,8,2020,14,562,733,1295,2020-08-27 13:00:00,2020-08-27 00:00:00,LABORABLE
27,8,2020,15,561,660,1221,2020-08-27 14:00:00,2020-08-27 00:00:00,LABORABLE
27,8,2020,16,484,578,1062,2020-08-27 15:00:00,2020-08-27 00:00:00,LABORABLE
27,8,2020,17,421,585,1006,2020-08-27 16:00:00,2020-08-27 00:00:00,LABORABLE
27,8,2020,18,497,644,1141,2020-08-27 17:00:00,2020-08-27 00:00:00,LABORABLE
27,8,2020,19,551,763,1314,2020-08-27 18:00:00,2020-08-27 00:00:00,LABORABLE
27,8,2020,20,550,676,1226,2020-08-27 19:00:00,2020-08-27 00:00:00,LABORABLE
27,8,2020,21,542,706,1248,2020-08-27 20:00:00,2020-08-27 00:00:00,LABORABLE
27,8,2020,22,450,608,1058,2020-08-27 21:00:00,2020-08-27 00:00:00,LABORABLE
27,8,2020,23,380,474,854,2020-08-27 22:00:00,2020-08-27 00:00:00,LABORABLE
27,8,2020,24,258,303,561,2020-08-27 23:00:00,2020-08-27 00:00:00,LABORABLE
28,8,2020,1,173,274,447,2020-08-28 00:00:00,2020-08-28 00:00:00,LABORABLE
28,8,2020,2,146,190,336,2020-08-28 01:00:00,2020-08-28 00:00:00,LABORABLE
28,8,2020,3,89,153,242,2020-08-28 02:00:00,2020-08-28 00:00:00,LABORABLE
28,8,2020,4,71,82,153,2020-08-28 03:00:00,2020-08-28 00:00:00,LABORABLE
28,8,2020,5,68,75,143,2020-08-28 04:00:00,2020-08-28 00:00:00,LABORABLE
28,8,2020,6,134,122,256,2020-08-28 05:00:00,2020-08-28 00:00:00,LABORABLE
28,8,2020,7,345,286,631,2020-08-28 06:00:00,2020-08-28 00:00:00,LABORABLE
28,8,2020,8,495,452,947,2020-08-28 07:00:00,2020-08-28 00:00:00,LABORABLE
28,8,2020,9,464,589,1053,2020-08-28 08:00:00,2020-08-28 00:00:00,LABORABLE
28,8,2020,10,465,654,1119,2020-08-28 09:00:00,2020-08-28 00:00:00,LABORABLE
28,8,2020,11,499,677,1176,2020-08-28 10:00:00,2020-08-28 00:00:00,LABORABLE
28,8,2020,12,537,625,1162,2020-08-28 11:00:00,2020-08-28 00:00:00,LABORABLE
28,8,2020,13,605,750,1355,2020-08-28 12:00:00,2020-08-28 00:00:00,LABORABLE
28,8,2020,14,558,779,1337,2020-08-28 13:00:00,2020-08-28 00:00:00,LABORABLE
28,8,2020,15,533,721,1254,2020-08-28 14:00:00,2020-08-28 00:00:00,LABORABLE
28,8,2020,16,491,613,1104,2020-08-28 15:00:00,2020-08-28 00:00:00,LABORABLE
28,8,2020,17,497,603,1100,2020-08-28 16:00:00,2020-08-28 00:00:00,LABORABLE
28,8,2020,18,544,708,1252,2020-08-28 17:00:00,2020-08-28 00:00:00,LABORABLE
28,8,2020,19,590,713,1303,2020-08-28 18:00:00,2020-08-28 00:00:00,LABORABLE
28,8,2020,20,631,701,1332,2020-08-28 19:00:00,2020-08-28 00:00:00,LABORABLE
28,8,2020,21,526,779,1305,2020-08-28 20:00:00,2020-08-28 00:00:00,LABORABLE
28,8,2020,22,548,715,1263,2020-08-28 21:00:00,2020-08-28 00:00:00,LABORABLE
28,8,2020,23,460,478,938,2020-08-28 22:00:00,2020-08-28 00:00:00,LABORABLE
28,8,2020,24,317,379,696,2020-08-28 23:00:00,2020-08-28 00:00:00,LABORABLE
29,8,2020,1,260,299,559,2020-08-29 00:00:00,2020-08-29 00:00:00,LABORABLE
29,8,2020,2,221,246,467,2020-08-29 01:00:00,2020-08-29 00:00:00,LABORABLE
29,8,2020,3,146,208,354,2020-08-29 02:00:00,2020-08-29 00:00:00,LABORABLE
29,8,2020,4,107,120,227,2020-08-29 03:00:00,2020-08-29 00:00:00,LABORABLE
29,8,2020,5,96,112,208,2020-08-29 04:00:00,2020-08-29 00:00:00,LABORABLE
29,8,2020,6,101,113,214,2020-08-29 05:00:00,2020-08-29 00:00:00,LABORABLE
29,8,2020,7,143,158,301,2020-08-29 06:00:00,2020-08-29 00:00:00,LABORABLE
29,8,2020,8,235,219,454,2020-08-29 07:00:00,2020-08-29 00:00:00,LABORABLE
29,8,2020,9,299,355,654,2020-08-29 08:00:00,2020-08-29 00:00:00,LABORABLE
29,8,2020,10,343,472,815,2020-08-29 09:00:00,2020-08-29 00:00:00,LABORABLE
29,8,2020,11,422,557,979,2020-08-29 10:00:00,2020-08-29 00:00:00,LABORABLE
29,8,2020,12,513,638,1151,2020-08-29 11:00:00,2020-08-29 00:00:00,LABORABLE
29,8,2020,13,560,727,1287,2020-08-29 12:00:00,2020-08-29 00:00:00,LABORABLE
29,8,2020,14,560,690,1250,2020-08-29 13:00:00,2020-08-29 00:00:00,LABORABLE
29,8,2020,15,547,647,1194,2020-08-29 14:00:00,2020-08-29 00:00:00,LABORABLE
29,8,2020,16,401,571,972,2020-08-29 15:00:00,2020-08-29 00:00:00,LABORABLE
29,8,2020,17,395,571,966,2020-08-29 16:00:00,2020-08-29 00:00:00,LABORABLE
29,8,2020,18,452,657,1109,2020-08-29 17:00:00,2020-08-29 00:00:00,LABORABLE
29,8,2020,19,532,657,1189,2020-08-29 18:00:00,2020-08-29 00:00:00,LABORABLE
29,8,2020,20,534,727,1261,2020-08-29 19:00:00,2020-08-29 00:00:00,LABORABLE
29,8,2020,21,489,649,1138,2020-08-29 20:00:00,2020-08-29 00:00:00,LABORABLE
29,8,2020,22,484,607,1091,2020-08-29 21:00:00,2020-08-29 00:00:00,LABORABLE
29,8,2020,23,395,508,903,2020-08-29 22:00:00,2020-08-29 00:00:00,LABORABLE
29,8,2020,24,331,442,773,2020-08-29 23:00:00,2020-08-29 00:00:00,LABORABLE
30,8,2020,1,319,361,680,2020-08-30 00:00:00,2020-08-30 00:00:00,LABORABLE
30,8,2020,2,270,327,597,2020-08-30 01:00:00,2020-08-30 00:00:00,LABORABLE
30,8,2020,3,153,202,355,2020-08-30 02:00:00,2020-08-30 00:00:00,LABORABLE
30,8,2020,4,99,141,240,2020-08-30 03:00:00,2020-08-30 00:00:00,LABORABLE
30,8,2020,5,66,116,182,2020-08-30 04:00:00,2020-08-30 00:00:00,LABORABLE
30,8,2020,6,70,78,148,2020-08-30 05:00:00,2020-08-30 00:00:00,LABORABLE
30,8,2020,7,95,104,199,2020-08-30 06:00:00,2020-08-30 00:00:00,LABORABLE
30,8,2020,8,103,127,230,2020-08-30 07:00:00,2020-08-30 00:00:00,LABORABLE
30,8,2020,9,179,228,407,2020-08-30 08:00:00,2020-08-30 00:00:00,LABORABLE
30,8,2020,10,250,359,609,2020-08-30 09:00:00,2020-08-30 00:00:00,LABORABLE
30,8,2020,11,318,413,731,2020-08-30 10:00:00,2020-08-30 00:00:00,LABORABLE
30,8,2020,12,442,516,958,2020-08-30 11:00:00,2020-08-30 00:00:00,LABORABLE
30,8,2020,13,488,561,1049,2020-08-30 12:00:00,2020-08-30 00:00:00,LABORABLE
30,8,2020,14,526,646,1172,2020-08-30 13:00:00,2020-08-30 00:00:00,LABORABLE
30,8,2020,15,483,601,1084,2020-08-30 14:00:00,2020-08-30 00:00:00,LABORABLE
30,8,2020,16,377,542,919,2020-08-30 15:00:00,2020-08-30 00:00:00,LABORABLE
30,8,2020,17,370,553,923,2020-08-30 16:00:00,2020-08-30 00:00:00,LABORABLE
30,8,2020,18,427,596,1023,2020-08-30 17:00:00,2020-08-30 00:00:00,LABORABLE
30,8,2020,19,496,576,1072,2020-08-30 18:00:00,2020-08-30 00:00:00,LABORABLE
30,8,2020,20,504,627,1131,2020-08-30 19:00:00,2020-08-30 00:00:00,LABORABLE
30,8,2020,21,452,616,1068,2020-08-30 20:00:00,2020-08-30 00:00:00,LABORABLE
30,8,2020,22,462,567,1029,2020-08-30 21:00:00,2020-08-30 00:00:00,LABORABLE
30,8,2020,23,337,462,799,2020-08-30 22:00:00,2020-08-30 00:00:00,LABORABLE
30,8,2020,24,303,334,637,2020-08-30 23:00:00,2020-08-30 00:00:00,LABORABLE
31,8,2020,1,220,264,484,2020-08-31 00:00:00,2020-08-31 00:00:00,LABORABLE
31,8,2020,2,142,232,374,2020-08-31 01:00:00,2020-08-31 00:00:00,LABORABLE
31,8,2020,3,90,127,217,2020-08-31 02:00:00,2020-08-31 00:00:00,LABORABLE
31,8,2020,4,57,83,140,2020-08-31 03:00:00,2020-08-31 00:00:00,LABORABLE
31,8,2020,5,53,78,131,2020-08-31 04:00:00,2020-08-31 00:00:00,LABORABLE
31,8,2020,6,142,122,264,2020-08-31 05:00:00,2020-08-31 00:00:00,LABORABLE
31,8,2020,7,333,301,634,2020-08-31 06:00:00,2020-08-31 00:00:00,LABORABLE
31,8,2020,8,542,463,1005,2020-08-31 07:00:00,2020-08-31 00:00:00,LABORABLE
31,8,2020,9,505,573,1078,2020-08-31 08:00:00,2020-08-31 00:00:00,LABORABLE
31,8,2020,10,491,572,1063,2020-08-31 09:00:00,2020-08-31 00:00:00,LABORABLE
31,8,2020,11,502,618,1120,2020-08-31 10:00:00,2020-08-31 00:00:00,LABORABLE
31,8,2020,12,523,668,1191,2020-08-31 11:00:00,2020-08-31 00:00:00,LABORABLE
31,8,2020,13,574,774,1348,2020-08-31 12:00:00,2020-08-31 00:00:00,LABORABLE
31,8,2020,14,624,752,1376,2020-08-31 13:00:00,2020-08-31 00:00:00,LABORABLE
31,8,2020,15,591,733,1324,2020-08-31 14:00:00,2020-08-31 00:00:00,LABORABLE
31,8,2020,16,548,645,1193,2020-08-31 15:00:00,2020-08-31 00:00:00,LABORABLE
31,8,2020,17,503,683,1186,2020-08-31 16:00:00,2020-08-31 00:00:00,LABORABLE
31,8,2020,18,592,718,1310,2020-08-31 17:00:00,2020-08-31 00:00:00,LABORABLE
31,8,2020,19,526,570,1096,2020-08-31 18:00:00,2020-08-31 00:00:00,LABORABLE
31,8,2020,20,614,754,1368,2020-08-31 19:00:00,2020-08-31 00:00:00,LABORABLE
31,8,2020,21,588,739,1327,2020-08-31 20:00:00,2020-08-31 00:00:00,LABORABLE
31,8,2020,22,479,571,1050,2020-08-31 21:00:00,2020-08-31 00:00:00,LABORABLE
31,8,2020,23,406,437,843,2020-08-31 22:00:00,2020-08-31 00:00:00,LABORABLE
31,8,2020,24,275,263,538,2020-08-31 23:00:00,2020-08-31 00:00:00,LABORABLE
1,9,2020,1,184,213,397,2020-09-01 00:00:00,2020-01-09 00:00:00,LABORABLE
1,9,2020,2,115,151,266,2020-09-01 01:00:00,2020-01-09 00:00:00,LABORABLE
1,9,2020,3,90,119,209,2020-09-01 02:00:00,2020-01-09 00:00:00,LABORABLE
1,9,2020,4,54,77,131,2020-09-01 03:00:00,2020-01-09 00:00:00,LABORABLE
1,9,2020,5,66,71,137,2020-09-01 04:00:00,2020-01-09 00:00:00,LABORABLE
1,9,2020,6,162,109,271,2020-09-01 05:00:00,2020-01-09 00:00:00,LABORABLE
1,9,2020,7,360,320,680,2020-09-01 06:00:00,2020-01-09 00:00:00,LABORABLE
1,9,2020,8,600,501,1101,2020-09-01 07:00:00,2020-01-09 00:00:00,LABORABLE
1,9,2020,9,624,607,1231,2020-09-01 08:00:00,2020-01-09 00:00:00,LABORABLE
1,9,2020,10,619,653,1272,2020-09-01 09:00:00,2020-01-09 00:00:00,LABORABLE
1,9,2020,11,593,615,1208,2020-09-01 10:00:00,2020-01-09 00:00:00,LABORABLE
1,9,2020,12,617,662,1279,2020-09-01 11:00:00,2020-01-09 00:00:00,LABORABLE
1,9,2020,13,608,694,1302,2020-09-01 12:00:00,2020-01-09 00:00:00,LABORABLE
1,9,2020,14,660,698,1358,2020-09-01 13:00:00,2020-01-09 00:00:00,LABORABLE
1,9,2020,15,638,672,1310,2020-09-01 14:00:00,2020-01-09 00:00:00,LABORABLE
1,9,2020,16,638,583,1221,2020-09-01 15:00:00,2020-01-09 00:00:00,LABORABLE
1,9,2020,17,534,706,1240,2020-09-01 16:00:00,2020-01-09 00:00:00,LABORABLE
1,9,2020,18,613,699,1312,2020-09-01 17:00:00,2020-01-09 00:00:00,LABORABLE
1,9,2020,19,676,779,1455,2020-09-01 18:00:00,2020-01-09 00:00:00,LABORABLE
1,9,2020,20,678,779,1457,2020-09-01 19:00:00,2020-01-09 00:00:00,LABORABLE
1,9,2020,21,590,673,1263,2020-09-01 20:00:00,2020-01-09 00:00:00,LABORABLE
1,9,2020,22,495,564,1059,2020-09-01 21:00:00,2020-01-09 00:00:00,LABORABLE
1,9,2020,23,374,414,788,2020-09-01 22:00:00,2020-01-09 00:00:00,LABORABLE
1,9,2020,24,274,328,602,2020-09-01 23:00:00,2020-01-09 00:00:00,LABORABLE
2,9,2020,1,180,207,387,2020-09-02 00:00:00,2020-02-09 00:00:00,LABORABLE
2,9,2020,2,138,157,295,2020-09-02 01:00:00,2020-02-09 00:00:00,LABORABLE
2,9,2020,3,72,108,180,2020-09-02 02:00:00,2020-02-09 00:00:00,LABORABLE
2,9,2020,4,44,87,131,2020-09-02 03:00:00,2020-02-09 00:00:00,LABORABLE
2,9,2020,5,71,73,144,2020-09-02 04:00:00,2020-02-09 00:00:00,LABORABLE
2,9,2020,6,133,124,257,2020-09-02 05:00:00,2020-02-09 00:00:00,LABORABLE
2,9,2020,7,385,308,693,2020-09-02 06:00:00,2020-02-09 00:00:00,LABORABLE
2,9,2020,8,570,502,1072,2020-09-02 07:00:00,2020-02-09 00:00:00,LABORABLE
2,9,2020,9,593,580,1173,2020-09-02 08:00:00,2020-02-09 00:00:00,LABORABLE
2,9,2020,10,578,612,1190,2020-09-02 09:00:00,2020-02-09 00:00:00,LABORABLE
2,9,2020,11,538,648,1186,2020-09-02 10:00:00,2020-02-09 00:00:00,LABORABLE
2,9,2020,12,559,688,1247,2020-09-02 11:00:00,2020-02-09 00:00:00,LABORABLE
2,9,2020,13,629,676,1305,2020-09-02 12:00:00,2020-02-09 00:00:00,LABORABLE
2,9,2020,14,629,731,1360,2020-09-02 13:00:00,2020-02-09 00:00:00,LABORABLE
2,9,2020,15,612,624,1236,2020-09-02 14:00:00,2020-02-09 00:00:00,LABORABLE
2,9,2020,16,582,615,1197,2020-09-02 15:00:00,2020-02-09 00:00:00,LABORABLE
2,9,2020,17,530,603,1133,2020-09-02 16:00:00,2020-02-09 00:00:00,LABORABLE
2,9,2020,18,590,681,1271,2020-09-02 17:00:00,2020-02-09 00:00:00,LABORABLE
2,9,2020,19,696,727,1423,2020-09-02 18:00:00,2020-02-09 00:00:00,LABORABLE
2,9,2020,20,665,717,1382,2020-09-02 19:00:00,2020-02-09 00:00:00,LABORABLE
2,9,2020,21,642,677,1319,2020-09-02 20:00:00,2020-02-09 00:00:00,LABORABLE
2,9,2020,22,535,549,1084,2020-09-02 21:00:00,2020-02-09 00:00:00,LABORABLE
2,9,2020,23,453,382,835,2020-09-02 22:00:00,2020-02-09 00:00:00,LABORABLE
2,9,2020,24,280,335,615,2020-09-02 23:00:00,2020-02-09 00:00:00,LABORABLE
3,9,2020,1,180,226,406,2020-09-03 00:00:00,2020-03-09 00:00:00,LABORABLE
3,9,2020,2,150,157,307,2020-09-03 01:00:00,2020-03-09 00:00:00,LABORABLE
3,9,2020,3,103,148,251,2020-09-03 02:00:00,2020-03-09 00:00:00,LABORABLE
3,9,2020,4,53,73,126,2020-09-03 03:00:00,2020-03-09 00:00:00,LABORABLE
3,9,2020,5,55,92,147,2020-09-03 04:00:00,2020-03-09 00:00:00,LABORABLE
3,9,2020,6,148,125,273,2020-09-03 05:00:00,2020-03-09 00:00:00,LABORABLE
3,9,2020,7,390,316,706,2020-09-03 06:00:00,2020-03-09 00:00:00,LABORABLE
3,9,2020,8,593,514,1107,2020-09-03 07:00:00,2020-03-09 00:00:00,LABORABLE
3,9,2020,9,640,595,1235,2020-09-03 08:00:00,2020-03-09 00:00:00,LABORABLE
3,9,2020,10,574,646,1220,2020-09-03 09:00:00,2020-03-09 00:00:00,LABORABLE
3,9,2020,11,615,637,1252,2020-09-03 10:00:00,2020-03-09 00:00:00,LABORABLE
3,9,2020,12,585,676,1261,2020-09-03 11:00:00,2020-03-09 00:00:00,LABORABLE
3,9,2020,13,494,580,1074,2020-09-03 12:00:00,2020-03-09 00:00:00,LABORABLE
3,9,2020,14,596,753,1349,2020-09-03 13:00:00,2020-03-09 00:00:00,LABORABLE
3,9,2020,15,645,664,1309,2020-09-03 14:00:00,2020-03-09 00:00:00,LABORABLE
3,9,2020,16,569,537,1106,2020-09-03 15:00:00,2020-03-09 00:00:00,LABORABLE
3,9,2020,17,567,605,1172,2020-09-03 16:00:00,2020-03-09 00:00:00,LABORABLE
3,9,2020,18,618,713,1331,2020-09-03 17:00:00,2020-03-09 00:00:00,LABORABLE
3,9,2020,19,695,757,1452,2020-09-03 18:00:00,2020-03-09 00:00:00,LABORABLE
3,9,2020,20,676,750,1426,2020-09-03 19:00:00,2020-03-09 00:00:00,LABORABLE
3,9,2020,21,622,692,1314,2020-09-03 20:00:00,2020-03-09 00:00:00,LABORABLE
3,9,2020,22,530,582,1112,2020-09-03 21:00:00,2020-03-09 00:00:00,LABORABLE
3,9,2020,23,426,410,836,2020-09-03 22:00:00,2020-03-09 00:00:00,LABORABLE
3,9,2020,24,304,295,599,2020-09-03 23:00:00,2020-03-09 00:00:00,LABORABLE
4,9,2020,1,209,247,456,2020-09-04 00:00:00,2020-04-09 00:00:00,LABORABLE
4,9,2020,2,166,175,341,2020-09-04 01:00:00,2020-04-09 00:00:00,LABORABLE
4,9,2020,3,106,147,253,2020-09-04 02:00:00,2020-04-09 00:00:00,LABORABLE
4,9,2020,4,73,100,173,2020-09-04 03:00:00,2020-04-09 00:00:00,LABORABLE
4,9,2020,5,73,81,154,2020-09-04 04:00:00,2020-04-09 00:00:00,LABORABLE
4,9,2020,6,136,129,265,2020-09-04 05:00:00,2020-04-09 00:00:00,LABORABLE
4,9,2020,7,380,296,676,2020-09-04 06:00:00,2020-04-09 00:00:00,LABORABLE
4,9,2020,8,551,510,1061,2020-09-04 07:00:00,2020-04-09 00:00:00,LABORABLE
4,9,2020,9,610,580,1190,2020-09-04 08:00:00,2020-04-09 00:00:00,LABORABLE
4,9,2020,10,563,621,1184,2020-09-04 09:00:00,2020-04-09 00:00:00,LABORABLE
4,9,2020,11,567,593,1160,2020-09-04 10:00:00,2020-04-09 00:00:00,LABORABLE
4,9,2020,12,612,650,1262,2020-09-04 11:00:00,2020-04-09 00:00:00,LABORABLE
4,9,2020,13,620,698,1318,2020-09-04 12:00:00,2020-04-09 00:00:00,LABORABLE
4,9,2020,14,629,754,1383,2020-09-04 13:00:00,2020-04-09 00:00:00,LABORABLE
4,9,2020,15,648,685,1333,2020-09-04 14:00:00,2020-04-09 00:00:00,LABORABLE
4,9,2020,16,599,605,1204,2020-09-04 15:00:00,2020-04-09 00:00:00,LABORABLE
4,9,2020,17,596,677,1273,2020-09-04 16:00:00,2020-04-09 00:00:00,LABORABLE
4,9,2020,18,633,724,1357,2020-09-04 17:00:00,2020-04-09 00:00:00,LABORABLE
4,9,2020,19,674,722,1396,2020-09-04 18:00:00,2020-04-09 00:00:00,LABORABLE
4,9,2020,20,663,806,1469,2020-09-04 19:00:00,2020-04-09 00:00:00,LABORABLE
4,9,2020,21,666,758,1424,2020-09-04 20:00:00,2020-04-09 00:00:00,LABORABLE
4,9,2020,22,547,660,1207,2020-09-04 21:00:00,2020-04-09 00:00:00,LABORABLE
4,9,2020,23,481,556,1037,2020-09-04 22:00:00,2020-04-09 00:00:00,LABORABLE
4,9,2020,24,338,420,758,2020-09-04 23:00:00,2020-04-09 00:00:00,LABORABLE
5,9,2020,1,608,380,988,2020-09-05 00:00:00,2020-05-09 00:00:00,LABORABLE
5,9,2020,2,540,312,852,2020-09-05 01:00:00,2020-05-09 00:00:00,LABORABLE
5,9,2020,3,357,263,620,2020-09-05 02:00:00,2020-05-09 00:00:00,LABORABLE
5,9,2020,4,207,211,418,2020-09-05 03:00:00,2020-05-09 00:00:00,LABORABLE
5,9,2020,5,142,187,329,2020-09-05 04:00:00,2020-05-09 00:00:00,LABORABLE
5,9,2020,6,129,209,338,2020-09-05 05:00:00,2020-05-09 00:00:00,LABORABLE
5,9,2020,7,166,268,434,2020-09-05 06:00:00,2020-05-09 00:00:00,LABORABLE
5,9,2020,8,277,244,521,2020-09-05 07:00:00,2020-05-09 00:00:00,LABORABLE
5,9,2020,9,305,349,654,2020-09-05 08:00:00,2020-05-09 00:00:00,LABORABLE
5,9,2020,10,465,471,936,2020-09-05 09:00:00,2020-05-09 00:00:00,LABORABLE
5,9,2020,11,604,553,1157,2020-09-05 10:00:00,2020-05-09 00:00:00,LABORABLE
5,9,2020,12,746,730,1476,2020-09-05 11:00:00,2020-05-09 00:00:00,LABORABLE
5,9,2020,13,847,718,1565,2020-09-05 12:00:00,2020-05-09 00:00:00,LABORABLE
5,9,2020,14,941,905,1846,2020-09-05 13:00:00,2020-05-09 00:00:00,LABORABLE
5,9,2020,15,945,1034,1979,2020-09-05 14:00:00,2020-05-09 00:00:00,LABORABLE
5,9,2020,16,780,849,1629,2020-09-05 15:00:00,2020-05-09 00:00:00,LABORABLE
5,9,2020,17,732,789,1521,2020-09-05 16:00:00,2020-05-09 00:00:00,LABORABLE
5,9,2020,18,902,638,1540,2020-09-05 17:00:00,2020-05-09 00:00:00,LABORABLE
5,9,2020,19,1001,731,1732,2020-09-05 18:00:00,2020-05-09 00:00:00,LABORABLE
5,9,2020,20,1072,697,1769,2020-09-05 19:00:00,2020-05-09 00:00:00,LABORABLE
5,9,2020,21,1102,708,1810,2020-09-05 20:00:00,2020-05-09 00:00:00,LABORABLE
5,9,2020,22,1081,722,1803,2020-09-05 21:00:00,2020-05-09 00:00:00,LABORABLE
5,9,2020,23,818,569,1387,2020-09-05 22:00:00,2020-05-09 00:00:00,LABORABLE
5,9,2020,24,594,426,1020,2020-09-05 23:00:00,2020-05-09 00:00:00,LABORABLE
6,9,2020,1,320,359,679,2020-09-06 00:00:00,2020-06-09 00:00:00,LABORABLE
6,9,2020,2,318,398,716,2020-09-06 01:00:00,2020-06-09 00:00:00,LABORABLE
6,9,2020,3,211,303,514,2020-09-06 02:00:00,2020-06-09 00:00:00,LABORABLE
6,9,2020,4,137,192,329,2020-09-06 03:00:00,2020-06-09 00:00:00,LABORABLE
6,9,2020,5,78,136,214,2020-09-06 04:00:00,2020-06-09 00:00:00,LABORABLE
6,9,2020,6,99,121,220,2020-09-06 05:00:00,2020-06-09 00:00:00,LABORABLE
6,9,2020,7,89,140,229,2020-09-06 06:00:00,2020-06-09 00:00:00,LABORABLE
6,9,2020,8,135,161,296,2020-09-06 07:00:00,2020-06-09 00:00:00,LABORABLE
6,9,2020,9,187,248,435,2020-09-06 08:00:00,2020-06-09 00:00:00,LABORABLE
6,9,2020,10,274,395,669,2020-09-06 09:00:00,2020-06-09 00:00:00,LABORABLE
6,9,2020,11,381,455,836,2020-09-06 10:00:00,2020-06-09 00:00:00,LABORABLE
6,9,2020,12,468,581,1049,2020-09-06 11:00:00,2020-06-09 00:00:00,LABORABLE
6,9,2020,13,524,614,1138,2020-09-06 12:00:00,2020-06-09 00:00:00,LABORABLE
6,9,2020,14,513,636,1149,2020-09-06 13:00:00,2020-06-09 00:00:00,LABORABLE
6,9,2020,15,485,646,1131,2020-09-06 14:00:00,2020-06-09 00:00:00,LABORABLE
6,9,2020,16,398,567,965,2020-09-06 15:00:00,2020-06-09 00:00:00,LABORABLE
6,9,2020,17,397,536,933,2020-09-06 16:00:00,2020-06-09 00:00:00,LABORABLE
6,9,2020,18,402,565,967,2020-09-06 17:00:00,2020-06-09 00:00:00,LABORABLE
6,9,2020,19,505,722,1227,2020-09-06 18:00:00,2020-06-09 00:00:00,LABORABLE
6,9,2020,20,452,635,1087,2020-09-06 19:00:00,2020-06-09 00:00:00,LABORABLE
6,9,2020,21,464,663,1127,2020-09-06 20:00:00,2020-06-09 00:00:00,LABORABLE
6,9,2020,22,487,556,1043,2020-09-06 21:00:00,2020-06-09 00:00:00,LABORABLE
6,9,2020,23,380,490,870,2020-09-06 22:00:00,2020-06-09 00:00:00,LABORABLE
6,9,2020,24,284,331,615,2020-09-06 23:00:00,2020-06-09 00:00:00,LABORABLE
7,9,2020,1,227,235,462,2020-09-07 00:00:00,2020-07-09 00:00:00,LABORABLE
7,9,2020,2,165,192,357,2020-09-07 01:00:00,2020-07-09 00:00:00,LABORABLE
7,9,2020,3,95,127,222,2020-09-07 02:00:00,2020-07-09 00:00:00,LABORABLE
7,9,2020,4,64,82,146,2020-09-07 03:00:00,2020-07-09 00:00:00,LABORABLE
7,9,2020,5,57,69,126,2020-09-07 04:00:00,2020-07-09 00:00:00,LABORABLE
7,9,2020,6,151,143,294,2020-09-07 05:00:00,2020-07-09 00:00:00,LABORABLE
7,9,2020,7,391,325,716,2020-09-07 06:00:00,2020-07-09 00:00:00,LABORABLE
7,9,2020,8,637,537,1174,2020-09-07 07:00:00,2020-07-09 00:00:00,LABORABLE
7,9,2020,9,613,577,1190,2020-09-07 08:00:00,2020-07-09 00:00:00,LABORABLE
7,9,2020,10,615,651,1266,2020-09-07 09:00:00,2020-07-09 00:00:00,LABORABLE
7,9,2020,11,573,610,1183,2020-09-07 10:00:00,2020-07-09 00:00:00,LABORABLE
7,9,2020,12,630,639,1269,2020-09-07 11:00:00,2020-07-09 00:00:00,LABORABLE
7,9,2020,13,576,675,1251,2020-09-07 12:00:00,2020-07-09 00:00:00,LABORABLE
7,9,2020,14,651,718,1369,2020-09-07 13:00:00,2020-07-09 00:00:00,LABORABLE
7,9,2020,15,661,715,1376,2020-09-07 14:00:00,2020-07-09 00:00:00,LABORABLE
7,9,2020,16,564,611,1175,2020-09-07 15:00:00,2020-07-09 00:00:00,LABORABLE
7,9,2020,17,562,600,1162,2020-09-07 16:00:00,2020-07-09 00:00:00,LABORABLE
7,9,2020,18,655,749,1404,2020-09-07 17:00:00,2020-07-09 00:00:00,LABORABLE
7,9,2020,19,690,725,1415,2020-09-07 18:00:00,2020-07-09 00:00:00,LABORABLE
7,9,2020,20,649,755,1404,2020-09-07 19:00:00,2020-07-09 00:00:00,LABORABLE
7,9,2020,21,571,713,1284,2020-09-07 20:00:00,2020-07-09 00:00:00,LABORABLE
7,9,2020,22,526,547,1073,2020-09-07 21:00:00,2020-07-09 00:00:00,LABORABLE
7,9,2020,23,384,440,824,2020-09-07 22:00:00,2020-07-09 00:00:00,LABORABLE
7,9,2020,24,246,273,519,2020-09-07 23:00:00,2020-07-09 00:00:00,LABORABLE
8,9,2020,1,171,206,377,2020-09-08 00:00:00,2020-08-09 00:00:00,LABORABLE
8,9,2020,2,109,138,247,2020-09-08 01:00:00,2020-08-09 00:00:00,LABORABLE
8,9,2020,3,73,110,183,2020-09-08 02:00:00,2020-08-09 00:00:00,LABORABLE
8,9,2020,4,66,59,125,2020-09-08 03:00:00,2020-08-09 00:00:00,LABORABLE
8,9,2020,5,74,64,138,2020-09-08 04:00:00,2020-08-09 00:00:00,LABORABLE
8,9,2020,6,152,112,264,2020-09-08 05:00:00,2020-08-09 00:00:00,LABORABLE
8,9,2020,7,377,341,718,2020-09-08 06:00:00,2020-08-09 00:00:00,LABORABLE
8,9,2020,8,642,547,1189,2020-09-08 07:00:00,2020-08-09 00:00:00,LABORABLE
8,9,2020,9,649,629,1278,2020-09-08 08:00:00,2020-08-09 00:00:00,LABORABLE
8,9,2020,10,640,634,1274,2020-09-08 09:00:00,2020-08-09 00:00:00,LABORABLE
8,9,2020,11,593,615,1208,2020-09-08 10:00:00,2020-08-09 00:00:00,LABORABLE
8,9,2020,12,617,662,1279,2020-09-08 11:00:00,2020-08-09 00:00:00,LABORABLE
8,9,2020,13,608,694,1302,2020-09-08 12:00:00,2020-08-09 00:00:00,LABORABLE
8,9,2020,14,660,698,1358,2020-09-08 13:00:00,2020-08-09 00:00:00,LABORABLE
8,9,2020,15,638,672,1310,2020-09-08 14:00:00,2020-08-09 00:00:00,LABORABLE
8,9,2020,16,549,627,1176,2020-09-08 15:00:00,2020-08-09 00:00:00,LABORABLE
8,9,2020,17,598,613,1211,2020-09-08 16:00:00,2020-08-09 00:00:00,LABORABLE
8,9,2020,18,606,667,1273,2020-09-08 17:00:00,2020-08-09 00:00:00,LABORABLE
8,9,2020,19,674,621,1295,2020-09-08 18:00:00,2020-08-09 00:00:00,LABORABLE
8,9,2020,20,655,578,1233,2020-09-08 19:00:00,2020-08-09 00:00:00,LABORABLE
8,9,2020,21,595,699,1294,2020-09-08 20:00:00,2020-08-09 00:00:00,LABORABLE
8,9,2020,22,538,744,1282,2020-09-08 21:00:00,2020-08-09 00:00:00,LABORABLE
8,9,2020,23,399,477,876,2020-09-08 22:00:00,2020-08-09 00:00:00,LABORABLE
8,9,2020,24,262,472,734,2020-09-08 23:00:00,2020-08-09 00:00:00,LABORABLE
9,9,2020,1,177,236,413,2020-09-09 00:00:00,2020-09-09 00:00:00,LABORABLE
9,9,2020,2,117,155,272,2020-09-09 01:00:00,2020-09-09 00:00:00,LABORABLE
9,9,2020,3,84,118,202,2020-09-09 02:00:00,2020-09-09 00:00:00,LABORABLE
9,9,2020,4,50,72,122,2020-09-09 03:00:00,2020-09-09 00:00:00,LABORABLE
9,9,2020,5,74,83,157,2020-09-09 04:00:00,2020-09-09 00:00:00,LABORABLE
9,9,2020,6,150,113,263,2020-09-09 05:00:00,2020-09-09 00:00:00,LABORABLE
9,9,2020,7,391,321,712,2020-09-09 06:00:00,2020-09-09 00:00:00,LABORABLE
9,9,2020,8,640,552,1192,2020-09-09 07:00:00,2020-09-09 00:00:00,LABORABLE
9,9,2020,9,643,630,1273,2020-09-09 08:00:00,2020-09-09 00:00:00,LABORABLE
9,9,2020,10,597,773,1370,2020-09-09 09:00:00,2020-09-09 00:00:00,LABORABLE
9,9,2020,11,593,711,1304,2020-09-09 10:00:00,2020-09-09 00:00:00,LABORABLE
9,9,2020,12,567,640,1207,2020-09-09 11:00:00,2020-09-09 00:00:00,LABORABLE
9,9,2020,13,622,744,1366,2020-09-09 12:00:00,2020-09-09 00:00:00,LABORABLE
9,9,2020,14,655,725,1380,2020-09-09 13:00:00,2020-09-09 00:00:00,LABORABLE
9,9,2020,15,621,714,1335,2020-09-09 14:00:00,2020-09-09 00:00:00,LABORABLE
9,9,2020,16,579,695,1274,2020-09-09 15:00:00,2020-09-09 00:00:00,LABORABLE
9,9,2020,17,592,619,1211,2020-09-09 16:00:00,2020-09-09 00:00:00,LABORABLE
9,9,2020,18,613,711,1324,2020-09-09 17:00:00,2020-09-09 00:00:00,LABORABLE
9,9,2020,19,702,784,1486,2020-09-09 18:00:00,2020-09-09 00:00:00,LABORABLE
9,9,2020,20,603,797,1400,2020-09-09 19:00:00,2020-09-09 00:00:00,LABORABLE
9,9,2020,21,642,789,1431,2020-09-09 20:00:00,2020-09-09 00:00:00,LABORABLE
9,9,2020,22,469,604,1073,2020-09-09 21:00:00,2020-09-09 00:00:00,LABORABLE
9,9,2020,23,402,440,842,2020-09-09 22:00:00,2020-09-09 00:00:00,LABORABLE
9,9,2020,24,290,307,597,2020-09-09 23:00:00,2020-09-09 00:00:00,LABORABLE
10,9,2020,1,219,247,466,2020-09-10 00:00:00,2020-10-09 00:00:00,LABORABLE
10,9,2020,2,132,166,298,2020-09-10 01:00:00,2020-10-09 00:00:00,LABORABLE
10,9,2020,3,103,147,250,2020-09-10 02:00:00,2020-10-09 00:00:00,LABORABLE
10,9,2020,4,53,73,126,2020-09-10 03:00:00,2020-10-09 00:00:00,LABORABLE
10,9,2020,5,87,95,182,2020-09-10 04:00:00,2020-10-09 00:00:00,LABORABLE
10,9,2020,6,166,126,292,2020-09-10 05:00:00,2020-10-09 00:00:00,LABORABLE
10,9,2020,7,385,351,736,2020-09-10 06:00:00,2020-10-09 00:00:00,LABORABLE
10,9,2020,8,658,554,1212,2020-09-10 07:00:00,2020-10-09 00:00:00,LABORABLE
10,9,2020,9,646,630,1276,2020-09-10 08:00:00,2020-10-09 00:00:00,LABORABLE
10,9,2020,10,645,732,1377,2020-09-10 09:00:00,2020-10-09 00:00:00,LABORABLE
10,9,2020,11,602,691,1293,2020-09-10 10:00:00,2020-10-09 00:00:00,LABORABLE
10,9,2020,12,609,711,1320,2020-09-10 11:00:00,2020-10-09 00:00:00,LABORABLE
10,9,2020,13,593,739,1332,2020-09-10 12:00:00,2020-10-09 00:00:00,LABORABLE
10,9,2020,14,660,759,1419,2020-09-10 13:00:00,2020-10-09 00:00:00,LABORABLE
10,9,2020,15,643,731,1374,2020-09-10 14:00:00,2020-10-09 00:00:00,LABORABLE
10,9,2020,16,590,620,1210,2020-09-10 15:00:00,2020-10-09 00:00:00,LABORABLE
10,9,2020,17,555,721,1276,2020-09-10 16:00:00,2020-10-09 00:00:00,LABORABLE
10,9,2020,18,644,785,1429,2020-09-10 17:00:00,2020-10-09 00:00:00,LABORABLE
10,9,2020,19,684,789,1473,2020-09-10 18:00:00,2020-10-09 00:00:00,LABORABLE
10,9,2020,20,742,885,1627,2020-09-10 19:00:00,2020-10-09 00:00:00,LABORABLE
10,9,2020,21,618,813,1431,2020-09-10 20:00:00,2020-10-09 00:00:00,LABORABLE
10,9,2020,22,564,668,1232,2020-09-10 21:00:00,2020-10-09 00:00:00,LABORABLE
10,9,2020,23,370,522,892,2020-09-10 22:00:00,2020-10-09 00:00:00,LABORABLE
10,9,2020,24,290,311,601,2020-09-10 23:00:00,2020-10-09 00:00:00,LABORABLE
11,9,2020,1,211,279,490,2020-09-11 00:00:00,2020-11-09 00:00:00,LABORABLE
11,9,2020,2,155,207,362,2020-09-11 01:00:00,2020-11-09 00:00:00,LABORABLE
11,9,2020,3,87,137,224,2020-09-11 02:00:00,2020-11-09 00:00:00,LABORABLE
11,9,2020,4,83,104,187,2020-09-11 03:00:00,2020-11-09 00:00:00,LABORABLE
11,9,2020,5,62,70,132,2020-09-11 04:00:00,2020-11-09 00:00:00,LABORABLE
11,9,2020,6,153,154,307,2020-09-11 05:00:00,2020-11-09 00:00:00,LABORABLE
11,9,2020,7,392,349,741,2020-09-11 06:00:00,2020-11-09 00:00:00,LABORABLE
11,9,2020,8,625,542,1167,2020-09-11 07:00:00,2020-11-09 00:00:00,LABORABLE
11,9,2020,9,650,639,1289,2020-09-11 08:00:00,2020-11-09 00:00:00,LABORABLE
11,9,2020,10,630,739,1369,2020-09-11 09:00:00,2020-11-09 00:00:00,LABORABLE
11,9,2020,11,585,660,1245,2020-09-11 10:00:00,2020-11-09 00:00:00,LABORABLE
11,9,2020,12,619,759,1378,2020-09-11 11:00:00,2020-11-09 00:00:00,LABORABLE
11,9,2020,13,595,802,1397,2020-09-11 12:00:00,2020-11-09 00:00:00,LABORABLE
11,9,2020,14,655,825,1480,2020-09-11 13:00:00,2020-11-09 00:00:00,LABORABLE
11,9,2020,15,673,753,1426,2020-09-11 14:00:00,2020-11-09 00:00:00,LABORABLE
11,9,2020,16,590,688,1278,2020-09-11 15:00:00,2020-11-09 00:00:00,LABORABLE
11,9,2020,17,609,763,1372,2020-09-11 16:00:00,2020-11-09 00:00:00,LABORABLE
11,9,2020,18,667,797,1464,2020-09-11 17:00:00,2020-11-09 00:00:00,LABORABLE
11,9,2020,19,674,829,1503,2020-09-11 18:00:00,2020-11-09 00:00:00,LABORABLE
11,9,2020,20,680,833,1513,2020-09-11 19:00:00,2020-11-09 00:00:00,LABORABLE
11,9,2020,21,663,888,1551,2020-09-11 20:00:00,2020-11-09 00:00:00,LABORABLE
11,9,2020,22,596,747,1343,2020-09-11 21:00:00,2020-11-09 00:00:00,LABORABLE
11,9,2020,23,466,601,1067,2020-09-11 22:00:00,2020-11-09 00:00:00,LABORABLE
11,9,2020,24,368,392,760,2020-09-11 23:00:00,2020-11-09 00:00:00,LABORABLE
12,9,2020,1,321,498,819,2020-09-12 00:00:00,2020-12-09 00:00:00,LABORABLE
12,9,2020,2,257,356,613,2020-09-12 01:00:00,2020-12-09 00:00:00,LABORABLE
12,9,2020,3,187,264,451,2020-09-12 02:00:00,2020-12-09 00:00:00,LABORABLE
12,9,2020,4,113,173,286,2020-09-12 03:00:00,2020-12-09 00:00:00,LABORABLE
12,9,2020,5,101,142,243,2020-09-12 04:00:00,2020-12-09 00:00:00,LABORABLE
12,9,2020,6,116,141,257,2020-09-12 05:00:00,2020-12-09 00:00:00,LABORABLE
12,9,2020,7,158,200,358,2020-09-12 06:00:00,2020-12-09 00:00:00,LABORABLE
12,9,2020,8,223,281,504,2020-09-12 07:00:00,2020-12-09 00:00:00,LABORABLE
12,9,2020,9,331,404,735,2020-09-12 08:00:00,2020-12-09 00:00:00,LABORABLE
12,9,2020,10,420,588,1008,2020-09-12 09:00:00,2020-12-09 00:00:00,LABORABLE
12,9,2020,11,514,648,1162,2020-09-12 10:00:00,2020-12-09 00:00:00,LABORABLE
12,9,2020,12,610,817,1427,2020-09-12 11:00:00,2020-12-09 00:00:00,LABORABLE
12,9,2020,13,662,868,1530,2020-09-12 12:00:00,2020-12-09 00:00:00,LABORABLE
12,9,2020,14,632,867,1499,2020-09-12 13:00:00,2020-12-09 00:00:00,LABORABLE
12,9,2020,15,576,857,1433,2020-09-12 14:00:00,2020-12-09 00:00:00,LABORABLE
12,9,2020,16,498,720,1218,2020-09-12 15:00:00,2020-12-09 00:00:00,LABORABLE
12,9,2020,17,438,695,1133,2020-09-12 16:00:00,2020-12-09 00:00:00,LABORABLE
12,9,2020,18,475,700,1175,2020-09-12 17:00:00,2020-12-09 00:00:00,LABORABLE
12,9,2020,19,578,775,1353,2020-09-12 18:00:00,2020-12-09 00:00:00,LABORABLE
12,9,2020,20,585,823,1408,2020-09-12 19:00:00,2020-12-09 00:00:00,LABORABLE
12,9,2020,21,567,777,1344,2020-09-12 20:00:00,2020-12-09 00:00:00,LABORABLE
12,9,2020,22,522,744,1266,2020-09-12 21:00:00,2020-12-09 00:00:00,LABORABLE
12,9,2020,23,454,624,1078,2020-09-12 22:00:00,2020-12-09 00:00:00,LABORABLE
12,9,2020,24,376,440,816,2020-09-12 23:00:00,2020-12-09 00:00:00,LABORABLE
13,9,2020,1,347,467,814,2020-09-13 00:00:00,2020-09-13 00:00:00,LABORABLE
13,9,2020,2,317,415,732,2020-09-13 01:00:00,2020-09-13 00:00:00,LABORABLE
13,9,2020,3,201,311,512,2020-09-13 02:00:00,2020-09-13 00:00:00,LABORABLE
13,9,2020,4,136,226,362,2020-09-13 03:00:00,2020-09-13 00:00:00,LABORABLE
13,9,2020,5,91,179,270,2020-09-13 04:00:00,2020-09-13 00:00:00,LABORABLE
13,9,2020,6,78,161,239,2020-09-13 05:00:00,2020-09-13 00:00:00,LABORABLE
13,9,2020,7,97,148,245,2020-09-13 06:00:00,2020-09-13 00:00:00,LABORABLE
13,9,2020,8,145,187,332,2020-09-13 07:00:00,2020-09-13 00:00:00,LABORABLE
13,9,2020,9,198,256,454,2020-09-13 08:00:00,2020-09-13 00:00:00,LABORABLE
13,9,2020,10,294,445,739,2020-09-13 09:00:00,2020-09-13 00:00:00,LABORABLE
13,9,2020,11,418,522,940,2020-09-13 10:00:00,2020-09-13 00:00:00,LABORABLE
13,9,2020,12,474,646,1120,2020-09-13 11:00:00,2020-09-13 00:00:00,LABORABLE
13,9,2020,13,529,667,1196,2020-09-13 12:00:00,2020-09-13 00:00:00,LABORABLE
13,9,2020,14,551,777,1328,2020-09-13 13:00:00,2020-09-13 00:00:00,LABORABLE
13,9,2020,15,482,745,1227,2020-09-13 14:00:00,2020-09-13 00:00:00,LABORABLE
13,9,2020,16,414,606,1020,2020-09-13 15:00:00,2020-09-13 00:00:00,LABORABLE
13,9,2020,17,388,614,1002,2020-09-13 16:00:00,2020-09-13 00:00:00,LABORABLE
13,9,2020,18,451,639,1090,2020-09-13 17:00:00,2020-09-13 00:00:00,LABORABLE
13,9,2020,19,490,694,1184,2020-09-13 18:00:00,2020-09-13 00:00:00,LABORABLE
13,9,2020,20,511,702,1213,2020-09-13 19:00:00,2020-09-13 00:00:00,LABORABLE
13,9,2020,21,471,688,1159,2020-09-13 20:00:00,2020-09-13 00:00:00,LABORABLE
13,9,2020,22,486,604,1090,2020-09-13 21:00:00,2020-09-13 00:00:00,LABORABLE
13,9,2020,23,344,467,811,2020-09-13 22:00:00,2020-09-13 00:00:00,LABORABLE
13,9,2020,24,258,355,613,2020-09-13 23:00:00,2020-09-13 00:00:00,LABORABLE
14,9,2020,1,229,278,507,2020-09-14 00:00:00,2020-09-14 00:00:00,LABORABLE
14,9,2020,2,127,193,320,2020-09-14 01:00:00,2020-09-14 00:00:00,LABORABLE
14,9,2020,3,115,158,273,2020-09-14 02:00:00,2020-09-14 00:00:00,LABORABLE
14,9,2020,4,77,88,165,2020-09-14 03:00:00,2020-09-14 00:00:00,LABORABLE
14,9,2020,5,55,76,131,2020-09-14 04:00:00,2020-09-14 00:00:00,LABORABLE
14,9,2020,6,155,124,279,2020-09-14 05:00:00,2020-09-14 00:00:00,LABORABLE
14,9,2020,7,391,352,743,2020-09-14 06:00:00,2020-09-14 00:00:00,LABORABLE
14,9,2020,8,626,564,1190,2020-09-14 07:00:00,2020-09-14 00:00:00,LABORABLE
14,9,2020,9,630,676,1306,2020-09-14 08:00:00,2020-09-14 00:00:00,LABORABLE
14,9,2020,10,624,726,1350,2020-09-14 09:00:00,2020-09-14 00:00:00,LABORABLE
14,9,2020,11,551,687,1238,2020-09-14 10:00:00,2020-09-14 00:00:00,LABORABLE
14,9,2020,12,576,686,1262,2020-09-14 11:00:00,2020-09-14 00:00:00,LABORABLE
14,9,2020,13,489,688,1177,2020-09-14 12:00:00,2020-09-14 00:00:00,LABORABLE
14,9,2020,14,655,782,1437,2020-09-14 13:00:00,2020-09-14 00:00:00,LABORABLE
14,9,2020,15,659,776,1435,2020-09-14 14:00:00,2020-09-14 00:00:00,LABORABLE
14,9,2020,16,596,661,1257,2020-09-14 15:00:00,2020-09-14 00:00:00,LABORABLE
14,9,2020,17,562,641,1203,2020-09-14 16:00:00,2020-09-14 00:00:00,LABORABLE
14,9,2020,18,620,705,1325,2020-09-14 17:00:00,2020-09-14 00:00:00,LABORABLE
14,9,2020,19,659,782,1441,2020-09-14 18:00:00,2020-09-14 00:00:00,LABORABLE
14,9,2020,20,638,791,1429,2020-09-14 19:00:00,2020-09-14 00:00:00,LABORABLE
14,9,2020,21,590,766,1356,2020-09-14 20:00:00,2020-09-14 00:00:00,LABORABLE
14,9,2020,22,478,576,1054,2020-09-14 21:00:00,2020-09-14 00:00:00,LABORABLE
14,9,2020,23,346,434,780,2020-09-14 22:00:00,2020-09-14 00:00:00,LABORABLE
14,9,2020,24,223,283,506,2020-09-14 23:00:00,2020-09-14 00:00:00,LABORABLE
15,9,2020,1,168,220,388,2020-09-15 00:00:00,2020-09-15 00:00:00,LABORABLE
15,9,2020,2,104,171,275,2020-09-15 01:00:00,2020-09-15 00:00:00,LABORABLE
15,9,2020,3,74,134,208,2020-09-15 02:00:00,2020-09-15 00:00:00,LABORABLE
15,9,2020,4,62,82,144,2020-09-15 03:00:00,2020-09-15 00:00:00,LABORABLE
15,9,2020,5,67,65,132,2020-09-15 04:00:00,2020-09-15 00:00:00,LABORABLE
15,9,2020,6,151,112,263,2020-09-15 05:00:00,2020-09-15 00:00:00,LABORABLE
15,9,2020,7,411,356,767,2020-09-15 06:00:00,2020-09-15 00:00:00,LABORABLE
15,9,2020,8,653,589,1242,2020-09-15 07:00:00,2020-09-15 00:00:00,LABORABLE
15,9,2020,9,652,703,1355,2020-09-15 08:00:00,2020-09-15 00:00:00,LABORABLE
15,9,2020,10,605,721,1326,2020-09-15 09:00:00,2020-09-15 00:00:00,LABORABLE
15,9,2020,11,580,689,1269,2020-09-15 10:00:00,2020-09-15 00:00:00,LABORABLE
15,9,2020,12,629,732,1361,2020-09-15 11:00:00,2020-09-15 00:00:00,LABORABLE
15,9,2020,13,664,822,1486,2020-09-15 12:00:00,2020-09-15 00:00:00,LABORABLE
15,9,2020,14,505,698,1203,2020-09-15 13:00:00,2020-09-15 00:00:00,LABORABLE
15,9,2020,15,680,783,1463,2020-09-15 14:00:00,2020-09-15 00:00:00,LABORABLE
15,9,2020,16,563,664,1227,2020-09-15 15:00:00,2020-09-15 00:00:00,LABORABLE
15,9,2020,17,507,631,1138,2020-09-15 16:00:00,2020-09-15 00:00:00,LABORABLE
15,9,2020,18,662,732,1394,2020-09-15 17:00:00,2020-09-15 00:00:00,LABORABLE
15,9,2020,19,658,880,1538,2020-09-15 18:00:00,2020-09-15 00:00:00,LABORABLE
15,9,2020,20,648,793,1441,2020-09-15 19:00:00,2020-09-15 00:00:00,LABORABLE
15,9,2020,21,600,772,1372,2020-09-15 20:00:00,2020-09-15 00:00:00,LABORABLE
15,9,2020,22,544,559,1103,2020-09-15 21:00:00,2020-09-15 00:00:00,LABORABLE
15,9,2020,23,411,444,855,2020-09-15 22:00:00,2020-09-15 00:00:00,LABORABLE
15,9,2020,24,245,302,547,2020-09-15 23:00:00,2020-09-15 00:00:00,LABORABLE
16,9,2020,1,194,220,414,2020-09-16 00:00:00,2020-09-16 00:00:00,LABORABLE
16,9,2020,2,92,155,247,2020-09-16 01:00:00,2020-09-16 00:00:00,LABORABLE
16,9,2020,3,79,117,196,2020-09-16 02:00:00,2020-09-16 00:00:00,LABORABLE
16,9,2020,4,57,94,151,2020-09-16 03:00:00,2020-09-16 00:00:00,LABORABLE
16,9,2020,5,68,69,137,2020-09-16 04:00:00,2020-09-16 00:00:00,LABORABLE
16,9,2020,6,163,129,292,2020-09-16 05:00:00,2020-09-16 00:00:00,LABORABLE
16,9,2020,7,389,301,690,2020-09-16 06:00:00,2020-09-16 00:00:00,LABORABLE
16,9,2020,8,655,591,1246,2020-09-16 07:00:00,2020-09-16 00:00:00,LABORABLE
16,9,2020,9,615,666,1281,2020-09-16 08:00:00,2020-09-16 00:00:00,LABORABLE
16,9,2020,10,631,731,1362,2020-09-16 09:00:00,2020-09-16 00:00:00,LABORABLE
16,9,2020,11,568,657,1225,2020-09-16 10:00:00,2020-09-16 00:00:00,LABORABLE
16,9,2020,12,595,707,1302,2020-09-16 11:00:00,2020-09-16 00:00:00,LABORABLE
16,9,2020,13,532,630,1162,2020-09-16 12:00:00,2020-09-16 00:00:00,LABORABLE
16,9,2020,14,666,803,1469,2020-09-16 13:00:00,2020-09-16 00:00:00,LABORABLE
16,9,2020,15,643,718,1361,2020-09-16 14:00:00,2020-09-16 00:00:00,LABORABLE
16,9,2020,16,612,704,1316,2020-09-16 15:00:00,2020-09-16 00:00:00,LABORABLE
16,9,2020,17,552,619,1171,2020-09-16 16:00:00,2020-09-16 00:00:00,LABORABLE
16,9,2020,18,597,703,1300,2020-09-16 17:00:00,2020-09-16 00:00:00,LABORABLE
16,9,2020,19,680,778,1458,2020-09-16 18:00:00,2020-09-16 00:00:00,LABORABLE
16,9,2020,20,669,809,1478,2020-09-16 19:00:00,2020-09-16 00:00:00,LABORABLE
16,9,2020,21,610,714,1324,2020-09-16 20:00:00,2020-09-16 00:00:00,LABORABLE
16,9,2020,22,518,581,1099,2020-09-16 21:00:00,2020-09-16 00:00:00,LABORABLE
16,9,2020,23,395,465,860,2020-09-16 22:00:00,2020-09-16 00:00:00,LABORABLE
16,9,2020,24,240,295,535,2020-09-16 23:00:00,2020-09-16 00:00:00,LABORABLE
17,9,2020,1,198,221,419,2020-09-17 00:00:00,2020-09-17 00:00:00,LABORABLE
17,9,2020,2,113,152,265,2020-09-17 01:00:00,2020-09-17 00:00:00,LABORABLE
17,9,2020,3,75,116,191,2020-09-17 02:00:00,2020-09-17 00:00:00,LABORABLE
17,9,2020,4,62,74,136,2020-09-17 03:00:00,2020-09-17 00:00:00,LABORABLE
17,9,2020,5,81,77,158,2020-09-17 04:00:00,2020-09-17 00:00:00,LABORABLE
17,9,2020,6,141,122,263,2020-09-17 05:00:00,2020-09-17 00:00:00,LABORABLE
17,9,2020,7,417,324,741,2020-09-17 06:00:00,2020-09-17 00:00:00,LABORABLE
17,9,2020,8,652,572,1224,2020-09-17 07:00:00,2020-09-17 00:00:00,LABORABLE
17,9,2020,9,663,677,1340,2020-09-17 08:00:00,2020-09-17 00:00:00,LABORABLE
17,9,2020,10,655,758,1413,2020-09-17 09:00:00,2020-09-17 00:00:00,LABORABLE
17,9,2020,11,479,630,1109,2020-09-17 10:00:00,2020-09-17 00:00:00,LABORABLE
17,9,2020,12,621,780,1401,2020-09-17 11:00:00,2020-09-17 00:00:00,LABORABLE
17,9,2020,13,622,756,1378,2020-09-17 12:00:00,2020-09-17 00:00:00,LABORABLE
17,9,2020,14,684,789,1473,2020-09-17 13:00:00,2020-09-17 00:00:00,LABORABLE
17,9,2020,15,634,689,1323,2020-09-17 14:00:00,2020-09-17 00:00:00,LABORABLE
17,9,2020,16,594,645,1239,2020-09-17 15:00:00,2020-09-17 00:00:00,LABORABLE
17,9,2020,17,581,728,1309,2020-09-17 16:00:00,2020-09-17 00:00:00,LABORABLE
17,9,2020,18,650,701,1351,2020-09-17 17:00:00,2020-09-17 00:00:00,LABORABLE
17,9,2020,19,659,814,1473,2020-09-17 18:00:00,2020-09-17 00:00:00,LABORABLE
17,9,2020,20,656,826,1482,2020-09-17 19:00:00,2020-09-17 00:00:00,LABORABLE
17,9,2020,21,624,721,1345,2020-09-17 20:00:00,2020-09-17 00:00:00,LABORABLE
17,9,2020,22,511,606,1117,2020-09-17 21:00:00,2020-09-17 00:00:00,LABORABLE
17,9,2020,23,397,452,849,2020-09-17 22:00:00,2020-09-17 00:00:00,LABORABLE
17,9,2020,24,244,333,577,2020-09-17 23:00:00,2020-09-17 00:00:00,LABORABLE
18,9,2020,1,188,272,460,2020-09-18 00:00:00,2020-09-18 00:00:00,LABORABLE
18,9,2020,2,128,197,325,2020-09-18 01:00:00,2020-09-18 00:00:00,LABORABLE
18,9,2020,3,94,126,220,2020-09-18 02:00:00,2020-09-18 00:00:00,LABORABLE
18,9,2020,4,66,90,156,2020-09-18 03:00:00,2020-09-18 00:00:00,LABORABLE
18,9,2020,5,64,80,144,2020-09-18 04:00:00,2020-09-18 00:00:00,LABORABLE
18,9,2020,6,158,135,293,2020-09-18 05:00:00,2020-09-18 00:00:00,LABORABLE
18,9,2020,7,374,309,683,2020-09-18 06:00:00,2020-09-18 00:00:00,LABORABLE
18,9,2020,8,637,518,1155,2020-09-18 07:00:00,2020-09-18 00:00:00,LABORABLE
18,9,2020,9,668,625,1293,2020-09-18 08:00:00,2020-09-18 00:00:00,LABORABLE
18,9,2020,10,631,756,1387,2020-09-18 09:00:00,2020-09-18 00:00:00,LABORABLE
18,9,2020,11,631,685,1316,2020-09-18 10:00:00,2020-09-18 00:00:00,LABORABLE
18,9,2020,12,623,769,1392,2020-09-18 11:00:00,2020-09-18 00:00:00,LABORABLE
18,9,2020,13,623,772,1395,2020-09-18 12:00:00,2020-09-18 00:00:00,LABORABLE
18,9,2020,14,714,813,1527,2020-09-18 13:00:00,2020-09-18 00:00:00,LABORABLE
18,9,2020,15,693,768,1461,2020-09-18 14:00:00,2020-09-18 00:00:00,LABORABLE
18,9,2020,16,606,665,1271,2020-09-18 15:00:00,2020-09-18 00:00:00,LABORABLE
18,9,2020,17,625,730,1355,2020-09-18 16:00:00,2020-09-18 00:00:00,LABORABLE
18,9,2020,18,565,800,1365,2020-09-18 17:00:00,2020-09-18 00:00:00,LABORABLE
18,9,2020,19,619,854,1473,2020-09-18 18:00:00,2020-09-18 00:00:00,LABORABLE
18,9,2020,20,687,846,1533,2020-09-18 19:00:00,2020-09-18 00:00:00,LABORABLE
18,9,2020,21,625,794,1419,2020-09-18 20:00:00,2020-09-18 00:00:00,LABORABLE
18,9,2020,22,546,734,1280,2020-09-18 21:00:00,2020-09-18 00:00:00,LABORABLE
18,9,2020,23,463,568,1031,2020-09-18 22:00:00,2020-09-18 00:00:00,LABORABLE
18,9,2020,24,314,401,715,2020-09-18 23:00:00,2020-09-18 00:00:00,LABORABLE
19,9,2020,1,277,436,713,2020-09-19 00:00:00,2020-09-19 00:00:00,LABORABLE
19,9,2020,2,251,314,565,2020-09-19 01:00:00,2020-09-19 00:00:00,LABORABLE
19,9,2020,3,147,235,382,2020-09-19 02:00:00,2020-09-19 00:00:00,LABORABLE
19,9,2020,4,99,148,247,2020-09-19 03:00:00,2020-09-19 00:00:00,LABORABLE
19,9,2020,5,86,112,198,2020-09-19 04:00:00,2020-09-19 00:00:00,LABORABLE
19,9,2020,6,100,123,223,2020-09-19 05:00:00,2020-09-19 00:00:00,LABORABLE
19,9,2020,7,184,158,342,2020-09-19 06:00:00,2020-09-19 00:00:00,LABORABLE
19,9,2020,8,236,274,510,2020-09-19 07:00:00,2020-09-19 00:00:00,LABORABLE
19,9,2020,9,323,385,708,2020-09-19 08:00:00,2020-09-19 00:00:00,LABORABLE
19,9,2020,10,457,565,1022,2020-09-19 09:00:00,2020-09-19 00:00:00,LABORABLE
19,9,2020,11,457,694,1151,2020-09-19 10:00:00,2020-09-19 00:00:00,LABORABLE
19,9,2020,12,613,798,1411,2020-09-19 11:00:00,2020-09-19 00:00:00,LABORABLE
19,9,2020,13,632,864,1496,2020-09-19 12:00:00,2020-09-19 00:00:00,LABORABLE
19,9,2020,14,633,913,1546,2020-09-19 13:00:00,2020-09-19 00:00:00,LABORABLE
19,9,2020,15,588,861,1449,2020-09-19 14:00:00,2020-09-19 00:00:00,LABORABLE
19,9,2020,16,509,735,1244,2020-09-19 15:00:00,2020-09-19 00:00:00,LABORABLE
19,9,2020,17,457,736,1193,2020-09-19 16:00:00,2020-09-19 00:00:00,LABORABLE
19,9,2020,18,483,745,1228,2020-09-19 17:00:00,2020-09-19 00:00:00,LABORABLE
19,9,2020,19,584,721,1305,2020-09-19 18:00:00,2020-09-19 00:00:00,LABORABLE
19,9,2020,20,582,825,1407,2020-09-19 19:00:00,2020-09-19 00:00:00,LABORABLE
19,9,2020,21,570,787,1357,2020-09-19 20:00:00,2020-09-19 00:00:00,LABORABLE
19,9,2020,22,512,721,1233,2020-09-19 21:00:00,2020-09-19 00:00:00,LABORABLE
19,9,2020,23,423,596,1019,2020-09-19 22:00:00,2020-09-19 00:00:00,LABORABLE
19,9,2020,24,306,446,752,2020-09-19 23:00:00,2020-09-19 00:00:00,LABORABLE
20,9,2020,1,313,436,749,2020-09-20 00:00:00,2020-09-20 00:00:00,LABORABLE
20,9,2020,2,302,404,706,2020-09-20 01:00:00,2020-09-20 00:00:00,LABORABLE
20,9,2020,3,182,269,451,2020-09-20 02:00:00,2020-09-20 00:00:00,LABORABLE
20,9,2020,4,104,212,316,2020-09-20 03:00:00,2020-09-20 00:00:00,LABORABLE
20,9,2020,5,86,178,264,2020-09-20 04:00:00,2020-09-20 00:00:00,LABORABLE
20,9,2020,6,73,124,197,2020-09-20 05:00:00,2020-09-20 00:00:00,LABORABLE
20,9,2020,7,102,133,235,2020-09-20 06:00:00,2020-09-20 00:00:00,LABORABLE
20,9,2020,8,144,156,300,2020-09-20 07:00:00,2020-09-20 00:00:00,LABORABLE
20,9,2020,9,184,245,429,2020-09-20 08:00:00,2020-09-20 00:00:00,LABORABLE
20,9,2020,10,276,435,711,2020-09-20 09:00:00,2020-09-20 00:00:00,LABORABLE
20,9,2020,11,335,510,845,2020-09-20 10:00:00,2020-09-20 00:00:00,LABORABLE
20,9,2020,12,493,668,1161,2020-09-20 11:00:00,2020-09-20 00:00:00,LABORABLE
20,9,2020,13,628,714,1342,2020-09-20 12:00:00,2020-09-20 00:00:00,LABORABLE
20,9,2020,14,563,751,1314,2020-09-20 13:00:00,2020-09-20 00:00:00,LABORABLE
20,9,2020,15,481,808,1289,2020-09-20 14:00:00,2020-09-20 00:00:00,LABORABLE
20,9,2020,16,412,666,1078,2020-09-20 15:00:00,2020-09-20 00:00:00,LABORABLE
20,9,2020,17,387,662,1049,2020-09-20 16:00:00,2020-09-20 00:00:00,LABORABLE
20,9,2020,18,474,663,1137,2020-09-20 17:00:00,2020-09-20 00:00:00,LABORABLE
20,9,2020,19,519,770,1289,2020-09-20 18:00:00,2020-09-20 00:00:00,LABORABLE
20,9,2020,20,510,669,1179,2020-09-20 19:00:00,2020-09-20 00:00:00,LABORABLE
20,9,2020,21,535,752,1287,2020-09-20 20:00:00,2020-09-20 00:00:00,LABORABLE
20,9,2020,22,523,634,1157,2020-09-20 21:00:00,2020-09-20 00:00:00,LABORABLE
20,9,2020,23,377,480,857,2020-09-20 22:00:00,2020-09-20 00:00:00,LABORABLE
20,9,2020,24,294,342,636,2020-09-20 23:00:00,2020-09-20 00:00:00,LABORABLE
21,9,2020,1,194,241,435,2020-09-21 00:00:00,2020-09-21 00:00:00,LABORABLE
21,9,2020,2,112,156,268,2020-09-21 01:00:00,2020-09-21 00:00:00,LABORABLE
21,9,2020,3,68,139,207,2020-09-21 02:00:00,2020-09-21 00:00:00,LABORABLE
21,9,2020,4,52,79,131,2020-09-21 03:00:00,2020-09-21 00:00:00,LABORABLE
21,9,2020,5,42,60,102,2020-09-21 04:00:00,2020-09-21 00:00:00,LABORABLE
21,9,2020,6,140,123,263,2020-09-21 05:00:00,2020-09-21 00:00:00,LABORABLE
21,9,2020,7,400,345,745,2020-09-21 06:00:00,2020-09-21 00:00:00,LABORABLE
21,9,2020,8,669,530,1199,2020-09-21 07:00:00,2020-09-21 00:00:00,LABORABLE
21,9,2020,9,603,644,1247,2020-09-21 08:00:00,2020-09-21 00:00:00,LABORABLE
21,9,2020,10,595,668,1263,2020-09-21 09:00:00,2020-09-21 00:00:00,LABORABLE
21,9,2020,11,544,601,1145,2020-09-21 10:00:00,2020-09-21 00:00:00,LABORABLE
21,9,2020,12,542,605,1147,2020-09-21 11:00:00,2020-09-21 00:00:00,LABORABLE
21,9,2020,13,556,614,1170,2020-09-21 12:00:00,2020-09-21 00:00:00,LABORABLE
21,9,2020,14,609,690,1299,2020-09-21 13:00:00,2020-09-21 00:00:00,LABORABLE
21,9,2020,15,614,707,1321,2020-09-21 14:00:00,2020-09-21 00:00:00,LABORABLE
21,9,2020,16,533,544,1077,2020-09-21 15:00:00,2020-09-21 00:00:00,LABORABLE
21,9,2020,17,533,604,1137,2020-09-21 16:00:00,2020-09-21 00:00:00,LABORABLE
21,9,2020,18,571,561,1132,2020-09-21 17:00:00,2020-09-21 00:00:00,LABORABLE
21,9,2020,19,638,647,1285,2020-09-21 18:00:00,2020-09-21 00:00:00,LABORABLE
21,9,2020,20,555,680,1235,2020-09-21 19:00:00,2020-09-21 00:00:00,LABORABLE
21,9,2020,21,523,599,1122,2020-09-21 20:00:00,2020-09-21 00:00:00,LABORABLE
21,9,2020,22,425,478,903,2020-09-21 21:00:00,2020-09-21 00:00:00,LABORABLE
21,9,2020,23,280,374,654,2020-09-21 22:00:00,2020-09-21 00:00:00,LABORABLE
21,9,2020,24,158,195,353,2020-09-21 23:00:00,2020-09-21 00:00:00,LABORABLE
22,9,2020,1,123,170,293,2020-09-22 00:00:00,2020-09-22 00:00:00,LABORABLE
22,9,2020,2,75,105,180,2020-09-22 01:00:00,2020-09-22 00:00:00,LABORABLE
22,9,2020,3,47,91,138,2020-09-22 02:00:00,2020-09-22 00:00:00,LABORABLE
22,9,2020,4,42,54,96,2020-09-22 03:00:00,2020-09-22 00:00:00,LABORABLE
22,9,2020,5,59,67,126,2020-09-22 04:00:00,2020-09-22 00:00:00,LABORABLE
22,9,2020,6,134,118,252,2020-09-22 05:00:00,2020-09-22 00:00:00,LABORABLE
22,9,2020,7,399,329,728,2020-09-22 06:00:00,2020-09-22 00:00:00,LABORABLE
22,9,2020,8,641,574,1215,2020-09-22 07:00:00,2020-09-22 00:00:00,LABORABLE
22,9,2020,9,660,675,1335,2020-09-22 08:00:00,2020-09-22 00:00:00,LABORABLE
22,9,2020,10,557,721,1278,2020-09-22 09:00:00,2020-09-22 00:00:00,LABORABLE
22,9,2020,11,544,657,1201,2020-09-22 10:00:00,2020-09-22 00:00:00,LABORABLE
22,9,2020,12,541,639,1180,2020-09-22 11:00:00,2020-09-22 00:00:00,LABORABLE
22,9,2020,13,580,710,1290,2020-09-22 12:00:00,2020-09-22 00:00:00,LABORABLE
22,9,2020,14,582,721,1303,2020-09-22 13:00:00,2020-09-22 00:00:00,LABORABLE
22,9,2020,15,586,696,1282,2020-09-22 14:00:00,2020-09-22 00:00:00,LABORABLE
22,9,2020,16,532,597,1129,2020-09-22 15:00:00,2020-09-22 00:00:00,LABORABLE
22,9,2020,17,481,614,1095,2020-09-22 16:00:00,2020-09-22 00:00:00,LABORABLE
22,9,2020,18,544,650,1194,2020-09-22 17:00:00,2020-09-22 00:00:00,LABORABLE
22,9,2020,19,621,742,1363,2020-09-22 18:00:00,2020-09-22 00:00:00,LABORABLE
22,9,2020,20,591,728,1319,2020-09-22 19:00:00,2020-09-22 00:00:00,LABORABLE
22,9,2020,21,518,642,1160,2020-09-22 20:00:00,2020-09-22 00:00:00,LABORABLE
22,9,2020,22,425,508,933,2020-09-22 21:00:00,2020-09-22 00:00:00,LABORABLE
22,9,2020,23,320,373,693,2020-09-22 22:00:00,2020-09-22 00:00:00,LABORABLE
22,9,2020,24,174,241,415,2020-09-22 23:00:00,2020-09-22 00:00:00,LABORABLE
23,9,2020,1,131,185,316,2020-09-23 00:00:00,2020-09-23 00:00:00,LABORABLE
23,9,2020,2,75,104,179,2020-09-23 01:00:00,2020-09-23 00:00:00,LABORABLE
23,9,2020,3,51,84,135,2020-09-23 02:00:00,2020-09-23 00:00:00,LABORABLE
23,9,2020,4,47,70,117,2020-09-23 03:00:00,2020-09-23 00:00:00,LABORABLE
23,9,2020,5,53,64,117,2020-09-23 04:00:00,2020-09-23 00:00:00,LABORABLE
23,9,2020,6,131,119,250,2020-09-23 05:00:00,2020-09-23 00:00:00,LABORABLE
23,9,2020,7,407,274,681,2020-09-23 06:00:00,2020-09-23 00:00:00,LABORABLE
23,9,2020,8,631,570,1201,2020-09-23 07:00:00,2020-09-23 00:00:00,LABORABLE
23,9,2020,9,627,605,1232,2020-09-23 08:00:00,2020-09-23 00:00:00,LABORABLE
23,9,2020,10,532,691,1223,2020-09-23 09:00:00,2020-09-23 00:00:00,LABORABLE
23,9,2020,11,484,630,1114,2020-09-23 10:00:00,2020-09-23 00:00:00,LABORABLE
23,9,2020,12,506,650,1156,2020-09-23 11:00:00,2020-09-23 00:00:00,LABORABLE
23,9,2020,13,569,665,1234,2020-09-23 12:00:00,2020-09-23 00:00:00,LABORABLE
23,9,2020,14,558,654,1212,2020-09-23 13:00:00,2020-09-23 00:00:00,LABORABLE
23,9,2020,15,586,608,1194,2020-09-23 14:00:00,2020-09-23 00:00:00,LABORABLE
23,9,2020,16,446,551,997,2020-09-23 15:00:00,2020-09-23 00:00:00,LABORABLE
23,9,2020,17,500,608,1108,2020-09-23 16:00:00,2020-09-23 00:00:00,LABORABLE
23,9,2020,18,521,618,1139,2020-09-23 17:00:00,2020-09-23 00:00:00,LABORABLE
23,9,2020,19,587,660,1247,2020-09-23 18:00:00,2020-09-23 00:00:00,LABORABLE
23,9,2020,20,564,706,1270,2020-09-23 19:00:00,2020-09-23 00:00:00,LABORABLE
23,9,2020,21,495,613,1108,2020-09-23 20:00:00,2020-09-23 00:00:00,LABORABLE
23,9,2020,22,439,515,954,2020-09-23 21:00:00,2020-09-23 00:00:00,LABORABLE
23,9,2020,23,335,404,739,2020-09-23 22:00:00,2020-09-23 00:00:00,LABORABLE
23,9,2020,24,188,226,414,2020-09-23 23:00:00,2020-09-23 00:00:00,LABORABLE
24,9,2020,1,108,150,258,2020-09-24 00:00:00,2020-09-24 00:00:00,LABORABLE
24,9,2020,2,110,129,239,2020-09-24 01:00:00,2020-09-24 00:00:00,LABORABLE
24,9,2020,3,64,88,152,2020-09-24 02:00:00,2020-09-24 00:00:00,LABORABLE
24,9,2020,4,45,65,110,2020-09-24 03:00:00,2020-09-24 00:00:00,LABORABLE
24,9,2020,5,44,62,106,2020-09-24 04:00:00,2020-09-24 00:00:00,LABORABLE
24,9,2020,6,130,115,245,2020-09-24 05:00:00,2020-09-24 00:00:00,LABORABLE
24,9,2020,7,424,311,735,2020-09-24 06:00:00,2020-09-24 00:00:00,LABORABLE
24,9,2020,8,648,577,1225,2020-09-24 07:00:00,2020-09-24 00:00:00,LABORABLE
24,9,2020,9,552,604,1156,2020-09-24 08:00:00,2020-09-24 00:00:00,LABORABLE
24,9,2020,10,562,741,1303,2020-09-24 09:00:00,2020-09-24 00:00:00,LABORABLE
24,9,2020,11,533,629,1162,2020-09-24 10:00:00,2020-09-24 00:00:00,LABORABLE
24,9,2020,12,428,592,1020,2020-09-24 11:00:00,2020-09-24 00:00:00,LABORABLE
24,9,2020,13,452,576,1028,2020-09-24 12:00:00,2020-09-24 00:00:00,LABORABLE
24,9,2020,14,608,708,1316,2020-09-24 13:00:00,2020-09-24 00:00:00,LABORABLE
24,9,2020,15,463,542,1005,2020-09-24 14:00:00,2020-09-24 00:00:00,LABORABLE
24,9,2020,16,528,635,1163,2020-09-24 15:00:00,2020-09-24 00:00:00,LABORABLE
24,9,2020,17,574,637,1211,2020-09-24 16:00:00,2020-09-24 00:00:00,LABORABLE
24,9,2020,18,532,612,1144,2020-09-24 17:00:00,2020-09-24 00:00:00,LABORABLE
24,9,2020,19,622,672,1294,2020-09-24 18:00:00,2020-09-24 00:00:00,LABORABLE
24,9,2020,20,620,634,1254,2020-09-24 19:00:00,2020-09-24 00:00:00,LABORABLE
24,9,2020,21,537,587,1124,2020-09-24 20:00:00,2020-09-24 00:00:00,LABORABLE
24,9,2020,22,409,481,890,2020-09-24 21:00:00,2020-09-24 00:00:00,LABORABLE
24,9,2020,23,280,401,681,2020-09-24 22:00:00,2020-09-24 00:00:00,LABORABLE
24,9,2020,24,181,241,422,2020-09-24 23:00:00,2020-09-24 00:00:00,LABORABLE
25,9,2020,1,121,215,336,2020-09-25 00:00:00,2020-09-25 00:00:00,LABORABLE
25,9,2020,2,78,133,211,2020-09-25 01:00:00,2020-09-25 00:00:00,LABORABLE
25,9,2020,3,59,110,169,2020-09-25 02:00:00,2020-09-25 00:00:00,LABORABLE
25,9,2020,4,48,76,124,2020-09-25 03:00:00,2020-09-25 00:00:00,LABORABLE
25,9,2020,5,52,64,116,2020-09-25 04:00:00,2020-09-25 00:00:00,LABORABLE
25,9,2020,6,163,151,314,2020-09-25 05:00:00,2020-09-25 00:00:00,LABORABLE
25,9,2020,7,376,290,666,2020-09-25 06:00:00,2020-09-25 00:00:00,LABORABLE
25,9,2020,8,620,562,1182,2020-09-25 07:00:00,2020-09-25 00:00:00,LABORABLE
25,9,2020,9,637,598,1235,2020-09-25 08:00:00,2020-09-25 00:00:00,LABORABLE
25,9,2020,10,576,709,1285,2020-09-25 09:00:00,2020-09-25 00:00:00,LABORABLE
25,9,2020,11,533,590,1123,2020-09-25 10:00:00,2020-09-25 00:00:00,LABORABLE
25,9,2020,12,527,662,1189,2020-09-25 11:00:00,2020-09-25 00:00:00,LABORABLE
25,9,2020,13,567,707,1274,2020-09-25 12:00:00,2020-09-25 00:00:00,LABORABLE
25,9,2020,14,636,749,1385,2020-09-25 13:00:00,2020-09-25 00:00:00,LABORABLE
25,9,2020,15,595,669,1264,2020-09-25 14:00:00,2020-09-25 00:00:00,LABORABLE
25,9,2020,16,583,644,1227,2020-09-25 15:00:00,2020-09-25 00:00:00,LABORABLE
25,9,2020,17,563,691,1254,2020-09-25 16:00:00,2020-09-25 00:00:00,LABORABLE
25,9,2020,18,552,663,1215,2020-09-25 17:00:00,2020-09-25 00:00:00,LABORABLE
25,9,2020,19,584,683,1267,2020-09-25 18:00:00,2020-09-25 00:00:00,LABORABLE
25,9,2020,20,550,666,1216,2020-09-25 19:00:00,2020-09-25 00:00:00,LABORABLE
25,9,2020,21,540,665,1205,2020-09-25 20:00:00,2020-09-25 00:00:00,LABORABLE
25,9,2020,22,471,596,1067,2020-09-25 21:00:00,2020-09-25 00:00:00,LABORABLE
25,9,2020,23,379,443,822,2020-09-25 22:00:00,2020-09-25 00:00:00,LABORABLE
25,9,2020,24,229,290,519,2020-09-25 23:00:00,2020-09-25 00:00:00,LABORABLE
26,9,2020,1,219,284,503,2020-09-26 00:00:00,2020-09-26 00:00:00,LABORABLE
26,9,2020,2,119,224,343,2020-09-26 01:00:00,2020-09-26 00:00:00,LABORABLE
26,9,2020,3,94,182,276,2020-09-26 02:00:00,2020-09-26 00:00:00,LABORABLE
26,9,2020,4,52,124,176,2020-09-26 03:00:00,2020-09-26 00:00:00,LABORABLE
26,9,2020,5,59,106,165,2020-09-26 04:00:00,2020-09-26 00:00:00,LABORABLE
26,9,2020,6,88,103,191,2020-09-26 05:00:00,2020-09-26 00:00:00,LABORABLE
26,9,2020,7,175,147,322,2020-09-26 06:00:00,2020-09-26 00:00:00,LABORABLE
26,9,2020,8,219,253,472,2020-09-26 07:00:00,2020-09-26 00:00:00,LABORABLE
26,9,2020,9,291,424,715,2020-09-26 08:00:00,2020-09-26 00:00:00,LABORABLE
26,9,2020,10,363,514,877,2020-09-26 09:00:00,2020-09-26 00:00:00,LABORABLE
26,9,2020,11,418,580,998,2020-09-26 10:00:00,2020-09-26 00:00:00,LABORABLE
26,9,2020,12,472,631,1103,2020-09-26 11:00:00,2020-09-26 00:00:00,LABORABLE
26,9,2020,13,517,645,1162,2020-09-26 12:00:00,2020-09-26 00:00:00,LABORABLE
26,9,2020,14,558,676,1234,2020-09-26 13:00:00,2020-09-26 00:00:00,LABORABLE
26,9,2020,15,494,657,1151,2020-09-26 14:00:00,2020-09-26 00:00:00,LABORABLE
26,9,2020,16,384,553,937,2020-09-26 15:00:00,2020-09-26 00:00:00,LABORABLE
26,9,2020,17,359,527,886,2020-09-26 16:00:00,2020-09-26 00:00:00,LABORABLE
26,9,2020,18,414,567,981,2020-09-26 17:00:00,2020-09-26 00:00:00,LABORABLE
26,9,2020,19,452,585,1037,2020-09-26 18:00:00,2020-09-26 00:00:00,LABORABLE
26,9,2020,20,433,643,1076,2020-09-26 19:00:00,2020-09-26 00:00:00,LABORABLE
26,9,2020,21,426,616,1042,2020-09-26 20:00:00,2020-09-26 00:00:00,LABORABLE
26,9,2020,22,345,580,925,2020-09-26 21:00:00,2020-09-26 00:00:00,LABORABLE
26,9,2020,23,310,467,777,2020-09-26 22:00:00,2020-09-26 00:00:00,LABORABLE
26,9,2020,24,269,299,568,2020-09-26 23:00:00,2020-09-26 00:00:00,LABORABLE
27,9,2020,1,173,275,448,2020-09-27 00:00:00,2020-09-27 00:00:00,LABORABLE
27,9,2020,2,161,244,405,2020-09-27 01:00:00,2020-09-27 00:00:00,LABORABLE
27,9,2020,3,108,187,295,2020-09-27 02:00:00,2020-09-27 00:00:00,LABORABLE
27,9,2020,4,84,168,252,2020-09-27 03:00:00,2020-09-27 00:00:00,LABORABLE
27,9,2020,5,60,133,193,2020-09-27 04:00:00,2020-09-27 00:00:00,LABORABLE
27,9,2020,6,54,105,159,2020-09-27 05:00:00,2020-09-27 00:00:00,LABORABLE
27,9,2020,7,98,110,208,2020-09-27 06:00:00,2020-09-27 00:00:00,LABORABLE
27,9,2020,8,106,146,252,2020-09-27 07:00:00,2020-09-27 00:00:00,LABORABLE
27,9,2020,9,146,210,356,2020-09-27 08:00:00,2020-09-27 00:00:00,LABORABLE
27,9,2020,10,245,326,571,2020-09-27 09:00:00,2020-09-27 00:00:00,LABORABLE
27,9,2020,11,303,390,693,2020-09-27 10:00:00,2020-09-27 00:00:00,LABORABLE
27,9,2020,12,379,479,858,2020-09-27 11:00:00,2020-09-27 00:00:00,LABORABLE
27,9,2020,13,516,499,1015,2020-09-27 12:00:00,2020-09-27 00:00:00,LABORABLE
27,9,2020,14,440,533,973,2020-09-27 13:00:00,2020-09-27 00:00:00,LABORABLE
27,9,2020,15,371,531,902,2020-09-27 14:00:00,2020-09-27 00:00:00,LABORABLE
27,9,2020,16,293,485,778,2020-09-27 15:00:00,2020-09-27 00:00:00,LABORABLE
27,9,2020,17,320,472,792,2020-09-27 16:00:00,2020-09-27 00:00:00,LABORABLE
27,9,2020,18,335,511,846,2020-09-27 17:00:00,2020-09-27 00:00:00,LABORABLE
27,9,2020,19,386,522,908,2020-09-27 18:00:00,2020-09-27 00:00:00,LABORABLE
27,9,2020,20,389,477,866,2020-09-27 19:00:00,2020-09-27 00:00:00,LABORABLE
27,9,2020,21,384,490,874,2020-09-27 20:00:00,2020-09-27 00:00:00,LABORABLE
27,9,2020,22,377,430,807,2020-09-27 21:00:00,2020-09-27 00:00:00,LABORABLE
27,9,2020,23,248,379,627,2020-09-27 22:00:00,2020-09-27 00:00:00,LABORABLE
27,9,2020,24,191,245,436,2020-09-27 23:00:00,2020-09-27 00:00:00,LABORABLE
28,9,2020,1,139,171,310,2020-09-28 00:00:00,2020-09-28 00:00:00,LABORABLE
28,9,2020,2,92,126,218,2020-09-28 01:00:00,2020-09-28 00:00:00,LABORABLE
28,9,2020,3,64,113,177,2020-09-28 02:00:00,2020-09-28 00:00:00,LABORABLE
28,9,2020,4,40,54,94,2020-09-28 03:00:00,2020-09-28 00:00:00,LABORABLE
28,9,2020,5,56,65,121,2020-09-28 04:00:00,2020-09-28 00:00:00,LABORABLE
28,9,2020,6,139,118,257,2020-09-28 05:00:00,2020-09-28 00:00:00,LABORABLE
28,9,2020,7,371,313,684,2020-09-28 06:00:00,2020-09-28 00:00:00,LABORABLE
28,9,2020,8,711,589,1300,2020-09-28 07:00:00,2020-09-28 00:00:00,LABORABLE
28,9,2020,9,642,664,1306,2020-09-28 08:00:00,2020-09-28 00:00:00,LABORABLE
28,9,2020,10,570,652,1222,2020-09-28 09:00:00,2020-09-28 00:00:00,LABORABLE
28,9,2020,11,484,598,1082,2020-09-28 10:00:00,2020-09-28 00:00:00,LABORABLE
28,9,2020,12,528,605,1133,2020-09-28 11:00:00,2020-09-28 00:00:00,LABORABLE
28,9,2020,13,524,618,1142,2020-09-28 12:00:00,2020-09-28 00:00:00,LABORABLE
28,9,2020,14,556,658,1214,2020-09-28 13:00:00,2020-09-28 00:00:00,LABORABLE
28,9,2020,15,608,634,1242,2020-09-28 14:00:00,2020-09-28 00:00:00,LABORABLE
28,9,2020,16,571,575,1146,2020-09-28 15:00:00,2020-09-28 00:00:00,LABORABLE
28,9,2020,17,525,613,1138,2020-09-28 16:00:00,2020-09-28 00:00:00,LABORABLE
28,9,2020,18,500,601,1101,2020-09-28 17:00:00,2020-09-28 00:00:00,LABORABLE
28,9,2020,19,614,667,1281,2020-09-28 18:00:00,2020-09-28 00:00:00,LABORABLE
28,9,2020,20,575,623,1198,2020-09-28 19:00:00,2020-09-28 00:00:00,LABORABLE
28,9,2020,21,489,620,1109,2020-09-28 20:00:00,2020-09-28 00:00:00,LABORABLE
28,9,2020,22,403,427,830,2020-09-28 21:00:00,2020-09-28 00:00:00,LABORABLE
28,9,2020,23,294,338,632,2020-09-28 22:00:00,2020-09-28 00:00:00,LABORABLE
28,9,2020,24,154,194,348,2020-09-28 23:00:00,2020-09-28 00:00:00,LABORABLE
29,9,2020,1,990,150,1140,2020-09-29 00:00:00,2020-09-29 00:00:00,LABORABLE
29,9,2020,2,996,113,1109,2020-09-29 01:00:00,2020-09-29 00:00:00,LABORABLE
29,9,2020,3,1003,76,1079,2020-09-29 02:00:00,2020-09-29 00:00:00,LABORABLE
29,9,2020,4,892,53,945,2020-09-29 03:00:00,2020-09-29 00:00:00,LABORABLE
29,9,2020,5,794,74,868,2020-09-29 04:00:00,2020-09-29 00:00:00,LABORABLE
29,9,2020,6,841,120,961,2020-09-29 05:00:00,2020-09-29 00:00:00,LABORABLE
29,9,2020,7,922,323,1245,2020-09-29 06:00:00,2020-09-29 00:00:00,LABORABLE
29,9,2020,8,825,594,1419,2020-09-29 07:00:00,2020-09-29 00:00:00,LABORABLE
29,9,2020,9,905,644,1549,2020-09-29 08:00:00,2020-09-29 00:00:00,LABORABLE
29,9,2020,10,736,703,1439,2020-09-29 09:00:00,2020-09-29 00:00:00,LABORABLE
29,9,2020,11,646,573,1219,2020-09-29 10:00:00,2020-09-29 00:00:00,LABORABLE
29,9,2020,12,267,558,825,2020-09-29 11:00:00,2020-09-29 00:00:00,LABORABLE
29,9,2020,13,990,670,1660,2020-09-29 12:00:00,2020-09-29 00:00:00,LABORABLE
29,9,2020,14,996,745,1741,2020-09-29 13:00:00,2020-09-29 00:00:00,LABORABLE
29,9,2020,15,1003,674,1677,2020-09-29 14:00:00,2020-09-29 00:00:00,LABORABLE
29,9,2020,16,892,603,1495,2020-09-29 15:00:00,2020-09-29 00:00:00,LABORABLE
29,9,2020,17,794,587,1381,2020-09-29 16:00:00,2020-09-29 00:00:00,LABORABLE
29,9,2020,18,841,616,1457,2020-09-29 17:00:00,2020-09-29 00:00:00,LABORABLE
29,9,2020,19,922,685,1607,2020-09-29 18:00:00,2020-09-29 00:00:00,LABORABLE
29,9,2020,20,825,699,1524,2020-09-29 19:00:00,2020-09-29 00:00:00,LABORABLE
29,9,2020,21,905,592,1497,2020-09-29 20:00:00,2020-09-29 00:00:00,LABORABLE
29,9,2020,22,736,493,1229,2020-09-29 21:00:00,2020-09-29 00:00:00,LABORABLE
29,9,2020,23,646,360,1006,2020-09-29 22:00:00,2020-09-29 00:00:00,LABORABLE
29,9,2020,24,267,221,488,2020-09-29 23:00:00,2020-09-29 00:00:00,LABORABLE
30,9,2020,1,125,171,296,2020-09-30 00:00:00,2020-09-30 00:00:00,LABORABLE
30,9,2020,2,92,98,190,2020-09-30 01:00:00,2020-09-30 00:00:00,LABORABLE
30,9,2020,3,54,84,138,2020-09-30 02:00:00,2020-09-30 00:00:00,LABORABLE
30,9,2020,4,56,66,122,2020-09-30 03:00:00,2020-09-30 00:00:00,LABORABLE
30,9,2020,5,70,60,130,2020-09-30 04:00:00,2020-09-30 00:00:00,LABORABLE
30,9,2020,6,135,111,246,2020-09-30 05:00:00,2020-09-30 00:00:00,LABORABLE
30,9,2020,7,414,316,730,2020-09-30 06:00:00,2020-09-30 00:00:00,LABORABLE
30,9,2020,8,639,571,1210,2020-09-30 07:00:00,2020-09-30 00:00:00,LABORABLE
30,9,2020,9,639,679,1318,2020-09-30 08:00:00,2020-09-30 00:00:00,LABORABLE
30,9,2020,10,595,740,1335,2020-09-30 09:00:00,2020-09-30 00:00:00,LABORABLE
30,9,2020,11,519,606,1125,2020-09-30 10:00:00,2020-09-30 00:00:00,LABORABLE
30,9,2020,12,506,619,1125,2020-09-30 11:00:00,2020-09-30 00:00:00,LABORABLE
30,9,2020,13,558,639,1197,2020-09-30 12:00:00,2020-09-30 00:00:00,LABORABLE
30,9,2020,14,649,628,1277,2020-09-30 13:00:00,2020-09-30 00:00:00,LABORABLE
30,9,2020,15,634,679,1313,2020-09-30 14:00:00,2020-09-30 00:00:00,LABORABLE
30,9,2020,16,547,611,1158,2020-09-30 15:00:00,2020-09-30 00:00:00,LABORABLE
30,9,2020,17,549,620,1169,2020-09-30 16:00:00,2020-09-30 00:00:00,LABORABLE
30,9,2020,18,594,583,1177,2020-09-30 17:00:00,2020-09-30 00:00:00,LABORABLE
30,9,2020,19,636,714,1350,2020-09-30 18:00:00,2020-09-30 00:00:00,LABORABLE
30,9,2020,20,595,691,1286,2020-09-30 19:00:00,2020-09-30 00:00:00,LABORABLE
30,9,2020,21,583,659,1242,2020-09-30 20:00:00,2020-09-30 00:00:00,LABORABLE
30,9,2020,22,456,503,959,2020-09-30 21:00:00,2020-09-30 00:00:00,LABORABLE
30,9,2020,23,322,410,732,2020-09-30 22:00:00,2020-09-30 00:00:00,LABORABLE
30,9,2020,24,209,223,432,2020-09-30 23:00:00,2020-09-30 00:00:00,LABORABLE
1,10,2020,1,164,172,336,2020-10-01 00:00:00,2020-01-10 00:00:00,LABORABLE
1,10,2020,2,104,98,202,2020-10-01 01:00:00,2020-01-10 00:00:00,LABORABLE
1,10,2020,3,50,85,135,2020-10-01 02:00:00,2020-01-10 00:00:00,LABORABLE
1,10,2020,4,51,77,128,2020-10-01 03:00:00,2020-01-10 00:00:00,LABORABLE
1,10,2020,5,54,78,132,2020-10-01 04:00:00,2020-01-10 00:00:00,LABORABLE
1,10,2020,6,140,146,286,2020-10-01 05:00:00,2020-01-10 00:00:00,LABORABLE
1,10,2020,7,402,330,732,2020-10-01 06:00:00,2020-01-10 00:00:00,LABORABLE
1,10,2020,8,658,605,1263,2020-10-01 07:00:00,2020-01-10 00:00:00,LABORABLE
1,10,2020,9,688,661,1349,2020-10-01 08:00:00,2020-01-10 00:00:00,LABORABLE
1,10,2020,10,579,682,1261,2020-10-01 09:00:00,2020-01-10 00:00:00,LABORABLE
1,10,2020,11,544,636,1180,2020-10-01 10:00:00,2020-01-10 00:00:00,LABORABLE
1,10,2020,12,546,693,1239,2020-10-01 11:00:00,2020-01-10 00:00:00,LABORABLE
1,10,2020,13,316,546,862,2020-10-01 12:00:00,2020-01-10 00:00:00,LABORABLE
1,10,2020,14,599,767,1366,2020-10-01 13:00:00,2020-01-10 00:00:00,LABORABLE
1,10,2020,15,629,728,1357,2020-10-01 14:00:00,2020-01-10 00:00:00,LABORABLE
1,10,2020,16,622,689,1311,2020-10-01 15:00:00,2020-01-10 00:00:00,LABORABLE
1,10,2020,17,541,712,1253,2020-10-01 16:00:00,2020-01-10 00:00:00,LABORABLE
1,10,2020,18,627,669,1296,2020-10-01 17:00:00,2020-01-10 00:00:00,LABORABLE
1,10,2020,19,616,755,1371,2020-10-01 18:00:00,2020-01-10 00:00:00,LABORABLE
1,10,2020,20,668,757,1425,2020-10-01 19:00:00,2020-01-10 00:00:00,LABORABLE
1,10,2020,21,593,712,1305,2020-10-01 20:00:00,2020-01-10 00:00:00,LABORABLE
1,10,2020,22,468,561,1029,2020-10-01 21:00:00,2020-01-10 00:00:00,LABORABLE
1,10,2020,23,349,412,761,2020-10-01 22:00:00,2020-01-10 00:00:00,LABORABLE
1,10,2020,24,213,267,480,2020-10-01 23:00:00,2020-01-10 00:00:00,LABORABLE
2,10,2020,1,135,186,321,2020-10-02 00:00:00,2020-02-10 00:00:00,LABORABLE
2,10,2020,2,107,142,249,2020-10-02 01:00:00,2020-02-10 00:00:00,LABORABLE
2,10,2020,3,71,99,170,2020-10-02 02:00:00,2020-02-10 00:00:00,LABORABLE
2,10,2020,4,55,64,119,2020-10-02 03:00:00,2020-02-10 00:00:00,LABORABLE
2,10,2020,5,56,56,112,2020-10-02 04:00:00,2020-02-10 00:00:00,LABORABLE
2,10,2020,6,131,106,237,2020-10-02 05:00:00,2020-02-10 00:00:00,LABORABLE
2,10,2020,7,401,321,722,2020-10-02 06:00:00,2020-02-10 00:00:00,LABORABLE
2,10,2020,8,662,579,1241,2020-10-02 07:00:00,2020-02-10 00:00:00,LABORABLE
2,10,2020,9,673,656,1329,2020-10-02 08:00:00,2020-02-10 00:00:00,LABORABLE
2,10,2020,10,589,751,1340,2020-10-02 09:00:00,2020-02-10 00:00:00,LABORABLE
2,10,2020,11,526,716,1242,2020-10-02 10:00:00,2020-02-10 00:00:00,LABORABLE
2,10,2020,12,416,608,1024,2020-10-02 11:00:00,2020-02-10 00:00:00,LABORABLE
2,10,2020,13,623,782,1405,2020-10-02 12:00:00,2020-02-10 00:00:00,LABORABLE
2,10,2020,14,640,809,1449,2020-10-02 13:00:00,2020-02-10 00:00:00,LABORABLE
2,10,2020,15,680,744,1424,2020-10-02 14:00:00,2020-02-10 00:00:00,LABORABLE
2,10,2020,16,645,659,1304,2020-10-02 15:00:00,2020-02-10 00:00:00,LABORABLE
2,10,2020,17,589,667,1256,2020-10-02 16:00:00,2020-02-10 00:00:00,LABORABLE
2,10,2020,18,630,662,1292,2020-10-02 17:00:00,2020-02-10 00:00:00,LABORABLE
2,10,2020,19,672,753,1425,2020-10-02 18:00:00,2020-02-10 00:00:00,LABORABLE
2,10,2020,20,669,725,1394,2020-10-02 19:00:00,2020-02-10 00:00:00,LABORABLE
2,10,2020,21,617,747,1364,2020-10-02 20:00:00,2020-02-10 00:00:00,LABORABLE
2,10,2020,22,573,692,1265,2020-10-02 21:00:00,2020-02-10 00:00:00,LABORABLE
2,10,2020,23,418,526,944,2020-10-02 22:00:00,2020-02-10 00:00:00,LABORABLE
2,10,2020,24,276,378,654,2020-10-02 23:00:00,2020-02-10 00:00:00,LABORABLE
3,10,2020,1,188,270,458,2020-10-03 00:00:00,2020-03-10 00:00:00,LABORABLE
3,10,2020,2,112,135,247,2020-10-03 01:00:00,2020-03-10 00:00:00,LABORABLE
3,10,2020,3,73,159,232,2020-10-03 02:00:00,2020-03-10 00:00:00,LABORABLE
3,10,2020,4,66,116,182,2020-10-03 03:00:00,2020-03-10 00:00:00,LABORABLE
3,10,2020,5,75,78,153,2020-10-03 04:00:00,2020-03-10 00:00:00,LABORABLE
3,10,2020,6,96,92,188,2020-10-03 05:00:00,2020-03-10 00:00:00,LABORABLE
3,10,2020,7,156,141,297,2020-10-03 06:00:00,2020-03-10 00:00:00,LABORABLE
3,10,2020,8,207,240,447,2020-10-03 07:00:00,2020-03-10 00:00:00,LABORABLE
3,10,2020,9,277,343,620,2020-10-03 08:00:00,2020-03-10 00:00:00,LABORABLE
3,10,2020,10,292,474,766,2020-10-03 09:00:00,2020-03-10 00:00:00,LABORABLE
3,10,2020,11,373,541,914,2020-10-03 10:00:00,2020-03-10 00:00:00,LABORABLE
3,10,2020,12,431,607,1038,2020-10-03 11:00:00,2020-03-10 00:00:00,LABORABLE
3,10,2020,13,515,616,1131,2020-10-03 12:00:00,2020-03-10 00:00:00,LABORABLE
3,10,2020,14,503,634,1137,2020-10-03 13:00:00,2020-03-10 00:00:00,LABORABLE
3,10,2020,15,480,636,1116,2020-10-03 14:00:00,2020-03-10 00:00:00,LABORABLE
3,10,2020,16,403,568,971,2020-10-03 15:00:00,2020-03-10 00:00:00,LABORABLE
3,10,2020,17,354,484,838,2020-10-03 16:00:00,2020-03-10 00:00:00,LABORABLE
3,10,2020,18,390,482,872,2020-10-03 17:00:00,2020-03-10 00:00:00,LABORABLE
3,10,2020,19,456,637,1093,2020-10-03 18:00:00,2020-03-10 00:00:00,LABORABLE
3,10,2020,20,449,552,1001,2020-10-03 19:00:00,2020-03-10 00:00:00,LABORABLE
3,10,2020,21,428,620,1048,2020-10-03 20:00:00,2020-03-10 00:00:00,LABORABLE
3,10,2020,22,368,577,945,2020-10-03 21:00:00,2020-03-10 00:00:00,LABORABLE
3,10,2020,23,342,464,806,2020-10-03 22:00:00,2020-03-10 00:00:00,LABORABLE
3,10,2020,24,279,355,634,2020-10-03 23:00:00,2020-03-10 00:00:00,LABORABLE
4,10,2020,1,189,242,431,2020-10-04 00:00:00,2020-04-10 00:00:00,LABORABLE
4,10,2020,2,102,223,325,2020-10-04 01:00:00,2020-04-10 00:00:00,LABORABLE
4,10,2020,3,86,159,245,2020-10-04 02:00:00,2020-04-10 00:00:00,LABORABLE
4,10,2020,4,59,127,186,2020-10-04 03:00:00,2020-04-10 00:00:00,LABORABLE
4,10,2020,5,52,106,158,2020-10-04 04:00:00,2020-04-10 00:00:00,LABORABLE
4,10,2020,6,54,84,138,2020-10-04 05:00:00,2020-04-10 00:00:00,LABORABLE
4,10,2020,7,81,101,182,2020-10-04 06:00:00,2020-04-10 00:00:00,LABORABLE
4,10,2020,8,106,154,260,2020-10-04 07:00:00,2020-04-10 00:00:00,LABORABLE
4,10,2020,9,153,203,356,2020-10-04 08:00:00,2020-04-10 00:00:00,LABORABLE
4,10,2020,10,222,318,540,2020-10-04 09:00:00,2020-04-10 00:00:00,LABORABLE
4,10,2020,11,306,379,685,2020-10-04 10:00:00,2020-04-10 00:00:00,LABORABLE
4,10,2020,12,359,489,848,2020-10-04 11:00:00,2020-04-10 00:00:00,LABORABLE
4,10,2020,13,421,488,909,2020-10-04 12:00:00,2020-04-10 00:00:00,LABORABLE
4,10,2020,14,407,599,1006,2020-10-04 13:00:00,2020-04-10 00:00:00,LABORABLE
4,10,2020,15,421,541,962,2020-10-04 14:00:00,2020-04-10 00:00:00,LABORABLE
4,10,2020,16,360,491,851,2020-10-04 15:00:00,2020-04-10 00:00:00,LABORABLE
4,10,2020,17,318,472,790,2020-10-04 16:00:00,2020-04-10 00:00:00,LABORABLE
4,10,2020,18,358,519,877,2020-10-04 17:00:00,2020-04-10 00:00:00,LABORABLE
4,10,2020,19,407,545,952,2020-10-04 18:00:00,2020-04-10 00:00:00,LABORABLE
4,10,2020,20,384,510,894,2020-10-04 19:00:00,2020-04-10 00:00:00,LABORABLE
4,10,2020,21,384,503,887,2020-10-04 20:00:00,2020-04-10 00:00:00,LABORABLE
4,10,2020,22,353,426,779,2020-10-04 21:00:00,2020-04-10 00:00:00,LABORABLE
4,10,2020,23,269,352,621,2020-10-04 22:00:00,2020-04-10 00:00:00,LABORABLE
4,10,2020,24,197,275,472,2020-10-04 23:00:00,2020-04-10 00:00:00,LABORABLE
5,10,2020,1,85,202,287,2020-10-05 00:00:00,2020-05-10 00:00:00,LABORABLE
5,10,2020,2,55,118,173,2020-10-05 01:00:00,2020-05-10 00:00:00,LABORABLE
5,10,2020,3,62,114,176,2020-10-05 02:00:00,2020-05-10 00:00:00,LABORABLE
5,10,2020,4,35,61,96,2020-10-05 03:00:00,2020-05-10 00:00:00,LABORABLE
5,10,2020,5,59,69,128,2020-10-05 04:00:00,2020-05-10 00:00:00,LABORABLE
5,10,2020,6,144,120,264,2020-10-05 05:00:00,2020-05-10 00:00:00,LABORABLE
5,10,2020,7,390,349,739,2020-10-05 06:00:00,2020-05-10 00:00:00,LABORABLE
5,10,2020,8,694,623,1317,2020-10-05 07:00:00,2020-05-10 00:00:00,LABORABLE
5,10,2020,9,626,669,1295,2020-10-05 08:00:00,2020-05-10 00:00:00,LABORABLE
5,10,2020,10,583,719,1302,2020-10-05 09:00:00,2020-05-10 00:00:00,LABORABLE
5,10,2020,11,519,660,1179,2020-10-05 10:00:00,2020-05-10 00:00:00,LABORABLE
5,10,2020,12,526,630,1156,2020-10-05 11:00:00,2020-05-10 00:00:00,LABORABLE
5,10,2020,13,560,660,1220,2020-10-05 12:00:00,2020-05-10 00:00:00,LABORABLE
5,10,2020,14,556,676,1232,2020-10-05 13:00:00,2020-05-10 00:00:00,LABORABLE
5,10,2020,15,623,702,1325,2020-10-05 14:00:00,2020-05-10 00:00:00,LABORABLE
5,10,2020,16,605,611,1216,2020-10-05 15:00:00,2020-05-10 00:00:00,LABORABLE
5,10,2020,17,344,726,1070,2020-10-05 16:00:00,2020-05-10 00:00:00,LABORABLE
5,10,2020,18,376,621,997,2020-10-05 17:00:00,2020-05-10 00:00:00,LABORABLE
5,10,2020,19,399,635,1034,2020-10-05 18:00:00,2020-05-10 00:00:00,LABORABLE
5,10,2020,20,562,734,1296,2020-10-05 19:00:00,2020-05-10 00:00:00,LABORABLE
5,10,2020,21,536,661,1197,2020-10-05 20:00:00,2020-05-10 00:00:00,LABORABLE
5,10,2020,22,423,520,943,2020-10-05 21:00:00,2020-05-10 00:00:00,LABORABLE
5,10,2020,23,324,369,693,2020-10-05 22:00:00,2020-05-10 00:00:00,LABORABLE
5,10,2020,24,164,232,396,2020-10-05 23:00:00,2020-05-10 00:00:00,LABORABLE
6,10,2020,1,97,161,258,2020-10-06 00:00:00,2020-06-10 00:00:00,LABORABLE
6,10,2020,2,73,118,191,2020-10-06 01:00:00,2020-06-10 00:00:00,LABORABLE
6,10,2020,3,41,77,118,2020-10-06 02:00:00,2020-06-10 00:00:00,LABORABLE
6,10,2020,4,49,51,100,2020-10-06 03:00:00,2020-06-10 00:00:00,LABORABLE
6,10,2020,5,66,74,140,2020-10-06 04:00:00,2020-06-10 00:00:00,LABORABLE
6,10,2020,6,147,132,279,2020-10-06 05:00:00,2020-06-10 00:00:00,LABORABLE
6,10,2020,7,371,307,678,2020-10-06 06:00:00,2020-06-10 00:00:00,LABORABLE
6,10,2020,8,551,524,1075,2020-10-06 07:00:00,2020-06-10 00:00:00,LABORABLE
6,10,2020,9,658,662,1320,2020-10-06 08:00:00,2020-06-10 00:00:00,LABORABLE
6,10,2020,10,603,786,1389,2020-10-06 09:00:00,2020-06-10 00:00:00,LABORABLE
6,10,2020,11,490,646,1136,2020-10-06 10:00:00,2020-06-10 00:00:00,LABORABLE
6,10,2020,12,389,527,916,2020-10-06 11:00:00,2020-06-10 00:00:00,LABORABLE
6,10,2020,13,513,736,1249,2020-10-06 12:00:00,2020-06-10 00:00:00,LABORABLE
6,10,2020,14,569,752,1321,2020-10-06 13:00:00,2020-06-10 00:00:00,LABORABLE
6,10,2020,15,636,756,1392,2020-10-06 14:00:00,2020-06-10 00:00:00,LABORABLE
6,10,2020,16,599,629,1228,2020-10-06 15:00:00,2020-06-10 00:00:00,LABORABLE
6,10,2020,17,547,673,1220,2020-10-06 16:00:00,2020-06-10 00:00:00,LABORABLE
6,10,2020,18,613,622,1235,2020-10-06 17:00:00,2020-06-10 00:00:00,LABORABLE
6,10,2020,19,630,761,1391,2020-10-06 18:00:00,2020-06-10 00:00:00,LABORABLE
6,10,2020,20,578,803,1381,2020-10-06 19:00:00,2020-06-10 00:00:00,LABORABLE
6,10,2020,21,549,676,1225,2020-10-06 20:00:00,2020-06-10 00:00:00,LABORABLE
6,10,2020,22,411,525,936,2020-10-06 21:00:00,2020-06-10 00:00:00,LABORABLE
6,10,2020,23,335,379,714,2020-10-06 22:00:00,2020-06-10 00:00:00,LABORABLE
6,10,2020,24,183,244,427,2020-10-06 23:00:00,2020-06-10 00:00:00,LABORABLE
7,10,2020,1,126,172,298,2020-10-07 00:00:00,2020-07-10 00:00:00,LABORABLE
7,10,2020,2,66,115,181,2020-10-07 01:00:00,2020-07-10 00:00:00,LABORABLE
7,10,2020,3,38,77,115,2020-10-07 02:00:00,2020-07-10 00:00:00,LABORABLE
7,10,2020,4,44,64,108,2020-10-07 03:00:00,2020-07-10 00:00:00,LABORABLE
7,10,2020,5,59,52,111,2020-10-07 04:00:00,2020-07-10 00:00:00,LABORABLE
7,10,2020,6,139,118,257,2020-10-07 05:00:00,2020-07-10 00:00:00,LABORABLE
7,10,2020,7,405,318,723,2020-10-07 06:00:00,2020-07-10 00:00:00,LABORABLE
7,10,2020,8,645,552,1197,2020-10-07 07:00:00,2020-07-10 00:00:00,LABORABLE
7,10,2020,9,651,685,1336,2020-10-07 08:00:00,2020-07-10 00:00:00,LABORABLE
7,10,2020,10,601,716,1317,2020-10-07 09:00:00,2020-07-10 00:00:00,LABORABLE
7,10,2020,11,520,662,1182,2020-10-07 10:00:00,2020-07-10 00:00:00,LABORABLE
7,10,2020,12,413,594,1007,2020-10-07 11:00:00,2020-07-10 00:00:00,LABORABLE
7,10,2020,13,490,637,1127,2020-10-07 12:00:00,2020-07-10 00:00:00,LABORABLE
7,10,2020,14,586,826,1412,2020-10-07 13:00:00,2020-07-10 00:00:00,LABORABLE
7,10,2020,15,666,764,1430,2020-10-07 14:00:00,2020-07-10 00:00:00,LABORABLE
7,10,2020,16,567,642,1209,2020-10-07 15:00:00,2020-07-10 00:00:00,LABORABLE
7,10,2020,17,576,681,1257,2020-10-07 16:00:00,2020-07-10 00:00:00,LABORABLE
7,10,2020,18,593,623,1216,2020-10-07 17:00:00,2020-07-10 00:00:00,LABORABLE
7,10,2020,19,598,798,1396,2020-10-07 18:00:00,2020-07-10 00:00:00,LABORABLE
7,10,2020,20,587,844,1431,2020-10-07 19:00:00,2020-07-10 00:00:00,LABORABLE
7,10,2020,21,614,703,1317,2020-10-07 20:00:00,2020-07-10 00:00:00,LABORABLE
7,10,2020,22,454,566,1020,2020-10-07 21:00:00,2020-07-10 00:00:00,LABORABLE
7,10,2020,23,378,404,782,2020-10-07 22:00:00,2020-07-10 00:00:00,LABORABLE
7,10,2020,24,189,326,515,2020-10-07 23:00:00,2020-07-10 00:00:00,LABORABLE
8,10,2020,1,111,161,272,2020-10-08 00:00:00,2020-08-10 00:00:00,LABORABLE
8,10,2020,2,77,119,196,2020-10-08 01:00:00,2020-08-10 00:00:00,LABORABLE
8,10,2020,3,45,87,132,2020-10-08 02:00:00,2020-08-10 00:00:00,LABORABLE
8,10,2020,4,54,60,114,2020-10-08 03:00:00,2020-08-10 00:00:00,LABORABLE
8,10,2020,5,61,61,122,2020-10-08 04:00:00,2020-08-10 00:00:00,LABORABLE
8,10,2020,6,138,147,285,2020-10-08 05:00:00,2020-08-10 00:00:00,LABORABLE
8,10,2020,7,400,338,738,2020-10-08 06:00:00,2020-08-10 00:00:00,LABORABLE
8,10,2020,8,651,597,1248,2020-10-08 07:00:00,2020-08-10 00:00:00,LABORABLE
8,10,2020,9,681,624,1305,2020-10-08 08:00:00,2020-08-10 00:00:00,LABORABLE
8,10,2020,10,620,767,1387,2020-10-08 09:00:00,2020-08-10 00:00:00,LABORABLE
8,10,2020,11,551,745,1296,2020-10-08 10:00:00,2020-08-10 00:00:00,LABORABLE
8,10,2020,12,572,729,1301,2020-10-08 11:00:00,2020-08-10 00:00:00,LABORABLE
8,10,2020,13,506,686,1192,2020-10-08 12:00:00,2020-08-10 00:00:00,LABORABLE
8,10,2020,14,636,772,1408,2020-10-08 13:00:00,2020-08-10 00:00:00,LABORABLE
8,10,2020,15,636,748,1384,2020-10-08 14:00:00,2020-08-10 00:00:00,LABORABLE
8,10,2020,16,589,683,1272,2020-10-08 15:00:00,2020-08-10 00:00:00,LABORABLE
8,10,2020,17,598,762,1360,2020-10-08 16:00:00,2020-08-10 00:00:00,LABORABLE
8,10,2020,18,632,718,1350,2020-10-08 17:00:00,2020-08-10 00:00:00,LABORABLE
8,10,2020,19,678,758,1436,2020-10-08 18:00:00,2020-08-10 00:00:00,LABORABLE
8,10,2020,20,658,833,1491,2020-10-08 19:00:00,2020-08-10 00:00:00,LABORABLE
8,10,2020,21,624,755,1379,2020-10-08 20:00:00,2020-08-10 00:00:00,LABORABLE
8,10,2020,22,478,583,1061,2020-10-08 21:00:00,2020-08-10 00:00:00,LABORABLE
8,10,2020,23,350,435,785,2020-10-08 22:00:00,2020-08-10 00:00:00,LABORABLE
8,10,2020,24,233,330,563,2020-10-08 23:00:00,2020-08-10 00:00:00,LABORABLE
9,10,2020,1,126,217,343,2020-10-09 00:00:00,2020-09-10 00:00:00,LABORABLE
9,10,2020,2,82,138,220,2020-10-09 01:00:00,2020-09-10 00:00:00,LABORABLE
9,10,2020,3,71,108,179,2020-10-09 02:00:00,2020-09-10 00:00:00,LABORABLE
9,10,2020,4,58,71,129,2020-10-09 03:00:00,2020-09-10 00:00:00,LABORABLE
9,10,2020,5,67,85,152,2020-10-09 04:00:00,2020-09-10 00:00:00,LABORABLE
9,10,2020,6,148,130,278,2020-10-09 05:00:00,2020-09-10 00:00:00,LABORABLE
9,10,2020,7,411,326,737,2020-10-09 06:00:00,2020-09-10 00:00:00,LABORABLE
9,10,2020,8,677,595,1272,2020-10-09 07:00:00,2020-09-10 00:00:00,LABORABLE
9,10,2020,9,667,674,1341,2020-10-09 08:00:00,2020-09-10 00:00:00,LABORABLE
9,10,2020,10,613,755,1368,2020-10-09 09:00:00,2020-09-10 00:00:00,LABORABLE
9,10,2020,11,568,718,1286,2020-10-09 10:00:00,2020-09-10 00:00:00,LABORABLE
9,10,2020,12,594,686,1280,2020-10-09 11:00:00,2020-09-10 00:00:00,LABORABLE
9,10,2020,13,608,793,1401,2020-10-09 12:00:00,2020-09-10 00:00:00,LABORABLE
9,10,2020,14,693,858,1551,2020-10-09 13:00:00,2020-09-10 00:00:00,LABORABLE
9,10,2020,15,671,814,1485,2020-10-09 14:00:00,2020-09-10 00:00:00,LABORABLE
9,10,2020,16,624,718,1342,2020-10-09 15:00:00,2020-09-10 00:00:00,LABORABLE
9,10,2020,17,580,777,1357,2020-10-09 16:00:00,2020-09-10 00:00:00,LABORABLE
9,10,2020,18,627,735,1362,2020-10-09 17:00:00,2020-09-10 00:00:00,LABORABLE
9,10,2020,19,635,813,1448,2020-10-09 18:00:00,2020-09-10 00:00:00,LABORABLE
9,10,2020,20,579,829,1408,2020-10-09 19:00:00,2020-09-10 00:00:00,LABORABLE
9,10,2020,21,616,813,1429,2020-10-09 20:00:00,2020-09-10 00:00:00,LABORABLE
9,10,2020,22,468,664,1132,2020-10-09 21:00:00,2020-09-10 00:00:00,LABORABLE
9,10,2020,23,382,546,928,2020-10-09 22:00:00,2020-09-10 00:00:00,LABORABLE
9,10,2020,24,295,473,768,2020-10-09 23:00:00,2020-09-10 00:00:00,LABORABLE
10,10,2020,1,194,297,491,2020-10-10 00:00:00,2020-10-10 00:00:00,LABORABLE
10,10,2020,2,146,186,332,2020-10-10 01:00:00,2020-10-10 00:00:00,LABORABLE
10,10,2020,3,85,157,242,2020-10-10 02:00:00,2020-10-10 00:00:00,LABORABLE
10,10,2020,4,71,124,195,2020-10-10 03:00:00,2020-10-10 00:00:00,LABORABLE
10,10,2020,5,72,94,166,2020-10-10 04:00:00,2020-10-10 00:00:00,LABORABLE
10,10,2020,6,99,114,213,2020-10-10 05:00:00,2020-10-10 00:00:00,LABORABLE
10,10,2020,7,175,170,345,2020-10-10 06:00:00,2020-10-10 00:00:00,LABORABLE
10,10,2020,8,213,251,464,2020-10-10 07:00:00,2020-10-10 00:00:00,LABORABLE
10,10,2020,9,278,324,602,2020-10-10 08:00:00,2020-10-10 00:00:00,LABORABLE
10,10,2020,10,374,488,862,2020-10-10 09:00:00,2020-10-10 00:00:00,LABORABLE
10,10,2020,11,416,586,1002,2020-10-10 10:00:00,2020-10-10 00:00:00,LABORABLE
10,10,2020,12,503,653,1156,2020-10-10 11:00:00,2020-10-10 00:00:00,LABORABLE
10,10,2020,13,537,780,1317,2020-10-10 12:00:00,2020-10-10 00:00:00,LABORABLE
10,10,2020,14,587,808,1395,2020-10-10 13:00:00,2020-10-10 00:00:00,LABORABLE
10,10,2020,15,553,761,1314,2020-10-10 14:00:00,2020-10-10 00:00:00,LABORABLE
10,10,2020,16,446,626,1072,2020-10-10 15:00:00,2020-10-10 00:00:00,LABORABLE
10,10,2020,17,383,554,937,2020-10-10 16:00:00,2020-10-10 00:00:00,LABORABLE
10,10,2020,18,461,607,1068,2020-10-10 17:00:00,2020-10-10 00:00:00,LABORABLE
10,10,2020,19,504,687,1191,2020-10-10 18:00:00,2020-10-10 00:00:00,LABORABLE
10,10,2020,20,473,759,1232,2020-10-10 19:00:00,2020-10-10 00:00:00,LABORABLE
10,10,2020,21,464,679,1143,2020-10-10 20:00:00,2020-10-10 00:00:00,LABORABLE
10,10,2020,22,419,612,1031,2020-10-10 21:00:00,2020-10-10 00:00:00,LABORABLE
10,10,2020,23,394,494,888,2020-10-10 22:00:00,2020-10-10 00:00:00,LABORABLE
10,10,2020,24,306,394,700,2020-10-10 23:00:00,2020-10-10 00:00:00,LABORABLE
11,10,2020,1,215,289,504,2020-10-11 00:00:00,2020-11-10 00:00:00,LABORABLE
11,10,2020,2,126,233,359,2020-10-11 01:00:00,2020-11-10 00:00:00,LABORABLE
11,10,2020,3,96,154,250,2020-10-11 02:00:00,2020-11-10 00:00:00,LABORABLE
11,10,2020,4,73,130,203,2020-10-11 03:00:00,2020-11-10 00:00:00,LABORABLE
11,10,2020,5,52,142,194,2020-10-11 04:00:00,2020-11-10 00:00:00,LABORABLE
11,10,2020,6,56,91,147,2020-10-11 05:00:00,2020-11-10 00:00:00,LABORABLE
11,10,2020,7,86,102,188,2020-10-11 06:00:00,2020-11-10 00:00:00,LABORABLE
11,10,2020,8,113,146,259,2020-10-11 07:00:00,2020-11-10 00:00:00,LABORABLE
11,10,2020,9,166,203,369,2020-10-11 08:00:00,2020-11-10 00:00:00,LABORABLE
11,10,2020,10,219,350,569,2020-10-11 09:00:00,2020-11-10 00:00:00,LABORABLE
11,10,2020,11,349,393,742,2020-10-11 10:00:00,2020-11-10 00:00:00,LABORABLE
11,10,2020,12,392,533,925,2020-10-11 11:00:00,2020-11-10 00:00:00,LABORABLE
11,10,2020,13,426,645,1071,2020-10-11 12:00:00,2020-11-10 00:00:00,LABORABLE
11,10,2020,14,369,649,1018,2020-10-11 13:00:00,2020-11-10 00:00:00,LABORABLE
11,10,2020,15,488,626,1114,2020-10-11 14:00:00,2020-11-10 00:00:00,LABORABLE
11,10,2020,16,340,591,931,2020-10-11 15:00:00,2020-11-10 00:00:00,LABORABLE
11,10,2020,17,339,486,825,2020-10-11 16:00:00,2020-11-10 00:00:00,LABORABLE
11,10,2020,18,353,557,910,2020-10-11 17:00:00,2020-11-10 00:00:00,LABORABLE
11,10,2020,19,390,624,1014,2020-10-11 18:00:00,2020-11-10 00:00:00,LABORABLE
11,10,2020,20,428,620,1048,2020-10-11 19:00:00,2020-11-10 00:00:00,LABORABLE
11,10,2020,21,418,621,1039,2020-10-11 20:00:00,2020-11-10 00:00:00,LABORABLE
11,10,2020,22,363,510,873,2020-10-11 21:00:00,2020-11-10 00:00:00,LABORABLE
11,10,2020,23,312,380,692,2020-10-11 22:00:00,2020-11-10 00:00:00,LABORABLE
11,10,2020,24,278,398,676,2020-10-11 23:00:00,2020-11-10 00:00:00,LABORABLE
12,10,2020,1,188,261,449,2020-10-12 00:00:00,2020-12-10 00:00:00,FESTIVO
12,10,2020,2,91,172,263,2020-10-12 01:00:00,2020-12-10 00:00:00,FESTIVO
12,10,2020,3,83,112,195,2020-10-12 02:00:00,2020-12-10 00:00:00,FESTIVO
12,10,2020,4,60,85,145,2020-10-12 03:00:00,2020-12-10 00:00:00,FESTIVO
12,10,2020,5,48,84,132,2020-10-12 04:00:00,2020-12-10 00:00:00,FESTIVO
12,10,2020,6,65,79,144,2020-10-12 05:00:00,2020-12-10 00:00:00,FESTIVO
12,10,2020,7,114,126,240,2020-10-12 06:00:00,2020-12-10 00:00:00,FESTIVO
12,10,2020,8,161,220,381,2020-10-12 07:00:00,2020-12-10 00:00:00,FESTIVO
12,10,2020,9,210,272,482,2020-10-12 08:00:00,2020-12-10 00:00:00,FESTIVO
12,10,2020,10,263,439,702,2020-10-12 09:00:00,2020-12-10 00:00:00,FESTIVO
12,10,2020,11,303,467,770,2020-10-12 10:00:00,2020-12-10 00:00:00,FESTIVO
12,10,2020,12,378,555,933,2020-10-12 11:00:00,2020-12-10 00:00:00,FESTIVO
12,10,2020,13,397,576,973,2020-10-12 12:00:00,2020-12-10 00:00:00,FESTIVO
12,10,2020,14,436,633,1069,2020-10-12 13:00:00,2020-12-10 00:00:00,FESTIVO
12,10,2020,15,427,576,1003,2020-10-12 14:00:00,2020-12-10 00:00:00,FESTIVO
12,10,2020,16,301,546,847,2020-10-12 15:00:00,2020-12-10 00:00:00,FESTIVO
12,10,2020,17,356,519,875,2020-10-12 16:00:00,2020-12-10 00:00:00,FESTIVO
12,10,2020,18,405,524,929,2020-10-12 17:00:00,2020-12-10 00:00:00,FESTIVO
12,10,2020,19,399,576,975,2020-10-12 18:00:00,2020-12-10 00:00:00,FESTIVO
12,10,2020,20,410,623,1033,2020-10-12 19:00:00,2020-12-10 00:00:00,FESTIVO
12,10,2020,21,383,606,989,2020-10-12 20:00:00,2020-12-10 00:00:00,FESTIVO
12,10,2020,22,355,443,798,2020-10-12 21:00:00,2020-12-10 00:00:00,FESTIVO
12,10,2020,23,260,348,608,2020-10-12 22:00:00,2020-12-10 00:00:00,FESTIVO
12,10,2020,24,201,313,514,2020-10-12 23:00:00,2020-12-10 00:00:00,FESTIVO
13,10,2020,1,112,165,277,2020-10-13 00:00:00,2020-10-13 00:00:00,LABORABLE
13,10,2020,2,72,113,185,2020-10-13 01:00:00,2020-10-13 00:00:00,LABORABLE
13,10,2020,3,43,83,126,2020-10-13 02:00:00,2020-10-13 00:00:00,LABORABLE
13,10,2020,4,43,55,98,2020-10-13 03:00:00,2020-10-13 00:00:00,LABORABLE
13,10,2020,5,68,62,130,2020-10-13 04:00:00,2020-10-13 00:00:00,LABORABLE
13,10,2020,6,144,123,267,2020-10-13 05:00:00,2020-10-13 00:00:00,LABORABLE
13,10,2020,7,393,330,723,2020-10-13 06:00:00,2020-10-13 00:00:00,LABORABLE
13,10,2020,8,684,601,1285,2020-10-13 07:00:00,2020-10-13 00:00:00,LABORABLE
13,10,2020,9,630,660,1290,2020-10-13 08:00:00,2020-10-13 00:00:00,LABORABLE
13,10,2020,10,568,774,1342,2020-10-13 09:00:00,2020-10-13 00:00:00,LABORABLE
13,10,2020,11,432,631,1063,2020-10-13 10:00:00,2020-10-13 00:00:00,LABORABLE
13,10,2020,12,494,685,1179,2020-10-13 11:00:00,2020-10-13 00:00:00,LABORABLE
13,10,2020,13,602,721,1323,2020-10-13 12:00:00,2020-10-13 00:00:00,LABORABLE
13,10,2020,14,549,775,1324,2020-10-13 13:00:00,2020-10-13 00:00:00,LABORABLE
13,10,2020,15,636,830,1466,2020-10-13 14:00:00,2020-10-13 00:00:00,LABORABLE
13,10,2020,16,605,656,1261,2020-10-13 15:00:00,2020-10-13 00:00:00,LABORABLE
13,10,2020,17,565,606,1171,2020-10-13 16:00:00,2020-10-13 00:00:00,LABORABLE
13,10,2020,18,565,751,1316,2020-10-13 17:00:00,2020-10-13 00:00:00,LABORABLE
13,10,2020,19,561,819,1380,2020-10-13 18:00:00,2020-10-13 00:00:00,LABORABLE
13,10,2020,20,605,827,1432,2020-10-13 19:00:00,2020-10-13 00:00:00,LABORABLE
13,10,2020,21,568,695,1263,2020-10-13 20:00:00,2020-10-13 00:00:00,LABORABLE
13,10,2020,22,416,560,976,2020-10-13 21:00:00,2020-10-13 00:00:00,LABORABLE
13,10,2020,23,340,394,734,2020-10-13 22:00:00,2020-10-13 00:00:00,LABORABLE
13,10,2020,24,191,292,483,2020-10-13 23:00:00,2020-10-13 00:00:00,LABORABLE
14,10,2020,1,100,171,271,2020-10-14 00:00:00,2020-10-14 00:00:00,LABORABLE
14,10,2020,2,55,97,152,2020-10-14 01:00:00,2020-10-14 00:00:00,LABORABLE
14,10,2020,3,50,62,112,2020-10-14 02:00:00,2020-10-14 00:00:00,LABORABLE
14,10,2020,4,42,59,101,2020-10-14 03:00:00,2020-10-14 00:00:00,LABORABLE
14,10,2020,5,67,78,145,2020-10-14 04:00:00,2020-10-14 00:00:00,LABORABLE
14,10,2020,6,149,131,280,2020-10-14 05:00:00,2020-10-14 00:00:00,LABORABLE
14,10,2020,7,420,289,709,2020-10-14 06:00:00,2020-10-14 00:00:00,LABORABLE
14,10,2020,8,669,591,1260,2020-10-14 07:00:00,2020-10-14 00:00:00,LABORABLE
14,10,2020,9,656,644,1300,2020-10-14 08:00:00,2020-10-14 00:00:00,LABORABLE
14,10,2020,10,566,794,1360,2020-10-14 09:00:00,2020-10-14 00:00:00,LABORABLE
14,10,2020,11,512,693,1205,2020-10-14 10:00:00,2020-10-14 00:00:00,LABORABLE
14,10,2020,12,434,592,1026,2020-10-14 11:00:00,2020-10-14 00:00:00,LABORABLE
14,10,2020,13,589,758,1347,2020-10-14 12:00:00,2020-10-14 00:00:00,LABORABLE
14,10,2020,14,603,757,1360,2020-10-14 13:00:00,2020-10-14 00:00:00,LABORABLE
14,10,2020,15,668,764,1432,2020-10-14 14:00:00,2020-10-14 00:00:00,LABORABLE
14,10,2020,16,623,671,1294,2020-10-14 15:00:00,2020-10-14 00:00:00,LABORABLE
14,10,2020,17,554,750,1304,2020-10-14 16:00:00,2020-10-14 00:00:00,LABORABLE
14,10,2020,18,637,732,1369,2020-10-14 17:00:00,2020-10-14 00:00:00,LABORABLE
14,10,2020,19,619,829,1448,2020-10-14 18:00:00,2020-10-14 00:00:00,LABORABLE
14,10,2020,20,600,785,1385,2020-10-14 19:00:00,2020-10-14 00:00:00,LABORABLE
14,10,2020,21,557,730,1287,2020-10-14 20:00:00,2020-10-14 00:00:00,LABORABLE
14,10,2020,22,441,559,1000,2020-10-14 21:00:00,2020-10-14 00:00:00,LABORABLE
14,10,2020,23,371,405,776,2020-10-14 22:00:00,2020-10-14 00:00:00,LABORABLE
14,10,2020,24,208,297,505,2020-10-14 23:00:00,2020-10-14 00:00:00,LABORABLE
15,10,2020,1,107,169,276,2020-10-15 00:00:00,2020-10-15 00:00:00,LABORABLE
15,10,2020,2,72,104,176,2020-10-15 01:00:00,2020-10-15 00:00:00,LABORABLE
15,10,2020,3,50,92,142,2020-10-15 02:00:00,2020-10-15 00:00:00,LABORABLE
15,10,2020,4,37,66,103,2020-10-15 03:00:00,2020-10-15 00:00:00,LABORABLE
15,10,2020,5,67,75,142,2020-10-15 04:00:00,2020-10-15 00:00:00,LABORABLE
15,10,2020,6,147,127,274,2020-10-15 05:00:00,2020-10-15 00:00:00,LABORABLE
15,10,2020,7,440,324,764,2020-10-15 06:00:00,2020-10-15 00:00:00,LABORABLE
15,10,2020,8,689,567,1256,2020-10-15 07:00:00,2020-10-15 00:00:00,LABORABLE
15,10,2020,9,675,642,1317,2020-10-15 08:00:00,2020-10-15 00:00:00,LABORABLE
15,10,2020,10,579,742,1321,2020-10-15 09:00:00,2020-10-15 00:00:00,LABORABLE
15,10,2020,11,540,705,1245,2020-10-15 10:00:00,2020-10-15 00:00:00,LABORABLE
15,10,2020,12,538,734,1272,2020-10-15 11:00:00,2020-10-15 00:00:00,LABORABLE
15,10,2020,13,581,734,1315,2020-10-15 12:00:00,2020-10-15 00:00:00,LABORABLE
15,10,2020,14,584,728,1312,2020-10-15 13:00:00,2020-10-15 00:00:00,LABORABLE
15,10,2020,15,589,723,1312,2020-10-15 14:00:00,2020-10-15 00:00:00,LABORABLE
15,10,2020,16,594,693,1287,2020-10-15 15:00:00,2020-10-15 00:00:00,LABORABLE
15,10,2020,17,571,701,1272,2020-10-15 16:00:00,2020-10-15 00:00:00,LABORABLE
15,10,2020,18,595,671,1266,2020-10-15 17:00:00,2020-10-15 00:00:00,LABORABLE
15,10,2020,19,623,820,1443,2020-10-15 18:00:00,2020-10-15 00:00:00,LABORABLE
15,10,2020,20,596,863,1459,2020-10-15 19:00:00,2020-10-15 00:00:00,LABORABLE
15,10,2020,21,553,676,1229,2020-10-15 20:00:00,2020-10-15 00:00:00,LABORABLE
15,10,2020,22,455,545,1000,2020-10-15 21:00:00,2020-10-15 00:00:00,LABORABLE
15,10,2020,23,335,427,762,2020-10-15 22:00:00,2020-10-15 00:00:00,LABORABLE
15,10,2020,24,236,341,577,2020-10-15 23:00:00,2020-10-15 00:00:00,LABORABLE
16,10,2020,1,113,210,323,2020-10-16 00:00:00,2020-10-16 00:00:00,LABORABLE
16,10,2020,2,78,122,200,2020-10-16 01:00:00,2020-10-16 00:00:00,LABORABLE
16,10,2020,3,80,95,175,2020-10-16 02:00:00,2020-10-16 00:00:00,LABORABLE
16,10,2020,4,44,50,94,2020-10-16 03:00:00,2020-10-16 00:00:00,LABORABLE
16,10,2020,5,70,52,122,2020-10-16 04:00:00,2020-10-16 00:00:00,LABORABLE
16,10,2020,6,163,120,283,2020-10-16 05:00:00,2020-10-16 00:00:00,LABORABLE
16,10,2020,7,433,329,762,2020-10-16 06:00:00,2020-10-16 00:00:00,LABORABLE
16,10,2020,8,674,623,1297,2020-10-16 07:00:00,2020-10-16 00:00:00,LABORABLE
16,10,2020,9,695,697,1392,2020-10-16 08:00:00,2020-10-16 00:00:00,LABORABLE
16,10,2020,10,595,811,1406,2020-10-16 09:00:00,2020-10-16 00:00:00,LABORABLE
16,10,2020,11,522,692,1214,2020-10-16 10:00:00,2020-10-16 00:00:00,LABORABLE
16,10,2020,12,515,747,1262,2020-10-16 11:00:00,2020-10-16 00:00:00,LABORABLE
16,10,2020,13,608,733,1341,2020-10-16 12:00:00,2020-10-16 00:00:00,LABORABLE
16,10,2020,14,642,827,1469,2020-10-16 13:00:00,2020-10-16 00:00:00,LABORABLE
16,10,2020,15,675,768,1443,2020-10-16 14:00:00,2020-10-16 00:00:00,LABORABLE
16,10,2020,16,610,722,1332,2020-10-16 15:00:00,2020-10-16 00:00:00,LABORABLE
16,10,2020,17,553,763,1316,2020-10-16 16:00:00,2020-10-16 00:00:00,LABORABLE
16,10,2020,18,594,817,1411,2020-10-16 17:00:00,2020-10-16 00:00:00,LABORABLE
16,10,2020,19,657,786,1443,2020-10-16 18:00:00,2020-10-16 00:00:00,LABORABLE
16,10,2020,20,643,804,1447,2020-10-16 19:00:00,2020-10-16 00:00:00,LABORABLE
16,10,2020,21,617,841,1458,2020-10-16 20:00:00,2020-10-16 00:00:00,LABORABLE
16,10,2020,22,500,714,1214,2020-10-16 21:00:00,2020-10-16 00:00:00,LABORABLE
16,10,2020,23,422,530,952,2020-10-16 22:00:00,2020-10-16 00:00:00,LABORABLE
16,10,2020,24,290,445,735,2020-10-16 23:00:00,2020-10-16 00:00:00,LABORABLE
17,10,2020,1,197,325,522,2020-10-17 00:00:00,2020-10-17 00:00:00,LABORABLE
17,10,2020,2,145,214,359,2020-10-17 01:00:00,2020-10-17 00:00:00,LABORABLE
17,10,2020,3,89,181,270,2020-10-17 02:00:00,2020-10-17 00:00:00,LABORABLE
17,10,2020,4,70,113,183,2020-10-17 03:00:00,2020-10-17 00:00:00,LABORABLE
17,10,2020,5,79,93,172,2020-10-17 04:00:00,2020-10-17 00:00:00,LABORABLE
17,10,2020,6,89,96,185,2020-10-17 05:00:00,2020-10-17 00:00:00,LABORABLE
17,10,2020,7,144,157,301,2020-10-17 06:00:00,2020-10-17 00:00:00,LABORABLE
17,10,2020,8,249,243,492,2020-10-17 07:00:00,2020-10-17 00:00:00,LABORABLE
17,10,2020,9,286,359,645,2020-10-17 08:00:00,2020-10-17 00:00:00,LABORABLE
17,10,2020,10,364,523,887,2020-10-17 09:00:00,2020-10-17 00:00:00,LABORABLE
17,10,2020,11,458,573,1031,2020-10-17 10:00:00,2020-10-17 00:00:00,LABORABLE
17,10,2020,12,478,757,1235,2020-10-17 11:00:00,2020-10-17 00:00:00,LABORABLE
17,10,2020,13,569,752,1321,2020-10-17 12:00:00,2020-10-17 00:00:00,LABORABLE
17,10,2020,14,611,825,1436,2020-10-17 13:00:00,2020-10-17 00:00:00,LABORABLE
17,10,2020,15,530,747,1277,2020-10-17 14:00:00,2020-10-17 00:00:00,LABORABLE
17,10,2020,16,460,655,1115,2020-10-17 15:00:00,2020-10-17 00:00:00,LABORABLE
17,10,2020,17,444,629,1073,2020-10-17 16:00:00,2020-10-17 00:00:00,LABORABLE
17,10,2020,18,474,648,1122,2020-10-17 17:00:00,2020-10-17 00:00:00,LABORABLE
17,10,2020,19,517,722,1239,2020-10-17 18:00:00,2020-10-17 00:00:00,LABORABLE
17,10,2020,20,505,781,1286,2020-10-17 19:00:00,2020-10-17 00:00:00,LABORABLE
17,10,2020,21,482,653,1135,2020-10-17 20:00:00,2020-10-17 00:00:00,LABORABLE
17,10,2020,22,448,616,1064,2020-10-17 21:00:00,2020-10-17 00:00:00,LABORABLE
17,10,2020,23,399,530,929,2020-10-17 22:00:00,2020-10-17 00:00:00,LABORABLE
17,10,2020,24,316,381,697,2020-10-17 23:00:00,2020-10-17 00:00:00,LABORABLE
18,10,2020,1,232,325,557,2020-10-18 00:00:00,2020-10-18 00:00:00,LABORABLE
18,10,2020,2,158,244,402,2020-10-18 01:00:00,2020-10-18 00:00:00,LABORABLE
18,10,2020,3,93,167,260,2020-10-18 02:00:00,2020-10-18 00:00:00,LABORABLE
18,10,2020,4,83,136,219,2020-10-18 03:00:00,2020-10-18 00:00:00,LABORABLE
18,10,2020,5,67,133,200,2020-10-18 04:00:00,2020-10-18 00:00:00,LABORABLE
18,10,2020,6,57,78,135,2020-10-18 05:00:00,2020-10-18 00:00:00,LABORABLE
18,10,2020,7,111,115,226,2020-10-18 06:00:00,2020-10-18 00:00:00,LABORABLE
18,10,2020,8,142,141,283,2020-10-18 07:00:00,2020-10-18 00:00:00,LABORABLE
18,10,2020,9,155,202,357,2020-10-18 08:00:00,2020-10-18 00:00:00,LABORABLE
18,10,2020,10,222,330,552,2020-10-18 09:00:00,2020-10-18 00:00:00,LABORABLE
18,10,2020,11,312,427,739,2020-10-18 10:00:00,2020-10-18 00:00:00,LABORABLE
18,10,2020,12,394,543,937,2020-10-18 11:00:00,2020-10-18 00:00:00,LABORABLE
18,10,2020,13,548,672,1220,2020-10-18 12:00:00,2020-10-18 00:00:00,LABORABLE
18,10,2020,14,487,663,1150,2020-10-18 13:00:00,2020-10-18 00:00:00,LABORABLE
18,10,2020,15,476,743,1219,2020-10-18 14:00:00,2020-10-18 00:00:00,LABORABLE
18,10,2020,16,459,625,1084,2020-10-18 15:00:00,2020-10-18 00:00:00,LABORABLE
18,10,2020,17,410,587,997,2020-10-18 16:00:00,2020-10-18 00:00:00,LABORABLE
18,10,2020,18,438,638,1076,2020-10-18 17:00:00,2020-10-18 00:00:00,LABORABLE
18,10,2020,19,406,648,1054,2020-10-18 18:00:00,2020-10-18 00:00:00,LABORABLE
18,10,2020,20,439,696,1135,2020-10-18 19:00:00,2020-10-18 00:00:00,LABORABLE
18,10,2020,21,438,641,1079,2020-10-18 20:00:00,2020-10-18 00:00:00,LABORABLE
18,10,2020,22,359,532,891,2020-10-18 21:00:00,2020-10-18 00:00:00,LABORABLE
18,10,2020,23,277,397,674,2020-10-18 22:00:00,2020-10-18 00:00:00,LABORABLE
18,10,2020,24,212,347,559,2020-10-18 23:00:00,2020-10-18 00:00:00,LABORABLE
19,10,2020,1,120,241,361,2020-10-19 00:00:00,2020-10-19 00:00:00,LABORABLE
19,10,2020,2,63,149,212,2020-10-19 01:00:00,2020-10-19 00:00:00,LABORABLE
19,10,2020,3,53,108,161,2020-10-19 02:00:00,2020-10-19 00:00:00,LABORABLE
19,10,2020,4,40,67,107,2020-10-19 03:00:00,2020-10-19 00:00:00,LABORABLE
19,10,2020,5,51,88,139,2020-10-19 04:00:00,2020-10-19 00:00:00,LABORABLE
19,10,2020,6,130,115,245,2020-10-19 05:00:00,2020-10-19 00:00:00,LABORABLE
19,10,2020,7,430,302,732,2020-10-19 06:00:00,2020-10-19 00:00:00,LABORABLE
19,10,2020,8,543,443,986,2020-10-19 07:00:00,2020-10-19 00:00:00,LABORABLE
19,10,2020,9,664,600,1264,2020-10-19 08:00:00,2020-10-19 00:00:00,LABORABLE
19,10,2020,10,594,704,1298,2020-10-19 09:00:00,2020-10-19 00:00:00,LABORABLE
19,10,2020,11,501,624,1125,2020-10-19 10:00:00,2020-10-19 00:00:00,LABORABLE
19,10,2020,12,552,624,1176,2020-10-19 11:00:00,2020-10-19 00:00:00,LABORABLE
19,10,2020,13,421,585,1006,2020-10-19 12:00:00,2020-10-19 00:00:00,LABORABLE
19,10,2020,14,646,778,1424,2020-10-19 13:00:00,2020-10-19 00:00:00,LABORABLE
19,10,2020,15,552,662,1214,2020-10-19 14:00:00,2020-10-19 00:00:00,LABORABLE
19,10,2020,16,630,655,1285,2020-10-19 15:00:00,2020-10-19 00:00:00,LABORABLE
19,10,2020,17,561,701,1262,2020-10-19 16:00:00,2020-10-19 00:00:00,LABORABLE
19,10,2020,18,575,707,1282,2020-10-19 17:00:00,2020-10-19 00:00:00,LABORABLE
19,10,2020,19,610,792,1402,2020-10-19 18:00:00,2020-10-19 00:00:00,LABORABLE
19,10,2020,20,606,740,1346,2020-10-19 19:00:00,2020-10-19 00:00:00,LABORABLE
19,10,2020,21,572,736,1308,2020-10-19 20:00:00,2020-10-19 00:00:00,LABORABLE
19,10,2020,22,403,540,943,2020-10-19 21:00:00,2020-10-19 00:00:00,LABORABLE
19,10,2020,23,327,416,743,2020-10-19 22:00:00,2020-10-19 00:00:00,LABORABLE
19,10,2020,24,159,272,431,2020-10-19 23:00:00,2020-10-19 00:00:00,LABORABLE
20,10,2020,1,113,190,303,2020-10-20 00:00:00,2020-10-20 00:00:00,LABORABLE
20,10,2020,2,45,106,151,2020-10-20 01:00:00,2020-10-20 00:00:00,LABORABLE
20,10,2020,3,46,86,132,2020-10-20 02:00:00,2020-10-20 00:00:00,LABORABLE
20,10,2020,4,48,66,114,2020-10-20 03:00:00,2020-10-20 00:00:00,LABORABLE
20,10,2020,5,75,68,143,2020-10-20 04:00:00,2020-10-20 00:00:00,LABORABLE
20,10,2020,6,144,139,283,2020-10-20 05:00:00,2020-10-20 00:00:00,LABORABLE
20,10,2020,7,420,301,721,2020-10-20 06:00:00,2020-10-20 00:00:00,LABORABLE
20,10,2020,8,681,623,1304,2020-10-20 07:00:00,2020-10-20 00:00:00,LABORABLE
20,10,2020,9,662,730,1392,2020-10-20 08:00:00,2020-10-20 00:00:00,LABORABLE
20,10,2020,10,576,775,1351,2020-10-20 09:00:00,2020-10-20 00:00:00,LABORABLE
20,10,2020,11,515,674,1189,2020-10-20 10:00:00,2020-10-20 00:00:00,LABORABLE
20,10,2020,12,520,696,1216,2020-10-20 11:00:00,2020-10-20 00:00:00,LABORABLE
20,10,2020,13,514,745,1259,2020-10-20 12:00:00,2020-10-20 00:00:00,LABORABLE
20,10,2020,14,638,791,1429,2020-10-20 13:00:00,2020-10-20 00:00:00,LABORABLE
20,10,2020,15,674,819,1493,2020-10-20 14:00:00,2020-10-20 00:00:00,LABORABLE
20,10,2020,16,672,684,1356,2020-10-20 15:00:00,2020-10-20 00:00:00,LABORABLE
20,10,2020,17,562,683,1245,2020-10-20 16:00:00,2020-10-20 00:00:00,LABORABLE
20,10,2020,18,602,729,1331,2020-10-20 17:00:00,2020-10-20 00:00:00,LABORABLE
20,10,2020,19,602,856,1458,2020-10-20 18:00:00,2020-10-20 00:00:00,LABORABLE
20,10,2020,20,570,748,1318,2020-10-20 19:00:00,2020-10-20 00:00:00,LABORABLE
20,10,2020,21,534,667,1201,2020-10-20 20:00:00,2020-10-20 00:00:00,LABORABLE
20,10,2020,22,373,527,900,2020-10-20 21:00:00,2020-10-20 00:00:00,LABORABLE
20,10,2020,23,309,414,723,2020-10-20 22:00:00,2020-10-20 00:00:00,LABORABLE
20,10,2020,24,158,285,443,2020-10-20 23:00:00,2020-10-20 00:00:00,LABORABLE
21,10,2020,1,83,156,239,2020-10-21 00:00:00,2020-10-21 00:00:00,LABORABLE
21,10,2020,2,52,128,180,2020-10-21 01:00:00,2020-10-21 00:00:00,LABORABLE
21,10,2020,3,34,61,95,2020-10-21 02:00:00,2020-10-21 00:00:00,LABORABLE
21,10,2020,4,33,65,98,2020-10-21 03:00:00,2020-10-21 00:00:00,LABORABLE
21,10,2020,5,66,69,135,2020-10-21 04:00:00,2020-10-21 00:00:00,LABORABLE
21,10,2020,6,155,143,298,2020-10-21 05:00:00,2020-10-21 00:00:00,LABORABLE
21,10,2020,7,465,296,761,2020-10-21 06:00:00,2020-10-21 00:00:00,LABORABLE
21,10,2020,8,698,601,1299,2020-10-21 07:00:00,2020-10-21 00:00:00,LABORABLE
21,10,2020,9,669,659,1328,2020-10-21 08:00:00,2020-10-21 00:00:00,LABORABLE
21,10,2020,10,613,805,1418,2020-10-21 09:00:00,2020-10-21 00:00:00,LABORABLE
21,10,2020,11,565,651,1216,2020-10-21 10:00:00,2020-10-21 00:00:00,LABORABLE
21,10,2020,12,571,720,1291,2020-10-21 11:00:00,2020-10-21 00:00:00,LABORABLE
21,10,2020,13,317,569,886,2020-10-21 12:00:00,2020-10-21 00:00:00,LABORABLE
21,10,2020,14,628,720,1348,2020-10-21 13:00:00,2020-10-21 00:00:00,LABORABLE
21,10,2020,15,617,749,1366,2020-10-21 14:00:00,2020-10-21 00:00:00,LABORABLE
21,10,2020,16,608,640,1248,2020-10-21 15:00:00,2020-10-21 00:00:00,LABORABLE
21,10,2020,17,593,739,1332,2020-10-21 16:00:00,2020-10-21 00:00:00,LABORABLE
21,10,2020,18,615,738,1353,2020-10-21 17:00:00,2020-10-21 00:00:00,LABORABLE
21,10,2020,19,650,797,1447,2020-10-21 18:00:00,2020-10-21 00:00:00,LABORABLE
21,10,2020,20,617,748,1365,2020-10-21 19:00:00,2020-10-21 00:00:00,LABORABLE
21,10,2020,21,565,714,1279,2020-10-21 20:00:00,2020-10-21 00:00:00,LABORABLE
21,10,2020,22,405,549,954,2020-10-21 21:00:00,2020-10-21 00:00:00,LABORABLE
21,10,2020,23,343,387,730,2020-10-21 22:00:00,2020-10-21 00:00:00,LABORABLE
21,10,2020,24,193,285,478,2020-10-21 23:00:00,2020-10-21 00:00:00,LABORABLE
22,10,2020,1,100,152,252,2020-10-22 00:00:00,2020-10-22 00:00:00,LABORABLE
22,10,2020,2,62,116,178,2020-10-22 01:00:00,2020-10-22 00:00:00,LABORABLE
22,10,2020,3,49,79,128,2020-10-22 02:00:00,2020-10-22 00:00:00,LABORABLE
22,10,2020,4,45,69,114,2020-10-22 03:00:00,2020-10-22 00:00:00,LABORABLE
22,10,2020,5,70,62,132,2020-10-22 04:00:00,2020-10-22 00:00:00,LABORABLE
22,10,2020,6,151,128,279,2020-10-22 05:00:00,2020-10-22 00:00:00,LABORABLE
22,10,2020,7,423,320,743,2020-10-22 06:00:00,2020-10-22 00:00:00,LABORABLE
22,10,2020,8,715,631,1346,2020-10-22 07:00:00,2020-10-22 00:00:00,LABORABLE
22,10,2020,9,686,732,1418,2020-10-22 08:00:00,2020-10-22 00:00:00,LABORABLE
22,10,2020,10,661,778,1439,2020-10-22 09:00:00,2020-10-22 00:00:00,LABORABLE
22,10,2020,11,426,552,978,2020-10-22 10:00:00,2020-10-22 00:00:00,LABORABLE
22,10,2020,12,540,712,1252,2020-10-22 11:00:00,2020-10-22 00:00:00,LABORABLE
22,10,2020,13,592,714,1306,2020-10-22 12:00:00,2020-10-22 00:00:00,LABORABLE
22,10,2020,14,302,550,852,2020-10-22 13:00:00,2020-10-22 00:00:00,LABORABLE
22,10,2020,15,97,379,476,2020-10-22 14:00:00,2020-10-22 00:00:00,LABORABLE
22,10,2020,16,616,703,1319,2020-10-22 15:00:00,2020-10-22 00:00:00,LABORABLE
22,10,2020,17,572,778,1350,2020-10-22 16:00:00,2020-10-22 00:00:00,LABORABLE
22,10,2020,18,686,668,1354,2020-10-22 17:00:00,2020-10-22 00:00:00,LABORABLE
22,10,2020,19,679,773,1452,2020-10-22 18:00:00,2020-10-22 00:00:00,LABORABLE
22,10,2020,20,637,781,1418,2020-10-22 19:00:00,2020-10-22 00:00:00,LABORABLE
22,10,2020,21,560,675,1235,2020-10-22 20:00:00,2020-10-22 00:00:00,LABORABLE
22,10,2020,22,466,570,1036,2020-10-22 21:00:00,2020-10-22 00:00:00,LABORABLE
22,10,2020,23,335,450,785,2020-10-22 22:00:00,2020-10-22 00:00:00,LABORABLE
22,10,2020,24,224,323,547,2020-10-22 23:00:00,2020-10-22 00:00:00,LABORABLE
23,10,2020,1,105,204,309,2020-10-23 00:00:00,2020-10-23 00:00:00,LABORABLE
23,10,2020,2,55,98,153,2020-10-23 01:00:00,2020-10-23 00:00:00,LABORABLE
23,10,2020,3,49,92,141,2020-10-23 02:00:00,2020-10-23 00:00:00,LABORABLE
23,10,2020,4,39,50,89,2020-10-23 03:00:00,2020-10-23 00:00:00,LABORABLE
23,10,2020,5,72,47,119,2020-10-23 04:00:00,2020-10-23 00:00:00,LABORABLE
23,10,2020,6,166,124,290,2020-10-23 05:00:00,2020-10-23 00:00:00,LABORABLE
23,10,2020,7,411,309,720,2020-10-23 06:00:00,2020-10-23 00:00:00,LABORABLE
23,10,2020,8,673,636,1309,2020-10-23 07:00:00,2020-10-23 00:00:00,LABORABLE
23,10,2020,9,680,629,1309,2020-10-23 08:00:00,2020-10-23 00:00:00,LABORABLE
23,10,2020,10,576,807,1383,2020-10-23 09:00:00,2020-10-23 00:00:00,LABORABLE
23,10,2020,11,545,671,1216,2020-10-23 10:00:00,2020-10-23 00:00:00,LABORABLE
23,10,2020,12,555,731,1286,2020-10-23 11:00:00,2020-10-23 00:00:00,LABORABLE
23,10,2020,13,618,721,1339,2020-10-23 12:00:00,2020-10-23 00:00:00,LABORABLE
23,10,2020,14,667,819,1486,2020-10-23 13:00:00,2020-10-23 00:00:00,LABORABLE
23,10,2020,15,580,809,1389,2020-10-23 14:00:00,2020-10-23 00:00:00,LABORABLE
23,10,2020,16,595,813,1408,2020-10-23 15:00:00,2020-10-23 00:00:00,LABORABLE
23,10,2020,17,584,729,1313,2020-10-23 16:00:00,2020-10-23 00:00:00,LABORABLE
23,10,2020,18,668,859,1527,2020-10-23 17:00:00,2020-10-23 00:00:00,LABORABLE
23,10,2020,19,658,862,1520,2020-10-23 18:00:00,2020-10-23 00:00:00,LABORABLE
23,10,2020,20,626,852,1478,2020-10-23 19:00:00,2020-10-23 00:00:00,LABORABLE
23,10,2020,21,639,814,1453,2020-10-23 20:00:00,2020-10-23 00:00:00,LABORABLE
23,10,2020,22,517,652,1169,2020-10-23 21:00:00,2020-10-23 00:00:00,LABORABLE
23,10,2020,23,359,554,913,2020-10-23 22:00:00,2020-10-23 00:00:00,LABORABLE
23,10,2020,24,351,425,776,2020-10-23 23:00:00,2020-10-23 00:00:00,LABORABLE
24,10,2020,1,208,320,528,2020-10-24 00:00:00,2020-10-24 00:00:00,LABORABLE
24,10,2020,2,118,188,306,2020-10-24 01:00:00,2020-10-24 00:00:00,LABORABLE
24,10,2020,3,85,178,263,2020-10-24 02:00:00,2020-10-24 00:00:00,LABORABLE
24,10,2020,4,62,103,165,2020-10-24 03:00:00,2020-10-24 00:00:00,LABORABLE
24,10,2020,5,79,92,171,2020-10-24 04:00:00,2020-10-24 00:00:00,LABORABLE
24,10,2020,6,100,102,202,2020-10-24 05:00:00,2020-10-24 00:00:00,LABORABLE
24,10,2020,7,191,164,355,2020-10-24 06:00:00,2020-10-24 00:00:00,LABORABLE
24,10,2020,8,247,265,512,2020-10-24 07:00:00,2020-10-24 00:00:00,LABORABLE
24,10,2020,9,308,340,648,2020-10-24 08:00:00,2020-10-24 00:00:00,LABORABLE
24,10,2020,10,377,485,862,2020-10-24 09:00:00,2020-10-24 00:00:00,LABORABLE
24,10,2020,11,457,630,1087,2020-10-24 10:00:00,2020-10-24 00:00:00,LABORABLE
24,10,2020,12,542,702,1244,2020-10-24 11:00:00,2020-10-24 00:00:00,LABORABLE
24,10,2020,13,639,797,1436,2020-10-24 12:00:00,2020-10-24 00:00:00,LABORABLE
24,10,2020,14,570,827,1397,2020-10-24 13:00:00,2020-10-24 00:00:00,LABORABLE
24,10,2020,15,587,860,1447,2020-10-24 14:00:00,2020-10-24 00:00:00,LABORABLE
24,10,2020,16,509,691,1200,2020-10-24 15:00:00,2020-10-24 00:00:00,LABORABLE
24,10,2020,17,430,665,1095,2020-10-24 16:00:00,2020-10-24 00:00:00,LABORABLE
24,10,2020,18,491,677,1168,2020-10-24 17:00:00,2020-10-24 00:00:00,LABORABLE
24,10,2020,19,634,783,1417,2020-10-24 18:00:00,2020-10-24 00:00:00,LABORABLE
24,10,2020,20,584,798,1382,2020-10-24 19:00:00,2020-10-24 00:00:00,LABORABLE
24,10,2020,21,514,728,1242,2020-10-24 20:00:00,2020-10-24 00:00:00,LABORABLE
24,10,2020,22,467,636,1103,2020-10-24 21:00:00,2020-10-24 00:00:00,LABORABLE
24,10,2020,23,439,552,991,2020-10-24 22:00:00,2020-10-24 00:00:00,LABORABLE
24,10,2020,24,361,402,763,2020-10-24 23:00:00,2020-10-24 00:00:00,LABORABLE
25,10,2020,1,237,342,579,2020-10-25 00:00:00,2020-10-25 00:00:00,LABORABLE
25,10,2020,2,106,234,340,2020-10-25 01:00:00,2020-10-25 00:00:00,LABORABLE
25,10,2020,3,79,166,245,2020-10-25 02:00:00,2020-10-25 00:00:00,LABORABLE
25,10,2020,4,41,96,137,2020-10-25 03:00:00,2020-10-25 00:00:00,LABORABLE
25,10,2020,5,39,99,138,2020-10-25 04:00:00,2020-10-25 00:00:00,LABORABLE
25,10,2020,6,72,82,154,2020-10-25 05:00:00,2020-10-25 00:00:00,LABORABLE
25,10,2020,7,115,129,244,2020-10-25 06:00:00,2020-10-25 00:00:00,LABORABLE
25,10,2020,8,143,147,290,2020-10-25 07:00:00,2020-10-25 00:00:00,LABORABLE
25,10,2020,9,217,249,466,2020-10-25 08:00:00,2020-10-25 00:00:00,LABORABLE
25,10,2020,10,309,386,695,2020-10-25 09:00:00,2020-10-25 00:00:00,LABORABLE
25,10,2020,11,445,519,964,2020-10-25 10:00:00,2020-10-25 00:00:00,LABORABLE
25,10,2020,12,514,627,1141,2020-10-25 11:00:00,2020-10-25 00:00:00,LABORABLE
25,10,2020,13,562,750,1312,2020-10-25 12:00:00,2020-10-25 00:00:00,LABORABLE
25,10,2020,14,520,714,1234,2020-10-25 13:00:00,2020-10-25 00:00:00,LABORABLE
25,10,2020,15,541,711,1252,2020-10-25 14:00:00,2020-10-25 00:00:00,LABORABLE
25,10,2020,16,426,604,1030,2020-10-25 15:00:00,2020-10-25 00:00:00,LABORABLE
25,10,2020,17,411,639,1050,2020-10-25 16:00:00,2020-10-25 00:00:00,LABORABLE
25,10,2020,18,484,696,1180,2020-10-25 17:00:00,2020-10-25 00:00:00,LABORABLE
25,10,2020,19,510,627,1137,2020-10-25 18:00:00,2020-10-25 00:00:00,LABORABLE
25,10,2020,20,491,599,1090,2020-10-25 19:00:00,2020-10-25 00:00:00,LABORABLE
25,10,2020,21,406,532,938,2020-10-25 20:00:00,2020-10-25 00:00:00,LABORABLE
25,10,2020,22,377,502,879,2020-10-25 21:00:00,2020-10-25 00:00:00,LABORABLE
25,10,2020,23,282,339,621,2020-10-25 22:00:00,2020-10-25 00:00:00,LABORABLE
25,10,2020,24,167,281,448,2020-10-25 23:00:00,2020-10-25 00:00:00,LABORABLE
26,10,2020,1,103,193,296,2020-10-26 00:00:00,2020-10-26 00:00:00,LABORABLE
26,10,2020,2,49,110,159,2020-10-26 01:00:00,2020-10-26 00:00:00,LABORABLE
26,10,2020,3,40,90,130,2020-10-26 02:00:00,2020-10-26 00:00:00,LABORABLE
26,10,2020,4,40,61,101,2020-10-26 03:00:00,2020-10-26 00:00:00,LABORABLE
26,10,2020,5,39,60,99,2020-10-26 04:00:00,2020-10-26 00:00:00,LABORABLE
26,10,2020,6,147,119,266,2020-10-26 05:00:00,2020-10-26 00:00:00,LABORABLE
26,10,2020,7,423,337,760,2020-10-26 06:00:00,2020-10-26 00:00:00,LABORABLE
26,10,2020,8,726,636,1362,2020-10-26 07:00:00,2020-10-26 00:00:00,LABORABLE
26,10,2020,9,677,686,1363,2020-10-26 08:00:00,2020-10-26 00:00:00,LABORABLE
26,10,2020,10,626,779,1405,2020-10-26 09:00:00,2020-10-26 00:00:00,LABORABLE
26,10,2020,11,622,738,1360,2020-10-26 10:00:00,2020-10-26 00:00:00,LABORABLE
26,10,2020,12,598,778,1376,2020-10-26 11:00:00,2020-10-26 00:00:00,LABORABLE
26,10,2020,13,462,679,1141,2020-10-26 12:00:00,2020-10-26 00:00:00,LABORABLE
26,10,2020,14,587,740,1327,2020-10-26 13:00:00,2020-10-26 00:00:00,LABORABLE
26,10,2020,15,622,707,1329,2020-10-26 14:00:00,2020-10-26 00:00:00,LABORABLE
26,10,2020,16,645,691,1336,2020-10-26 15:00:00,2020-10-26 00:00:00,LABORABLE
26,10,2020,17,588,735,1323,2020-10-26 16:00:00,2020-10-26 00:00:00,LABORABLE
26,10,2020,18,623,755,1378,2020-10-26 17:00:00,2020-10-26 00:00:00,LABORABLE
26,10,2020,19,658,804,1462,2020-10-26 18:00:00,2020-10-26 00:00:00,LABORABLE
26,10,2020,20,579,809,1388,2020-10-26 19:00:00,2020-10-26 00:00:00,LABORABLE
26,10,2020,21,547,649,1196,2020-10-26 20:00:00,2020-10-26 00:00:00,LABORABLE
26,10,2020,22,392,483,875,2020-10-26 21:00:00,2020-10-26 00:00:00,LABORABLE
26,10,2020,23,341,369,710,2020-10-26 22:00:00,2020-10-26 00:00:00,LABORABLE
26,10,2020,24,164,214,378,2020-10-26 23:00:00,2020-10-26 00:00:00,LABORABLE
27,10,2020,1,64,158,222,2020-10-27 00:00:00,2020-10-27 00:00:00,LABORABLE
27,10,2020,2,43,95,138,2020-10-27 01:00:00,2020-10-27 00:00:00,LABORABLE
27,10,2020,3,32,74,106,2020-10-27 02:00:00,2020-10-27 00:00:00,LABORABLE
27,10,2020,4,41,55,96,2020-10-27 03:00:00,2020-10-27 00:00:00,LABORABLE
27,10,2020,5,57,57,114,2020-10-27 04:00:00,2020-10-27 00:00:00,LABORABLE
27,10,2020,6,150,112,262,2020-10-27 05:00:00,2020-10-27 00:00:00,LABORABLE
27,10,2020,7,422,297,719,2020-10-27 06:00:00,2020-10-27 00:00:00,LABORABLE
27,10,2020,8,694,611,1305,2020-10-27 07:00:00,2020-10-27 00:00:00,LABORABLE
27,10,2020,9,689,691,1380,2020-10-27 08:00:00,2020-10-27 00:00:00,LABORABLE
27,10,2020,10,662,801,1463,2020-10-27 09:00:00,2020-10-27 00:00:00,LABORABLE
27,10,2020,11,572,684,1256,2020-10-27 10:00:00,2020-10-27 00:00:00,LABORABLE
27,10,2020,12,569,738,1307,2020-10-27 11:00:00,2020-10-27 00:00:00,LABORABLE
27,10,2020,13,602,800,1402,2020-10-27 12:00:00,2020-10-27 00:00:00,LABORABLE
27,10,2020,14,637,747,1384,2020-10-27 13:00:00,2020-10-27 00:00:00,LABORABLE
27,10,2020,15,628,814,1442,2020-10-27 14:00:00,2020-10-27 00:00:00,LABORABLE
27,10,2020,16,609,666,1275,2020-10-27 15:00:00,2020-10-27 00:00:00,LABORABLE
27,10,2020,17,625,739,1364,2020-10-27 16:00:00,2020-10-27 00:00:00,LABORABLE
27,10,2020,18,629,735,1364,2020-10-27 17:00:00,2020-10-27 00:00:00,LABORABLE
27,10,2020,19,661,817,1478,2020-10-27 18:00:00,2020-10-27 00:00:00,LABORABLE
27,10,2020,20,601,797,1398,2020-10-27 19:00:00,2020-10-27 00:00:00,LABORABLE
27,10,2020,21,564,703,1267,2020-10-27 20:00:00,2020-10-27 00:00:00,LABORABLE
27,10,2020,22,424,542,966,2020-10-27 21:00:00,2020-10-27 00:00:00,LABORABLE
27,10,2020,23,316,375,691,2020-10-27 22:00:00,2020-10-27 00:00:00,LABORABLE
27,10,2020,24,172,263,435,2020-10-27 23:00:00,2020-10-27 00:00:00,LABORABLE
28,10,2020,1,105,145,250,2020-10-28 00:00:00,2020-10-28 00:00:00,LABORABLE
28,10,2020,2,43,79,122,2020-10-28 01:00:00,2020-10-28 00:00:00,LABORABLE
28,10,2020,3,41,43,84,2020-10-28 02:00:00,2020-10-28 00:00:00,LABORABLE
28,10,2020,4,34,45,79,2020-10-28 03:00:00,2020-10-28 00:00:00,LABORABLE
28,10,2020,5,50,58,108,2020-10-28 04:00:00,2020-10-28 00:00:00,LABORABLE
28,10,2020,6,140,113,253,2020-10-28 05:00:00,2020-10-28 00:00:00,LABORABLE
28,10,2020,7,437,318,755,2020-10-28 06:00:00,2020-10-28 00:00:00,LABORABLE
28,10,2020,8,677,598,1275,2020-10-28 07:00:00,2020-10-28 00:00:00,LABORABLE
28,10,2020,9,711,685,1396,2020-10-28 08:00:00,2020-10-28 00:00:00,LABORABLE
28,10,2020,10,647,740,1387,2020-10-28 09:00:00,2020-10-28 00:00:00,LABORABLE
28,10,2020,11,511,683,1194,2020-10-28 10:00:00,2020-10-28 00:00:00,LABORABLE
28,10,2020,12,581,737,1318,2020-10-28 11:00:00,2020-10-28 00:00:00,LABORABLE
28,10,2020,13,633,767,1400,2020-10-28 12:00:00,2020-10-28 00:00:00,LABORABLE
28,10,2020,14,678,774,1452,2020-10-28 13:00:00,2020-10-28 00:00:00,LABORABLE
28,10,2020,15,681,718,1399,2020-10-28 14:00:00,2020-10-28 00:00:00,LABORABLE
28,10,2020,16,630,650,1280,2020-10-28 15:00:00,2020-10-28 00:00:00,LABORABLE
28,10,2020,17,646,714,1360,2020-10-28 16:00:00,2020-10-28 00:00:00,LABORABLE
28,10,2020,18,603,772,1375,2020-10-28 17:00:00,2020-10-28 00:00:00,LABORABLE
28,10,2020,19,667,736,1403,2020-10-28 18:00:00,2020-10-28 00:00:00,LABORABLE
28,10,2020,20,574,788,1362,2020-10-28 19:00:00,2020-10-28 00:00:00,LABORABLE
28,10,2020,21,585,706,1291,2020-10-28 20:00:00,2020-10-28 00:00:00,LABORABLE
28,10,2020,22,429,570,999,2020-10-28 21:00:00,2020-10-28 00:00:00,LABORABLE
28,10,2020,23,367,424,791,2020-10-28 22:00:00,2020-10-28 00:00:00,LABORABLE
28,10,2020,24,195,247,442,2020-10-28 23:00:00,2020-10-28 00:00:00,LABORABLE
29,10,2020,1,97,165,262,2020-10-29 00:00:00,2020-10-29 00:00:00,LABORABLE
29,10,2020,2,50,91,141,2020-10-29 01:00:00,2020-10-29 00:00:00,LABORABLE
29,10,2020,3,29,71,100,2020-10-29 02:00:00,2020-10-29 00:00:00,LABORABLE
29,10,2020,4,41,51,92,2020-10-29 03:00:00,2020-10-29 00:00:00,LABORABLE
29,10,2020,5,55,60,115,2020-10-29 04:00:00,2020-10-29 00:00:00,LABORABLE
29,10,2020,6,153,132,285,2020-10-29 05:00:00,2020-10-29 00:00:00,LABORABLE
29,10,2020,7,436,332,768,2020-10-29 06:00:00,2020-10-29 00:00:00,LABORABLE
29,10,2020,8,709,617,1326,2020-10-29 07:00:00,2020-10-29 00:00:00,LABORABLE
29,10,2020,9,681,674,1355,2020-10-29 08:00:00,2020-10-29 00:00:00,LABORABLE
29,10,2020,10,706,759,1465,2020-10-29 09:00:00,2020-10-29 00:00:00,LABORABLE
29,10,2020,11,652,695,1347,2020-10-29 10:00:00,2020-10-29 00:00:00,LABORABLE
29,10,2020,12,649,772,1421,2020-10-29 11:00:00,2020-10-29 00:00:00,LABORABLE
29,10,2020,13,658,755,1413,2020-10-29 12:00:00,2020-10-29 00:00:00,LABORABLE
29,10,2020,14,671,807,1478,2020-10-29 13:00:00,2020-10-29 00:00:00,LABORABLE
29,10,2020,15,657,795,1452,2020-10-29 14:00:00,2020-10-29 00:00:00,LABORABLE
29,10,2020,16,643,727,1370,2020-10-29 15:00:00,2020-10-29 00:00:00,LABORABLE
29,10,2020,17,586,839,1425,2020-10-29 16:00:00,2020-10-29 00:00:00,LABORABLE
29,10,2020,18,645,738,1383,2020-10-29 17:00:00,2020-10-29 00:00:00,LABORABLE
29,10,2020,19,697,842,1539,2020-10-29 18:00:00,2020-10-29 00:00:00,LABORABLE
29,10,2020,20,619,788,1407,2020-10-29 19:00:00,2020-10-29 00:00:00,LABORABLE
29,10,2020,21,598,672,1270,2020-10-29 20:00:00,2020-10-29 00:00:00,LABORABLE
29,10,2020,22,465,588,1053,2020-10-29 21:00:00,2020-10-29 00:00:00,LABORABLE
29,10,2020,23,373,465,838,2020-10-29 22:00:00,2020-10-29 00:00:00,LABORABLE
29,10,2020,24,218,286,504,2020-10-29 23:00:00,2020-10-29 00:00:00,LABORABLE
30,10,2020,1,113,206,319,2020-10-30 00:00:00,2020-10-30 00:00:00,LABORABLE
30,10,2020,2,60,104,164,2020-10-30 01:00:00,2020-10-30 00:00:00,LABORABLE
30,10,2020,3,33,82,115,2020-10-30 02:00:00,2020-10-30 00:00:00,LABORABLE
30,10,2020,4,43,50,93,2020-10-30 03:00:00,2020-10-30 00:00:00,LABORABLE
30,10,2020,5,64,54,118,2020-10-30 04:00:00,2020-10-30 00:00:00,LABORABLE
30,10,2020,6,142,113,255,2020-10-30 05:00:00,2020-10-30 00:00:00,LABORABLE
30,10,2020,7,396,301,697,2020-10-30 06:00:00,2020-10-30 00:00:00,LABORABLE
30,10,2020,8,690,585,1275,2020-10-30 07:00:00,2020-10-30 00:00:00,LABORABLE
30,10,2020,9,657,698,1355,2020-10-30 08:00:00,2020-10-30 00:00:00,LABORABLE
30,10,2020,10,642,768,1410,2020-10-30 09:00:00,2020-10-30 00:00:00,LABORABLE
30,10,2020,11,584,707,1291,2020-10-30 10:00:00,2020-10-30 00:00:00,LABORABLE
30,10,2020,12,614,710,1324,2020-10-30 11:00:00,2020-10-30 00:00:00,LABORABLE
30,10,2020,13,589,794,1383,2020-10-30 12:00:00,2020-10-30 00:00:00,LABORABLE
30,10,2020,14,682,868,1550,2020-10-30 13:00:00,2020-10-30 00:00:00,LABORABLE
30,10,2020,15,700,803,1503,2020-10-30 14:00:00,2020-10-30 00:00:00,LABORABLE
30,10,2020,16,632,770,1402,2020-10-30 15:00:00,2020-10-30 00:00:00,LABORABLE
30,10,2020,17,619,740,1359,2020-10-30 16:00:00,2020-10-30 00:00:00,LABORABLE
30,10,2020,18,692,818,1510,2020-10-30 17:00:00,2020-10-30 00:00:00,LABORABLE
30,10,2020,19,647,879,1526,2020-10-30 18:00:00,2020-10-30 00:00:00,LABORABLE
30,10,2020,20,643,855,1498,2020-10-30 19:00:00,2020-10-30 00:00:00,LABORABLE
30,10,2020,21,618,834,1452,2020-10-30 20:00:00,2020-10-30 00:00:00,LABORABLE
30,10,2020,22,506,670,1176,2020-10-30 21:00:00,2020-10-30 00:00:00,LABORABLE
30,10,2020,23,438,591,1029,2020-10-30 22:00:00,2020-10-30 00:00:00,LABORABLE
30,10,2020,24,340,373,713,2020-10-30 23:00:00,2020-10-30 00:00:00,LABORABLE
31,10,2020,1,205,308,513,2020-10-31 00:00:00,2020-10-31 00:00:00,LABORABLE
31,10,2020,2,91,162,253,2020-10-31 01:00:00,2020-10-31 00:00:00,LABORABLE
31,10,2020,3,57,105,162,2020-10-31 02:00:00,2020-10-31 00:00:00,LABORABLE
31,10,2020,4,55,89,144,2020-10-31 03:00:00,2020-10-31 00:00:00,LABORABLE
31,10,2020,5,46,72,118,2020-10-31 04:00:00,2020-10-31 00:00:00,LABORABLE
31,10,2020,6,81,78,159,2020-10-31 05:00:00,2020-10-31 00:00:00,LABORABLE
31,10,2020,7,151,143,294,2020-10-31 06:00:00,2020-10-31 00:00:00,LABORABLE
31,10,2020,8,287,241,528,2020-10-31 07:00:00,2020-10-31 00:00:00,LABORABLE
31,10,2020,9,283,359,642,2020-10-31 08:00:00,2020-10-31 00:00:00,LABORABLE
31,10,2020,10,460,506,966,2020-10-31 09:00:00,2020-10-31 00:00:00,LABORABLE
31,10,2020,11,546,605,1151,2020-10-31 10:00:00,2020-10-31 00:00:00,LABORABLE
31,10,2020,12,590,758,1348,2020-10-31 11:00:00,2020-10-31 00:00:00,LABORABLE
31,10,2020,13,632,872,1504,2020-10-31 12:00:00,2020-10-31 00:00:00,LABORABLE
31,10,2020,14,638,842,1480,2020-10-31 13:00:00,2020-10-31 00:00:00,LABORABLE
31,10,2020,15,618,847,1465,2020-10-31 14:00:00,2020-10-31 00:00:00,LABORABLE
31,10,2020,16,532,716,1248,2020-10-31 15:00:00,2020-10-31 00:00:00,LABORABLE
31,10,2020,17,512,674,1186,2020-10-31 16:00:00,2020-10-31 00:00:00,LABORABLE
31,10,2020,18,528,811,1339,2020-10-31 17:00:00,2020-10-31 00:00:00,LABORABLE
31,10,2020,19,600,838,1438,2020-10-31 18:00:00,2020-10-31 00:00:00,LABORABLE
31,10,2020,20,556,759,1315,2020-10-31 19:00:00,2020-10-31 00:00:00,LABORABLE
31,10,2020,21,539,724,1263,2020-10-31 20:00:00,2020-10-31 00:00:00,LABORABLE
31,10,2020,22,458,642,1100,2020-10-31 21:00:00,2020-10-31 00:00:00,LABORABLE
31,10,2020,23,430,571,1001,2020-10-31 22:00:00,2020-10-31 00:00:00,LABORABLE
31,10,2020,24,409,442,851,2020-10-31 23:00:00,2020-10-31 00:00:00,LABORABLE
1,11,2020,1,193,328,521,2020-11-01 00:00:00,2020-01-11 00:00:00,LABORABLE
1,11,2020,2,95,220,315,2020-11-01 01:00:00,2020-01-11 00:00:00,LABORABLE
1,11,2020,3,60,122,182,2020-11-01 02:00:00,2020-01-11 00:00:00,LABORABLE
1,11,2020,4,47,76,123,2020-11-01 03:00:00,2020-01-11 00:00:00,LABORABLE
1,11,2020,5,34,94,128,2020-11-01 04:00:00,2020-01-11 00:00:00,LABORABLE
1,11,2020,6,36,69,105,2020-11-01 05:00:00,2020-01-11 00:00:00,LABORABLE
1,11,2020,7,93,112,205,2020-11-01 06:00:00,2020-01-11 00:00:00,LABORABLE
1,11,2020,8,157,146,303,2020-11-01 07:00:00,2020-01-11 00:00:00,LABORABLE
1,11,2020,9,199,219,418,2020-11-01 08:00:00,2020-01-11 00:00:00,LABORABLE
1,11,2020,10,322,399,721,2020-11-01 09:00:00,2020-01-11 00:00:00,LABORABLE
1,11,2020,11,437,521,958,2020-11-01 10:00:00,2020-01-11 00:00:00,LABORABLE
1,11,2020,12,543,658,1201,2020-11-01 11:00:00,2020-01-11 00:00:00,LABORABLE
1,11,2020,13,569,713,1282,2020-11-01 12:00:00,2020-01-11 00:00:00,LABORABLE
1,11,2020,14,571,690,1261,2020-11-01 13:00:00,2020-01-11 00:00:00,LABORABLE
1,11,2020,15,564,755,1319,2020-11-01 14:00:00,2020-01-11 00:00:00,LABORABLE
1,11,2020,16,433,626,1059,2020-11-01 15:00:00,2020-01-11 00:00:00,LABORABLE
1,11,2020,17,387,583,970,2020-11-01 16:00:00,2020-01-11 00:00:00,LABORABLE
1,11,2020,18,509,663,1172,2020-11-01 17:00:00,2020-01-11 00:00:00,LABORABLE
1,11,2020,19,497,671,1168,2020-11-01 18:00:00,2020-01-11 00:00:00,LABORABLE
1,11,2020,20,523,604,1127,2020-11-01 19:00:00,2020-01-11 00:00:00,LABORABLE
1,11,2020,21,452,614,1066,2020-11-01 20:00:00,2020-01-11 00:00:00,LABORABLE
1,11,2020,22,422,547,969,2020-11-01 21:00:00,2020-01-11 00:00:00,LABORABLE
1,11,2020,23,336,363,699,2020-11-01 22:00:00,2020-01-11 00:00:00,LABORABLE
1,11,2020,24,294,361,655,2020-11-01 23:00:00,2020-01-11 00:00:00,LABORABLE
2,11,2020,1,166,211,377,2020-11-02 00:00:00,2020-02-11 00:00:00,FESTIVO
2,11,2020,2,67,131,198,2020-11-02 01:00:00,2020-02-11 00:00:00,FESTIVO
2,11,2020,3,35,94,129,2020-11-02 02:00:00,2020-02-11 00:00:00,FESTIVO
2,11,2020,4,33,61,94,2020-11-02 03:00:00,2020-02-11 00:00:00,FESTIVO
2,11,2020,5,30,49,79,2020-11-02 04:00:00,2020-02-11 00:00:00,FESTIVO
2,11,2020,6,60,65,125,2020-11-02 05:00:00,2020-02-11 00:00:00,FESTIVO
2,11,2020,7,135,165,300,2020-11-02 06:00:00,2020-02-11 00:00:00,FESTIVO
2,11,2020,8,221,274,495,2020-11-02 07:00:00,2020-02-11 00:00:00,FESTIVO
2,11,2020,9,233,384,617,2020-11-02 08:00:00,2020-02-11 00:00:00,FESTIVO
2,11,2020,10,327,514,841,2020-11-02 09:00:00,2020-02-11 00:00:00,FESTIVO
2,11,2020,11,405,541,946,2020-11-02 10:00:00,2020-02-11 00:00:00,FESTIVO
2,11,2020,12,475,696,1171,2020-11-02 11:00:00,2020-02-11 00:00:00,FESTIVO
2,11,2020,13,510,698,1208,2020-11-02 12:00:00,2020-02-11 00:00:00,FESTIVO
2,11,2020,14,485,674,1159,2020-11-02 13:00:00,2020-02-11 00:00:00,FESTIVO
2,11,2020,15,459,661,1120,2020-11-02 14:00:00,2020-02-11 00:00:00,FESTIVO
2,11,2020,16,374,560,934,2020-11-02 15:00:00,2020-02-11 00:00:00,FESTIVO
2,11,2020,17,472,619,1091,2020-11-02 16:00:00,2020-02-11 00:00:00,FESTIVO
2,11,2020,18,465,642,1107,2020-11-02 17:00:00,2020-02-11 00:00:00,FESTIVO
2,11,2020,19,505,755,1260,2020-11-02 18:00:00,2020-02-11 00:00:00,FESTIVO
2,11,2020,20,493,716,1209,2020-11-02 19:00:00,2020-02-11 00:00:00,FESTIVO
2,11,2020,21,392,579,971,2020-11-02 20:00:00,2020-02-11 00:00:00,FESTIVO
2,11,2020,22,360,465,825,2020-11-02 21:00:00,2020-02-11 00:00:00,FESTIVO
2,11,2020,23,289,348,637,2020-11-02 22:00:00,2020-02-11 00:00:00,FESTIVO
2,11,2020,24,211,233,444,2020-11-02 23:00:00,2020-02-11 00:00:00,FESTIVO
3,11,2020,1,110,169,279,2020-11-03 00:00:00,2020-03-11 00:00:00,LABORABLE
3,11,2020,2,50,109,159,2020-11-03 01:00:00,2020-03-11 00:00:00,LABORABLE
3,11,2020,3,39,79,118,2020-11-03 02:00:00,2020-03-11 00:00:00,LABORABLE
3,11,2020,4,42,58,100,2020-11-03 03:00:00,2020-03-11 00:00:00,LABORABLE
3,11,2020,5,60,63,123,2020-11-03 04:00:00,2020-03-11 00:00:00,LABORABLE
3,11,2020,6,157,122,279,2020-11-03 05:00:00,2020-03-11 00:00:00,LABORABLE
3,11,2020,7,410,327,737,2020-11-03 06:00:00,2020-03-11 00:00:00,LABORABLE
3,11,2020,8,665,594,1259,2020-11-03 07:00:00,2020-03-11 00:00:00,LABORABLE
3,11,2020,9,679,694,1373,2020-11-03 08:00:00,2020-03-11 00:00:00,LABORABLE
3,11,2020,10,657,759,1416,2020-11-03 09:00:00,2020-03-11 00:00:00,LABORABLE
3,11,2020,11,562,734,1296,2020-11-03 10:00:00,2020-03-11 00:00:00,LABORABLE
3,11,2020,12,589,738,1327,2020-11-03 11:00:00,2020-03-11 00:00:00,LABORABLE
3,11,2020,13,628,780,1408,2020-11-03 12:00:00,2020-03-11 00:00:00,LABORABLE
3,11,2020,14,628,779,1407,2020-11-03 13:00:00,2020-03-11 00:00:00,LABORABLE
3,11,2020,15,639,795,1434,2020-11-03 14:00:00,2020-03-11 00:00:00,LABORABLE
3,11,2020,16,665,703,1368,2020-11-03 15:00:00,2020-03-11 00:00:00,LABORABLE
3,11,2020,17,583,685,1268,2020-11-03 16:00:00,2020-03-11 00:00:00,LABORABLE
3,11,2020,18,669,787,1456,2020-11-03 17:00:00,2020-03-11 00:00:00,LABORABLE
3,11,2020,19,641,792,1433,2020-11-03 18:00:00,2020-03-11 00:00:00,LABORABLE
3,11,2020,20,603,796,1399,2020-11-03 19:00:00,2020-03-11 00:00:00,LABORABLE
3,11,2020,21,552,685,1237,2020-11-03 20:00:00,2020-03-11 00:00:00,LABORABLE
3,11,2020,22,402,539,941,2020-11-03 21:00:00,2020-03-11 00:00:00,LABORABLE
3,11,2020,23,316,383,699,2020-11-03 22:00:00,2020-03-11 00:00:00,LABORABLE
3,11,2020,24,191,258,449,2020-11-03 23:00:00,2020-03-11 00:00:00,LABORABLE
4,11,2020,1,92,135,227,2020-11-04 00:00:00,2020-04-11 00:00:00,LABORABLE
4,11,2020,2,43,90,133,2020-11-04 01:00:00,2020-04-11 00:00:00,LABORABLE
4,11,2020,3,41,48,89,2020-11-04 02:00:00,2020-04-11 00:00:00,LABORABLE
4,11,2020,4,28,47,75,2020-11-04 03:00:00,2020-04-11 00:00:00,LABORABLE
4,11,2020,5,63,63,126,2020-11-04 04:00:00,2020-04-11 00:00:00,LABORABLE
4,11,2020,6,148,116,264,2020-11-04 05:00:00,2020-04-11 00:00:00,LABORABLE
4,11,2020,7,421,290,711,2020-11-04 06:00:00,2020-04-11 00:00:00,LABORABLE
4,11,2020,8,699,604,1303,2020-11-04 07:00:00,2020-04-11 00:00:00,LABORABLE
4,11,2020,9,678,676,1354,2020-11-04 08:00:00,2020-04-11 00:00:00,LABORABLE
4,11,2020,10,647,740,1387,2020-11-04 09:00:00,2020-04-11 00:00:00,LABORABLE
4,11,2020,11,565,645,1210,2020-11-04 10:00:00,2020-04-11 00:00:00,LABORABLE
4,11,2020,12,631,730,1361,2020-11-04 11:00:00,2020-04-11 00:00:00,LABORABLE
4,11,2020,13,602,728,1330,2020-11-04 12:00:00,2020-04-11 00:00:00,LABORABLE
4,11,2020,14,687,696,1383,2020-11-04 13:00:00,2020-04-11 00:00:00,LABORABLE
4,11,2020,15,660,753,1413,2020-11-04 14:00:00,2020-04-11 00:00:00,LABORABLE
4,11,2020,16,666,740,1406,2020-11-04 15:00:00,2020-04-11 00:00:00,LABORABLE
4,11,2020,17,581,682,1263,2020-11-04 16:00:00,2020-04-11 00:00:00,LABORABLE
4,11,2020,18,698,754,1452,2020-11-04 17:00:00,2020-04-11 00:00:00,LABORABLE
4,11,2020,19,669,783,1452,2020-11-04 18:00:00,2020-04-11 00:00:00,LABORABLE
4,11,2020,20,640,809,1449,2020-11-04 19:00:00,2020-04-11 00:00:00,LABORABLE
4,11,2020,21,574,709,1283,2020-11-04 20:00:00,2020-04-11 00:00:00,LABORABLE
4,11,2020,22,424,529,953,2020-11-04 21:00:00,2020-04-11 00:00:00,LABORABLE
4,11,2020,23,375,438,813,2020-11-04 22:00:00,2020-04-11 00:00:00,LABORABLE
4,11,2020,24,173,239,412,2020-11-04 23:00:00,2020-04-11 00:00:00,LABORABLE
5,11,2020,1,106,176,282,2020-11-05 00:00:00,2020-05-11 00:00:00,LABORABLE
5,11,2020,2,51,85,136,2020-11-05 01:00:00,2020-05-11 00:00:00,LABORABLE
5,11,2020,3,37,72,109,2020-11-05 02:00:00,2020-05-11 00:00:00,LABORABLE
5,11,2020,4,37,44,81,2020-11-05 03:00:00,2020-05-11 00:00:00,LABORABLE
5,11,2020,5,61,58,119,2020-11-05 04:00:00,2020-05-11 00:00:00,LABORABLE
5,11,2020,6,129,118,247,2020-11-05 05:00:00,2020-05-11 00:00:00,LABORABLE
5,11,2020,7,411,300,711,2020-11-05 06:00:00,2020-05-11 00:00:00,LABORABLE
5,11,2020,8,675,590,1265,2020-11-05 07:00:00,2020-05-11 00:00:00,LABORABLE
5,11,2020,9,706,725,1431,2020-11-05 08:00:00,2020-05-11 00:00:00,LABORABLE
5,11,2020,10,646,771,1417,2020-11-05 09:00:00,2020-05-11 00:00:00,LABORABLE
5,11,2020,11,475,609,1084,2020-11-05 10:00:00,2020-05-11 00:00:00,LABORABLE
5,11,2020,12,613,744,1357,2020-11-05 11:00:00,2020-05-11 00:00:00,LABORABLE
5,11,2020,13,663,749,1412,2020-11-05 12:00:00,2020-05-11 00:00:00,LABORABLE
5,11,2020,14,689,742,1431,2020-11-05 13:00:00,2020-05-11 00:00:00,LABORABLE
5,11,2020,15,659,788,1447,2020-11-05 14:00:00,2020-05-11 00:00:00,LABORABLE
5,11,2020,16,653,758,1411,2020-11-05 15:00:00,2020-05-11 00:00:00,LABORABLE
5,11,2020,17,653,751,1404,2020-11-05 16:00:00,2020-05-11 00:00:00,LABORABLE
5,11,2020,18,612,729,1341,2020-11-05 17:00:00,2020-05-11 00:00:00,LABORABLE
5,11,2020,19,682,820,1502,2020-11-05 18:00:00,2020-05-11 00:00:00,LABORABLE
5,11,2020,20,658,835,1493,2020-11-05 19:00:00,2020-05-11 00:00:00,LABORABLE
5,11,2020,21,556,648,1204,2020-11-05 20:00:00,2020-05-11 00:00:00,LABORABLE
5,11,2020,22,472,583,1055,2020-11-05 21:00:00,2020-05-11 00:00:00,LABORABLE
5,11,2020,23,354,431,785,2020-11-05 22:00:00,2020-05-11 00:00:00,LABORABLE
5,11,2020,24,236,302,538,2020-11-05 23:00:00,2020-05-11 00:00:00,LABORABLE
6,11,2020,1,115,216,331,2020-11-06 00:00:00,2020-06-11 00:00:00,LABORABLE
6,11,2020,2,52,98,150,2020-11-06 01:00:00,2020-06-11 00:00:00,LABORABLE
6,11,2020,3,36,72,108,2020-11-06 02:00:00,2020-06-11 00:00:00,LABORABLE
6,11,2020,4,36,48,84,2020-11-06 03:00:00,2020-06-11 00:00:00,LABORABLE
6,11,2020,5,59,55,114,2020-11-06 04:00:00,2020-06-11 00:00:00,LABORABLE
6,11,2020,6,149,104,253,2020-11-06 05:00:00,2020-06-11 00:00:00,LABORABLE
6,11,2020,7,395,318,713,2020-11-06 06:00:00,2020-06-11 00:00:00,LABORABLE
6,11,2020,8,698,581,1279,2020-11-06 07:00:00,2020-06-11 00:00:00,LABORABLE
6,11,2020,9,704,700,1404,2020-11-06 08:00:00,2020-06-11 00:00:00,LABORABLE
6,11,2020,10,673,763,1436,2020-11-06 09:00:00,2020-06-11 00:00:00,LABORABLE
6,11,2020,11,566,746,1312,2020-11-06 10:00:00,2020-06-11 00:00:00,LABORABLE
6,11,2020,12,588,741,1329,2020-11-06 11:00:00,2020-06-11 00:00:00,LABORABLE
6,11,2020,13,639,808,1447,2020-11-06 12:00:00,2020-06-11 00:00:00,LABORABLE
6,11,2020,14,753,868,1621,2020-11-06 13:00:00,2020-06-11 00:00:00,LABORABLE
6,11,2020,15,675,812,1487,2020-11-06 14:00:00,2020-06-11 00:00:00,LABORABLE
6,11,2020,16,694,749,1443,2020-11-06 15:00:00,2020-06-11 00:00:00,LABORABLE
6,11,2020,17,662,830,1492,2020-11-06 16:00:00,2020-06-11 00:00:00,LABORABLE
6,11,2020,18,677,811,1488,2020-11-06 17:00:00,2020-06-11 00:00:00,LABORABLE
6,11,2020,19,657,810,1467,2020-11-06 18:00:00,2020-06-11 00:00:00,LABORABLE
6,11,2020,20,682,840,1522,2020-11-06 19:00:00,2020-06-11 00:00:00,LABORABLE
6,11,2020,21,685,831,1516,2020-11-06 20:00:00,2020-06-11 00:00:00,LABORABLE
6,11,2020,22,503,677,1180,2020-11-06 21:00:00,2020-06-11 00:00:00,LABORABLE
6,11,2020,23,447,538,985,2020-11-06 22:00:00,2020-06-11 00:00:00,LABORABLE
6,11,2020,24,344,407,751,2020-11-06 23:00:00,2020-06-11 00:00:00,LABORABLE
7,11,2020,1,209,315,524,2020-11-07 00:00:00,2020-07-11 00:00:00,LABORABLE
7,11,2020,2,97,190,287,2020-11-07 01:00:00,2020-07-11 00:00:00,LABORABLE
7,11,2020,3,60,118,178,2020-11-07 02:00:00,2020-07-11 00:00:00,LABORABLE
7,11,2020,4,49,92,141,2020-11-07 03:00:00,2020-07-11 00:00:00,LABORABLE
7,11,2020,5,44,77,121,2020-11-07 04:00:00,2020-07-11 00:00:00,LABORABLE
7,11,2020,6,94,83,177,2020-11-07 05:00:00,2020-07-11 00:00:00,LABORABLE
7,11,2020,7,165,149,314,2020-11-07 06:00:00,2020-07-11 00:00:00,LABORABLE
7,11,2020,8,281,231,512,2020-11-07 07:00:00,2020-07-11 00:00:00,LABORABLE
7,11,2020,9,309,377,686,2020-11-07 08:00:00,2020-07-11 00:00:00,LABORABLE
7,11,2020,10,423,485,908,2020-11-07 09:00:00,2020-07-11 00:00:00,LABORABLE
7,11,2020,11,518,637,1155,2020-11-07 10:00:00,2020-07-11 00:00:00,LABORABLE
7,11,2020,12,579,771,1350,2020-11-07 11:00:00,2020-07-11 00:00:00,LABORABLE
7,11,2020,13,645,860,1505,2020-11-07 12:00:00,2020-07-11 00:00:00,LABORABLE
7,11,2020,14,629,854,1483,2020-11-07 13:00:00,2020-07-11 00:00:00,LABORABLE
7,11,2020,15,637,896,1533,2020-11-07 14:00:00,2020-07-11 00:00:00,LABORABLE
7,11,2020,16,505,703,1208,2020-11-07 15:00:00,2020-07-11 00:00:00,LABORABLE
7,11,2020,17,506,655,1161,2020-11-07 16:00:00,2020-07-11 00:00:00,LABORABLE
7,11,2020,18,570,771,1341,2020-11-07 17:00:00,2020-07-11 00:00:00,LABORABLE
7,11,2020,19,607,880,1487,2020-11-07 18:00:00,2020-07-11 00:00:00,LABORABLE
7,11,2020,20,627,817,1444,2020-11-07 19:00:00,2020-07-11 00:00:00,LABORABLE
7,11,2020,21,567,727,1294,2020-11-07 20:00:00,2020-07-11 00:00:00,LABORABLE
7,11,2020,22,461,635,1096,2020-11-07 21:00:00,2020-07-11 00:00:00,LABORABLE
7,11,2020,23,438,566,1004,2020-11-07 22:00:00,2020-07-11 00:00:00,LABORABLE
7,11,2020,24,426,462,888,2020-11-07 23:00:00,2020-07-11 00:00:00,LABORABLE
8,11,2020,1,250,336,586,2020-11-08 00:00:00,2020-08-11 00:00:00,LABORABLE
8,11,2020,2,81,242,323,2020-11-08 01:00:00,2020-08-11 00:00:00,LABORABLE
8,11,2020,3,61,112,173,2020-11-08 02:00:00,2020-08-11 00:00:00,LABORABLE
8,11,2020,4,40,91,131,2020-11-08 03:00:00,2020-08-11 00:00:00,LABORABLE
8,11,2020,5,40,96,136,2020-11-08 04:00:00,2020-08-11 00:00:00,LABORABLE
8,11,2020,6,45,57,102,2020-11-08 05:00:00,2020-08-11 00:00:00,LABORABLE
8,11,2020,7,104,120,224,2020-11-08 06:00:00,2020-08-11 00:00:00,LABORABLE
8,11,2020,8,146,153,299,2020-11-08 07:00:00,2020-08-11 00:00:00,LABORABLE
8,11,2020,9,223,212,435,2020-11-08 08:00:00,2020-08-11 00:00:00,LABORABLE
8,11,2020,10,267,369,636,2020-11-08 09:00:00,2020-08-11 00:00:00,LABORABLE
8,11,2020,11,440,497,937,2020-11-08 10:00:00,2020-08-11 00:00:00,LABORABLE
8,11,2020,12,518,652,1170,2020-11-08 11:00:00,2020-08-11 00:00:00,LABORABLE
8,11,2020,13,534,721,1255,2020-11-08 12:00:00,2020-08-11 00:00:00,LABORABLE
8,11,2020,14,562,692,1254,2020-11-08 13:00:00,2020-08-11 00:00:00,LABORABLE
8,11,2020,15,526,688,1214,2020-11-08 14:00:00,2020-08-11 00:00:00,LABORABLE
8,11,2020,16,418,618,1036,2020-11-08 15:00:00,2020-08-11 00:00:00,LABORABLE
8,11,2020,17,432,581,1013,2020-11-08 16:00:00,2020-08-11 00:00:00,LABORABLE
8,11,2020,18,466,653,1119,2020-11-08 17:00:00,2020-08-11 00:00:00,LABORABLE
8,11,2020,19,555,697,1252,2020-11-08 18:00:00,2020-08-11 00:00:00,LABORABLE
8,11,2020,20,507,636,1143,2020-11-08 19:00:00,2020-08-11 00:00:00,LABORABLE
8,11,2020,21,435,584,1019,2020-11-08 20:00:00,2020-08-11 00:00:00,LABORABLE
8,11,2020,22,363,487,850,2020-11-08 21:00:00,2020-08-11 00:00:00,LABORABLE
8,11,2020,23,329,393,722,2020-11-08 22:00:00,2020-08-11 00:00:00,LABORABLE
8,11,2020,24,312,389,701,2020-11-08 23:00:00,2020-08-11 00:00:00,LABORABLE
9,11,2020,1,187,214,401,2020-11-09 00:00:00,2020-09-11 00:00:00,FESTIVO
9,11,2020,2,81,107,188,2020-11-09 01:00:00,2020-09-11 00:00:00,FESTIVO
9,11,2020,3,45,89,134,2020-11-09 02:00:00,2020-09-11 00:00:00,FESTIVO
9,11,2020,4,33,62,95,2020-11-09 03:00:00,2020-09-11 00:00:00,FESTIVO
9,11,2020,5,34,51,85,2020-11-09 04:00:00,2020-09-11 00:00:00,FESTIVO
9,11,2020,6,92,73,165,2020-11-09 05:00:00,2020-09-11 00:00:00,FESTIVO
9,11,2020,7,204,193,397,2020-11-09 06:00:00,2020-09-11 00:00:00,FESTIVO
9,11,2020,8,334,299,633,2020-11-09 07:00:00,2020-09-11 00:00:00,FESTIVO
9,11,2020,9,370,411,781,2020-11-09 08:00:00,2020-09-11 00:00:00,FESTIVO
9,11,2020,10,351,550,901,2020-11-09 09:00:00,2020-09-11 00:00:00,FESTIVO
9,11,2020,11,379,522,901,2020-11-09 10:00:00,2020-09-11 00:00:00,FESTIVO
9,11,2020,12,494,644,1138,2020-11-09 11:00:00,2020-09-11 00:00:00,FESTIVO
9,11,2020,13,488,704,1192,2020-11-09 12:00:00,2020-09-11 00:00:00,FESTIVO
9,11,2020,14,536,648,1184,2020-11-09 13:00:00,2020-09-11 00:00:00,FESTIVO
9,11,2020,15,492,627,1119,2020-11-09 14:00:00,2020-09-11 00:00:00,FESTIVO
9,11,2020,16,412,557,969,2020-11-09 15:00:00,2020-09-11 00:00:00,FESTIVO
9,11,2020,17,428,587,1015,2020-11-09 16:00:00,2020-09-11 00:00:00,FESTIVO
9,11,2020,18,485,642,1127,2020-11-09 17:00:00,2020-09-11 00:00:00,FESTIVO
9,11,2020,19,537,761,1298,2020-11-09 18:00:00,2020-09-11 00:00:00,FESTIVO
9,11,2020,20,454,720,1174,2020-11-09 19:00:00,2020-09-11 00:00:00,FESTIVO
9,11,2020,21,416,648,1064,2020-11-09 20:00:00,2020-09-11 00:00:00,FESTIVO
9,11,2020,22,346,472,818,2020-11-09 21:00:00,2020-09-11 00:00:00,FESTIVO
9,11,2020,23,300,367,667,2020-11-09 22:00:00,2020-09-11 00:00:00,FESTIVO
9,11,2020,24,205,215,420,2020-11-09 23:00:00,2020-09-11 00:00:00,FESTIVO
10,11,2020,1,118,186,304,2020-11-10 00:00:00,2020-10-11 00:00:00,LABORABLE
10,11,2020,2,55,99,154,2020-11-10 01:00:00,2020-10-11 00:00:00,LABORABLE
10,11,2020,3,40,71,111,2020-11-10 02:00:00,2020-10-11 00:00:00,LABORABLE
10,11,2020,4,42,47,89,2020-11-10 03:00:00,2020-10-11 00:00:00,LABORABLE
10,11,2020,5,66,58,124,2020-11-10 04:00:00,2020-10-11 00:00:00,LABORABLE
10,11,2020,6,144,106,250,2020-11-10 05:00:00,2020-10-11 00:00:00,LABORABLE
10,11,2020,7,407,295,702,2020-11-10 06:00:00,2020-10-11 00:00:00,LABORABLE
10,11,2020,8,696,562,1258,2020-11-10 07:00:00,2020-10-11 00:00:00,LABORABLE
10,11,2020,9,673,701,1374,2020-11-10 08:00:00,2020-10-11 00:00:00,LABORABLE
10,11,2020,10,651,786,1437,2020-11-10 09:00:00,2020-10-11 00:00:00,LABORABLE
10,11,2020,11,574,725,1299,2020-11-10 10:00:00,2020-10-11 00:00:00,LABORABLE
10,11,2020,12,636,761,1397,2020-11-10 11:00:00,2020-10-11 00:00:00,LABORABLE
10,11,2020,13,621,819,1440,2020-11-10 12:00:00,2020-10-11 00:00:00,LABORABLE
10,11,2020,14,698,785,1483,2020-11-10 13:00:00,2020-10-11 00:00:00,LABORABLE
10,11,2020,15,640,752,1392,2020-11-10 14:00:00,2020-10-11 00:00:00,LABORABLE
10,11,2020,16,633,706,1339,2020-11-10 15:00:00,2020-10-11 00:00:00,LABORABLE
10,11,2020,17,620,733,1353,2020-11-10 16:00:00,2020-10-11 00:00:00,LABORABLE
10,11,2020,18,627,785,1412,2020-11-10 17:00:00,2020-10-11 00:00:00,LABORABLE
10,11,2020,19,647,824,1471,2020-11-10 18:00:00,2020-10-11 00:00:00,LABORABLE
10,11,2020,20,654,746,1400,2020-11-10 19:00:00,2020-10-11 00:00:00,LABORABLE
10,11,2020,21,593,706,1299,2020-11-10 20:00:00,2020-10-11 00:00:00,LABORABLE
10,11,2020,22,461,507,968,2020-11-10 21:00:00,2020-10-11 00:00:00,LABORABLE
10,11,2020,23,334,408,742,2020-11-10 22:00:00,2020-10-11 00:00:00,LABORABLE
10,11,2020,24,185,284,469,2020-11-10 23:00:00,2020-10-11 00:00:00,LABORABLE
11,11,2020,1,104,149,253,2020-11-11 00:00:00,2020-11-11 00:00:00,LABORABLE
11,11,2020,2,48,89,137,2020-11-11 01:00:00,2020-11-11 00:00:00,LABORABLE
11,11,2020,3,38,57,95,2020-11-11 02:00:00,2020-11-11 00:00:00,LABORABLE
11,11,2020,4,35,34,69,2020-11-11 03:00:00,2020-11-11 00:00:00,LABORABLE
11,11,2020,5,52,59,111,2020-11-11 04:00:00,2020-11-11 00:00:00,LABORABLE
11,11,2020,6,138,97,235,2020-11-11 05:00:00,2020-11-11 00:00:00,LABORABLE
11,11,2020,7,429,309,738,2020-11-11 06:00:00,2020-11-11 00:00:00,LABORABLE
11,11,2020,8,692,568,1260,2020-11-11 07:00:00,2020-11-11 00:00:00,LABORABLE
11,11,2020,9,714,733,1447,2020-11-11 08:00:00,2020-11-11 00:00:00,LABORABLE
11,11,2020,10,634,741,1375,2020-11-11 09:00:00,2020-11-11 00:00:00,LABORABLE
11,11,2020,11,558,675,1233,2020-11-11 10:00:00,2020-11-11 00:00:00,LABORABLE
11,11,2020,12,579,738,1317,2020-11-11 11:00:00,2020-11-11 00:00:00,LABORABLE
11,11,2020,13,607,751,1358,2020-11-11 12:00:00,2020-11-11 00:00:00,LABORABLE
11,11,2020,14,675,785,1460,2020-11-11 13:00:00,2020-11-11 00:00:00,LABORABLE
11,11,2020,15,677,738,1415,2020-11-11 14:00:00,2020-11-11 00:00:00,LABORABLE
11,11,2020,16,619,654,1273,2020-11-11 15:00:00,2020-11-11 00:00:00,LABORABLE
11,11,2020,17,636,712,1348,2020-11-11 16:00:00,2020-11-11 00:00:00,LABORABLE
11,11,2020,18,690,725,1415,2020-11-11 17:00:00,2020-11-11 00:00:00,LABORABLE
11,11,2020,19,657,799,1456,2020-11-11 18:00:00,2020-11-11 00:00:00,LABORABLE
11,11,2020,20,555,833,1388,2020-11-11 19:00:00,2020-11-11 00:00:00,LABORABLE
11,11,2020,21,576,614,1190,2020-11-11 20:00:00,2020-11-11 00:00:00,LABORABLE
11,11,2020,22,444,577,1021,2020-11-11 21:00:00,2020-11-11 00:00:00,LABORABLE
11,11,2020,23,330,437,767,2020-11-11 22:00:00,2020-11-11 00:00:00,LABORABLE
11,11,2020,24,233,255,488,2020-11-11 23:00:00,2020-11-11 00:00:00,LABORABLE
12,11,2020,1,126,162,288,2020-11-12 00:00:00,2020-12-11 00:00:00,LABORABLE
12,11,2020,2,47,87,134,2020-11-12 01:00:00,2020-12-11 00:00:00,LABORABLE
12,11,2020,3,36,72,108,2020-11-12 02:00:00,2020-12-11 00:00:00,LABORABLE
12,11,2020,4,36,50,86,2020-11-12 03:00:00,2020-12-11 00:00:00,LABORABLE
12,11,2020,5,49,62,111,2020-11-12 04:00:00,2020-12-11 00:00:00,LABORABLE
12,11,2020,6,150,119,269,2020-11-12 05:00:00,2020-12-11 00:00:00,LABORABLE
12,11,2020,7,450,322,772,2020-11-12 06:00:00,2020-12-11 00:00:00,LABORABLE
12,11,2020,8,692,622,1314,2020-11-12 07:00:00,2020-12-11 00:00:00,LABORABLE
12,11,2020,9,712,688,1400,2020-11-12 08:00:00,2020-12-11 00:00:00,LABORABLE
12,11,2020,10,616,793,1409,2020-11-12 09:00:00,2020-12-11 00:00:00,LABORABLE
12,11,2020,11,633,699,1332,2020-11-12 10:00:00,2020-12-11 00:00:00,LABORABLE
12,11,2020,12,635,776,1411,2020-11-12 11:00:00,2020-12-11 00:00:00,LABORABLE
12,11,2020,13,625,759,1384,2020-11-12 12:00:00,2020-12-11 00:00:00,LABORABLE
12,11,2020,14,568,712,1280,2020-11-12 13:00:00,2020-12-11 00:00:00,LABORABLE
12,11,2020,15,642,801,1443,2020-11-12 14:00:00,2020-12-11 00:00:00,LABORABLE
12,11,2020,16,665,727,1392,2020-11-12 15:00:00,2020-12-11 00:00:00,LABORABLE
12,11,2020,17,600,760,1360,2020-11-12 16:00:00,2020-12-11 00:00:00,LABORABLE
12,11,2020,18,665,789,1454,2020-11-12 17:00:00,2020-12-11 00:00:00,LABORABLE
12,11,2020,19,689,841,1530,2020-11-12 18:00:00,2020-12-11 00:00:00,LABORABLE
12,11,2020,20,699,829,1528,2020-11-12 19:00:00,2020-12-11 00:00:00,LABORABLE
12,11,2020,21,618,722,1340,2020-11-12 20:00:00,2020-12-11 00:00:00,LABORABLE
12,11,2020,22,457,580,1037,2020-11-12 21:00:00,2020-12-11 00:00:00,LABORABLE
12,11,2020,23,392,430,822,2020-11-12 22:00:00,2020-12-11 00:00:00,LABORABLE
12,11,2020,24,242,295,537,2020-11-12 23:00:00,2020-12-11 00:00:00,LABORABLE
13,11,2020,1,135,204,339,2020-11-13 00:00:00,2020-11-13 00:00:00,LABORABLE
13,11,2020,2,58,110,168,2020-11-13 01:00:00,2020-11-13 00:00:00,LABORABLE
13,11,2020,3,45,83,128,2020-11-13 02:00:00,2020-11-13 00:00:00,LABORABLE
13,11,2020,4,34,41,75,2020-11-13 03:00:00,2020-11-13 00:00:00,LABORABLE
13,11,2020,5,62,68,130,2020-11-13 04:00:00,2020-11-13 00:00:00,LABORABLE
13,11,2020,6,155,105,260,2020-11-13 05:00:00,2020-11-13 00:00:00,LABORABLE
13,11,2020,7,434,307,741,2020-11-13 06:00:00,2020-11-13 00:00:00,LABORABLE
13,11,2020,8,685,610,1295,2020-11-13 07:00:00,2020-11-13 00:00:00,LABORABLE
13,11,2020,9,703,707,1410,2020-11-13 08:00:00,2020-11-13 00:00:00,LABORABLE
13,11,2020,10,651,815,1466,2020-11-13 09:00:00,2020-11-13 00:00:00,LABORABLE
13,11,2020,11,629,763,1392,2020-11-13 10:00:00,2020-11-13 00:00:00,LABORABLE
13,11,2020,12,593,728,1321,2020-11-13 11:00:00,2020-11-13 00:00:00,LABORABLE
13,11,2020,13,611,796,1407,2020-11-13 12:00:00,2020-11-13 00:00:00,LABORABLE
13,11,2020,14,721,821,1542,2020-11-13 13:00:00,2020-11-13 00:00:00,LABORABLE
13,11,2020,15,676,797,1473,2020-11-13 14:00:00,2020-11-13 00:00:00,LABORABLE
13,11,2020,16,676,746,1422,2020-11-13 15:00:00,2020-11-13 00:00:00,LABORABLE
13,11,2020,17,579,805,1384,2020-11-13 16:00:00,2020-11-13 00:00:00,LABORABLE
13,11,2020,18,685,818,1503,2020-11-13 17:00:00,2020-11-13 00:00:00,LABORABLE
13,11,2020,19,715,879,1594,2020-11-13 18:00:00,2020-11-13 00:00:00,LABORABLE
13,11,2020,20,680,878,1558,2020-11-13 19:00:00,2020-11-13 00:00:00,LABORABLE
13,11,2020,21,607,812,1419,2020-11-13 20:00:00,2020-11-13 00:00:00,LABORABLE
13,11,2020,22,525,696,1221,2020-11-13 21:00:00,2020-11-13 00:00:00,LABORABLE
13,11,2020,23,435,557,992,2020-11-13 22:00:00,2020-11-13 00:00:00,LABORABLE
13,11,2020,24,389,451,840,2020-11-13 23:00:00,2020-11-13 00:00:00,LABORABLE
14,11,2020,1,214,350,564,2020-11-14 00:00:00,2020-11-14 00:00:00,LABORABLE
14,11,2020,2,112,188,300,2020-11-14 01:00:00,2020-11-14 00:00:00,LABORABLE
14,11,2020,3,60,138,198,2020-11-14 02:00:00,2020-11-14 00:00:00,LABORABLE
14,11,2020,4,49,81,130,2020-11-14 03:00:00,2020-11-14 00:00:00,LABORABLE
14,11,2020,5,51,74,125,2020-11-14 04:00:00,2020-11-14 00:00:00,LABORABLE
14,11,2020,6,87,94,181,2020-11-14 05:00:00,2020-11-14 00:00:00,LABORABLE
14,11,2020,7,163,147,310,2020-11-14 06:00:00,2020-11-14 00:00:00,LABORABLE
14,11,2020,8,254,251,505,2020-11-14 07:00:00,2020-11-14 00:00:00,LABORABLE
14,11,2020,9,354,347,701,2020-11-14 08:00:00,2020-11-14 00:00:00,LABORABLE
14,11,2020,10,448,515,963,2020-11-14 09:00:00,2020-11-14 00:00:00,LABORABLE
14,11,2020,11,544,625,1169,2020-11-14 10:00:00,2020-11-14 00:00:00,LABORABLE
14,11,2020,12,588,728,1316,2020-11-14 11:00:00,2020-11-14 00:00:00,LABORABLE
14,11,2020,13,650,799,1449,2020-11-14 12:00:00,2020-11-14 00:00:00,LABORABLE
14,11,2020,14,657,874,1531,2020-11-14 13:00:00,2020-11-14 00:00:00,LABORABLE
14,11,2020,15,618,812,1430,2020-11-14 14:00:00,2020-11-14 00:00:00,LABORABLE
14,11,2020,16,543,715,1258,2020-11-14 15:00:00,2020-11-14 00:00:00,LABORABLE
14,11,2020,17,470,697,1167,2020-11-14 16:00:00,2020-11-14 00:00:00,LABORABLE
14,11,2020,18,581,776,1357,2020-11-14 17:00:00,2020-11-14 00:00:00,LABORABLE
14,11,2020,19,587,824,1411,2020-11-14 18:00:00,2020-11-14 00:00:00,LABORABLE
14,11,2020,20,595,785,1380,2020-11-14 19:00:00,2020-11-14 00:00:00,LABORABLE
14,11,2020,21,470,740,1210,2020-11-14 20:00:00,2020-11-14 00:00:00,LABORABLE
14,11,2020,22,457,646,1103,2020-11-14 21:00:00,2020-11-14 00:00:00,LABORABLE
14,11,2020,23,397,544,941,2020-11-14 22:00:00,2020-11-14 00:00:00,LABORABLE
14,11,2020,24,425,458,883,2020-11-14 23:00:00,2020-11-14 00:00:00,LABORABLE
15,11,2020,1,287,348,635,2020-11-15 00:00:00,2020-11-15 00:00:00,LABORABLE
15,11,2020,2,92,220,312,2020-11-15 01:00:00,2020-11-15 00:00:00,LABORABLE
15,11,2020,3,49,132,181,2020-11-15 02:00:00,2020-11-15 00:00:00,LABORABLE
15,11,2020,4,47,86,133,2020-11-15 03:00:00,2020-11-15 00:00:00,LABORABLE
15,11,2020,5,39,92,131,2020-11-15 04:00:00,2020-11-15 00:00:00,LABORABLE
15,11,2020,6,47,74,121,2020-11-15 05:00:00,2020-11-15 00:00:00,LABORABLE
15,11,2020,7,102,116,218,2020-11-15 06:00:00,2020-11-15 00:00:00,LABORABLE
15,11,2020,8,137,136,273,2020-11-15 07:00:00,2020-11-15 00:00:00,LABORABLE
15,11,2020,9,190,217,407,2020-11-15 08:00:00,2020-11-15 00:00:00,LABORABLE
15,11,2020,10,276,340,616,2020-11-15 09:00:00,2020-11-15 00:00:00,LABORABLE
15,11,2020,11,392,467,859,2020-11-15 10:00:00,2020-11-15 00:00:00,LABORABLE
15,11,2020,12,496,599,1095,2020-11-15 11:00:00,2020-11-15 00:00:00,LABORABLE
15,11,2020,13,547,679,1226,2020-11-15 12:00:00,2020-11-15 00:00:00,LABORABLE
15,11,2020,14,605,642,1247,2020-11-15 13:00:00,2020-11-15 00:00:00,LABORABLE
15,11,2020,15,515,689,1204,2020-11-15 14:00:00,2020-11-15 00:00:00,LABORABLE
15,11,2020,16,411,620,1031,2020-11-15 15:00:00,2020-11-15 00:00:00,LABORABLE
15,11,2020,17,424,638,1062,2020-11-15 16:00:00,2020-11-15 00:00:00,LABORABLE
15,11,2020,18,488,669,1157,2020-11-15 17:00:00,2020-11-15 00:00:00,LABORABLE
15,11,2020,19,574,695,1269,2020-11-15 18:00:00,2020-11-15 00:00:00,LABORABLE
15,11,2020,20,509,628,1137,2020-11-15 19:00:00,2020-11-15 00:00:00,LABORABLE
15,11,2020,21,445,603,1048,2020-11-15 20:00:00,2020-11-15 00:00:00,LABORABLE
15,11,2020,22,380,497,877,2020-11-15 21:00:00,2020-11-15 00:00:00,LABORABLE
15,11,2020,23,291,404,695,2020-11-15 22:00:00,2020-11-15 00:00:00,LABORABLE
15,11,2020,24,250,297,547,2020-11-15 23:00:00,2020-11-15 00:00:00,LABORABLE
16,11,2020,1,163,237,400,2020-11-16 00:00:00,2020-11-16 00:00:00,LABORABLE
16,11,2020,2,71,102,173,2020-11-16 01:00:00,2020-11-16 00:00:00,LABORABLE
16,11,2020,3,45,93,138,2020-11-16 02:00:00,2020-11-16 00:00:00,LABORABLE
16,11,2020,4,31,64,95,2020-11-16 03:00:00,2020-11-16 00:00:00,LABORABLE
16,11,2020,5,40,52,92,2020-11-16 04:00:00,2020-11-16 00:00:00,LABORABLE
16,11,2020,6,147,106,253,2020-11-16 05:00:00,2020-11-16 00:00:00,LABORABLE
16,11,2020,7,448,321,769,2020-11-16 06:00:00,2020-11-16 00:00:00,LABORABLE
16,11,2020,8,701,592,1293,2020-11-16 07:00:00,2020-11-16 00:00:00,LABORABLE
16,11,2020,9,669,678,1347,2020-11-16 08:00:00,2020-11-16 00:00:00,LABORABLE
16,11,2020,10,635,748,1383,2020-11-16 09:00:00,2020-11-16 00:00:00,LABORABLE
16,11,2020,11,540,714,1254,2020-11-16 10:00:00,2020-11-16 00:00:00,LABORABLE
16,11,2020,12,581,688,1269,2020-11-16 11:00:00,2020-11-16 00:00:00,LABORABLE
16,11,2020,13,582,751,1333,2020-11-16 12:00:00,2020-11-16 00:00:00,LABORABLE
16,11,2020,14,628,810,1438,2020-11-16 13:00:00,2020-11-16 00:00:00,LABORABLE
16,11,2020,15,658,791,1449,2020-11-16 14:00:00,2020-11-16 00:00:00,LABORABLE
16,11,2020,16,668,697,1365,2020-11-16 15:00:00,2020-11-16 00:00:00,LABORABLE
16,11,2020,17,616,715,1331,2020-11-16 16:00:00,2020-11-16 00:00:00,LABORABLE
16,11,2020,18,673,770,1443,2020-11-16 17:00:00,2020-11-16 00:00:00,LABORABLE
16,11,2020,19,642,821,1463,2020-11-16 18:00:00,2020-11-16 00:00:00,LABORABLE
16,11,2020,20,632,759,1391,2020-11-16 19:00:00,2020-11-16 00:00:00,LABORABLE
16,11,2020,21,531,672,1203,2020-11-16 20:00:00,2020-11-16 00:00:00,LABORABLE
16,11,2020,22,407,518,925,2020-11-16 21:00:00,2020-11-16 00:00:00,LABORABLE
16,11,2020,23,338,420,758,2020-11-16 22:00:00,2020-11-16 00:00:00,LABORABLE
16,11,2020,24,177,249,426,2020-11-16 23:00:00,2020-11-16 00:00:00,LABORABLE
17,11,2020,1,106,179,285,2020-11-17 00:00:00,2020-11-17 00:00:00,LABORABLE
17,11,2020,2,48,88,136,2020-11-17 01:00:00,2020-11-17 00:00:00,LABORABLE
17,11,2020,3,50,76,126,2020-11-17 02:00:00,2020-11-17 00:00:00,LABORABLE
17,11,2020,4,46,61,107,2020-11-17 03:00:00,2020-11-17 00:00:00,LABORABLE
17,11,2020,5,55,69,124,2020-11-17 04:00:00,2020-11-17 00:00:00,LABORABLE
17,11,2020,6,146,120,266,2020-11-17 05:00:00,2020-11-17 00:00:00,LABORABLE
17,11,2020,7,425,314,739,2020-11-17 06:00:00,2020-11-17 00:00:00,LABORABLE
17,11,2020,8,672,584,1256,2020-11-17 07:00:00,2020-11-17 00:00:00,LABORABLE
17,11,2020,9,695,724,1419,2020-11-17 08:00:00,2020-11-17 00:00:00,LABORABLE
17,11,2020,10,682,795,1477,2020-11-17 09:00:00,2020-11-17 00:00:00,LABORABLE
17,11,2020,11,533,721,1254,2020-11-17 10:00:00,2020-11-17 00:00:00,LABORABLE
17,11,2020,12,598,695,1293,2020-11-17 11:00:00,2020-11-17 00:00:00,LABORABLE
17,11,2020,13,605,830,1435,2020-11-17 12:00:00,2020-11-17 00:00:00,LABORABLE
17,11,2020,14,649,777,1426,2020-11-17 13:00:00,2020-11-17 00:00:00,LABORABLE
17,11,2020,15,652,798,1450,2020-11-17 14:00:00,2020-11-17 00:00:00,LABORABLE
17,11,2020,16,636,693,1329,2020-11-17 15:00:00,2020-11-17 00:00:00,LABORABLE
17,11,2020,17,616,714,1330,2020-11-17 16:00:00,2020-11-17 00:00:00,LABORABLE
17,11,2020,18,659,698,1357,2020-11-17 17:00:00,2020-11-17 00:00:00,LABORABLE
17,11,2020,19,674,855,1529,2020-11-17 18:00:00,2020-11-17 00:00:00,LABORABLE
17,11,2020,20,573,775,1348,2020-11-17 19:00:00,2020-11-17 00:00:00,LABORABLE
17,11,2020,21,594,677,1271,2020-11-17 20:00:00,2020-11-17 00:00:00,LABORABLE
17,11,2020,22,392,546,938,2020-11-17 21:00:00,2020-11-17 00:00:00,LABORABLE
17,11,2020,23,340,403,743,2020-11-17 22:00:00,2020-11-17 00:00:00,LABORABLE
17,11,2020,24,201,274,475,2020-11-17 23:00:00,2020-11-17 00:00:00,LABORABLE
18,11,2020,1,107,163,270,2020-11-18 00:00:00,2020-11-18 00:00:00,LABORABLE
18,11,2020,2,50,89,139,2020-11-18 01:00:00,2020-11-18 00:00:00,LABORABLE
18,11,2020,3,42,66,108,2020-11-18 02:00:00,2020-11-18 00:00:00,LABORABLE
18,11,2020,4,43,44,87,2020-11-18 03:00:00,2020-11-18 00:00:00,LABORABLE
18,11,2020,5,58,61,119,2020-11-18 04:00:00,2020-11-18 00:00:00,LABORABLE
18,11,2020,6,157,109,266,2020-11-18 05:00:00,2020-11-18 00:00:00,LABORABLE
18,11,2020,7,428,336,764,2020-11-18 06:00:00,2020-11-18 00:00:00,LABORABLE
18,11,2020,8,698,570,1268,2020-11-18 07:00:00,2020-11-18 00:00:00,LABORABLE
18,11,2020,9,668,652,1320,2020-11-18 08:00:00,2020-11-18 00:00:00,LABORABLE
18,11,2020,10,655,723,1378,2020-11-18 09:00:00,2020-11-18 00:00:00,LABORABLE
18,11,2020,11,530,646,1176,2020-11-18 10:00:00,2020-11-18 00:00:00,LABORABLE
18,11,2020,12,559,720,1279,2020-11-18 11:00:00,2020-11-18 00:00:00,LABORABLE
18,11,2020,13,647,753,1400,2020-11-18 12:00:00,2020-11-18 00:00:00,LABORABLE
18,11,2020,14,652,751,1403,2020-11-18 13:00:00,2020-11-18 00:00:00,LABORABLE
18,11,2020,15,682,753,1435,2020-11-18 14:00:00,2020-11-18 00:00:00,LABORABLE
18,11,2020,16,648,711,1359,2020-11-18 15:00:00,2020-11-18 00:00:00,LABORABLE
18,11,2020,17,595,760,1355,2020-11-18 16:00:00,2020-11-18 00:00:00,LABORABLE
18,11,2020,18,686,716,1402,2020-11-18 17:00:00,2020-11-18 00:00:00,LABORABLE
18,11,2020,19,649,738,1387,2020-11-18 18:00:00,2020-11-18 00:00:00,LABORABLE
18,11,2020,20,626,786,1412,2020-11-18 19:00:00,2020-11-18 00:00:00,LABORABLE
18,11,2020,21,593,644,1237,2020-11-18 20:00:00,2020-11-18 00:00:00,LABORABLE
18,11,2020,22,486,559,1045,2020-11-18 21:00:00,2020-11-18 00:00:00,LABORABLE
18,11,2020,23,369,413,782,2020-11-18 22:00:00,2020-11-18 00:00:00,LABORABLE
18,11,2020,24,224,262,486,2020-11-18 23:00:00,2020-11-18 00:00:00,LABORABLE
19,11,2020,1,124,164,288,2020-11-19 00:00:00,2020-11-19 00:00:00,LABORABLE
19,11,2020,2,60,83,143,2020-11-19 01:00:00,2020-11-19 00:00:00,LABORABLE
19,11,2020,3,46,54,100,2020-11-19 02:00:00,2020-11-19 00:00:00,LABORABLE
19,11,2020,4,39,41,80,2020-11-19 03:00:00,2020-11-19 00:00:00,LABORABLE
19,11,2020,5,52,63,115,2020-11-19 04:00:00,2020-11-19 00:00:00,LABORABLE
19,11,2020,6,144,116,260,2020-11-19 05:00:00,2020-11-19 00:00:00,LABORABLE
19,11,2020,7,425,338,763,2020-11-19 06:00:00,2020-11-19 00:00:00,LABORABLE
19,11,2020,8,678,598,1276,2020-11-19 07:00:00,2020-11-19 00:00:00,LABORABLE
19,11,2020,9,663,737,1400,2020-11-19 08:00:00,2020-11-19 00:00:00,LABORABLE
19,11,2020,10,637,754,1391,2020-11-19 09:00:00,2020-11-19 00:00:00,LABORABLE
19,11,2020,11,617,643,1260,2020-11-19 10:00:00,2020-11-19 00:00:00,LABORABLE
19,11,2020,12,502,625,1127,2020-11-19 11:00:00,2020-11-19 00:00:00,LABORABLE
19,11,2020,13,624,814,1438,2020-11-19 12:00:00,2020-11-19 00:00:00,LABORABLE
19,11,2020,14,679,822,1501,2020-11-19 13:00:00,2020-11-19 00:00:00,LABORABLE
19,11,2020,15,636,776,1412,2020-11-19 14:00:00,2020-11-19 00:00:00,LABORABLE
19,11,2020,16,625,672,1297,2020-11-19 15:00:00,2020-11-19 00:00:00,LABORABLE
19,11,2020,17,644,722,1366,2020-11-19 16:00:00,2020-11-19 00:00:00,LABORABLE
19,11,2020,18,716,790,1506,2020-11-19 17:00:00,2020-11-19 00:00:00,LABORABLE
19,11,2020,19,712,824,1536,2020-11-19 18:00:00,2020-11-19 00:00:00,LABORABLE
19,11,2020,20,699,767,1466,2020-11-19 19:00:00,2020-11-19 00:00:00,LABORABLE
19,11,2020,21,653,707,1360,2020-11-19 20:00:00,2020-11-19 00:00:00,LABORABLE
19,11,2020,22,480,630,1110,2020-11-19 21:00:00,2020-11-19 00:00:00,LABORABLE
19,11,2020,23,365,427,792,2020-11-19 22:00:00,2020-11-19 00:00:00,LABORABLE
19,11,2020,24,246,281,527,2020-11-19 23:00:00,2020-11-19 00:00:00,LABORABLE
20,11,2020,1,131,175,306,2020-11-20 00:00:00,2020-11-20 00:00:00,LABORABLE
20,11,2020,2,64,97,161,2020-11-20 01:00:00,2020-11-20 00:00:00,LABORABLE
20,11,2020,3,40,61,101,2020-11-20 02:00:00,2020-11-20 00:00:00,LABORABLE
20,11,2020,4,51,47,98,2020-11-20 03:00:00,2020-11-20 00:00:00,LABORABLE
20,11,2020,5,64,64,128,2020-11-20 04:00:00,2020-11-20 00:00:00,LABORABLE
20,11,2020,6,155,123,278,2020-11-20 05:00:00,2020-11-20 00:00:00,LABORABLE
20,11,2020,7,423,309,732,2020-11-20 06:00:00,2020-11-20 00:00:00,LABORABLE
20,11,2020,8,685,602,1287,2020-11-20 07:00:00,2020-11-20 00:00:00,LABORABLE
20,11,2020,9,746,712,1458,2020-11-20 08:00:00,2020-11-20 00:00:00,LABORABLE
20,11,2020,10,641,779,1420,2020-11-20 09:00:00,2020-11-20 00:00:00,LABORABLE
20,11,2020,11,547,807,1354,2020-11-20 10:00:00,2020-11-20 00:00:00,LABORABLE
20,11,2020,12,589,780,1369,2020-11-20 11:00:00,2020-11-20 00:00:00,LABORABLE
20,11,2020,13,653,792,1445,2020-11-20 12:00:00,2020-11-20 00:00:00,LABORABLE
20,11,2020,14,698,822,1520,2020-11-20 13:00:00,2020-11-20 00:00:00,LABORABLE
20,11,2020,15,675,850,1525,2020-11-20 14:00:00,2020-11-20 00:00:00,LABORABLE
20,11,2020,16,670,728,1398,2020-11-20 15:00:00,2020-11-20 00:00:00,LABORABLE
20,11,2020,17,631,808,1439,2020-11-20 16:00:00,2020-11-20 00:00:00,LABORABLE
20,11,2020,18,752,816,1568,2020-11-20 17:00:00,2020-11-20 00:00:00,LABORABLE
20,11,2020,19,729,891,1620,2020-11-20 18:00:00,2020-11-20 00:00:00,LABORABLE
20,11,2020,20,706,862,1568,2020-11-20 19:00:00,2020-11-20 00:00:00,LABORABLE
20,11,2020,21,631,793,1424,2020-11-20 20:00:00,2020-11-20 00:00:00,LABORABLE
20,11,2020,22,553,718,1271,2020-11-20 21:00:00,2020-11-20 00:00:00,LABORABLE
20,11,2020,23,460,600,1060,2020-11-20 22:00:00,2020-11-20 00:00:00,LABORABLE
20,11,2020,24,374,422,796,2020-11-20 23:00:00,2020-11-20 00:00:00,LABORABLE
21,11,2020,1,212,290,502,2020-11-21 00:00:00,2020-11-21 00:00:00,LABORABLE
21,11,2020,2,94,150,244,2020-11-21 01:00:00,2020-11-21 00:00:00,LABORABLE
21,11,2020,3,69,92,161,2020-11-21 02:00:00,2020-11-21 00:00:00,LABORABLE
21,11,2020,4,56,63,119,2020-11-21 03:00:00,2020-11-21 00:00:00,LABORABLE
21,11,2020,5,51,63,114,2020-11-21 04:00:00,2020-11-21 00:00:00,LABORABLE
21,11,2020,6,98,87,185,2020-11-21 05:00:00,2020-11-21 00:00:00,LABORABLE
21,11,2020,7,169,148,317,2020-11-21 06:00:00,2020-11-21 00:00:00,LABORABLE
21,11,2020,8,269,238,507,2020-11-21 07:00:00,2020-11-21 00:00:00,LABORABLE
21,11,2020,9,334,357,691,2020-11-21 08:00:00,2020-11-21 00:00:00,LABORABLE
21,11,2020,10,465,528,993,2020-11-21 09:00:00,2020-11-21 00:00:00,LABORABLE
21,11,2020,11,523,595,1118,2020-11-21 10:00:00,2020-11-21 00:00:00,LABORABLE
21,11,2020,12,597,731,1328,2020-11-21 11:00:00,2020-11-21 00:00:00,LABORABLE
21,11,2020,13,633,856,1489,2020-11-21 12:00:00,2020-11-21 00:00:00,LABORABLE
21,11,2020,14,658,913,1571,2020-11-21 13:00:00,2020-11-21 00:00:00,LABORABLE
21,11,2020,15,643,877,1520,2020-11-21 14:00:00,2020-11-21 00:00:00,LABORABLE
21,11,2020,16,529,777,1306,2020-11-21 15:00:00,2020-11-21 00:00:00,LABORABLE
21,11,2020,17,481,725,1206,2020-11-21 16:00:00,2020-11-21 00:00:00,LABORABLE
21,11,2020,18,547,771,1318,2020-11-21 17:00:00,2020-11-21 00:00:00,LABORABLE
21,11,2020,19,609,851,1460,2020-11-21 18:00:00,2020-11-21 00:00:00,LABORABLE
21,11,2020,20,632,815,1447,2020-11-21 19:00:00,2020-11-21 00:00:00,LABORABLE
21,11,2020,21,590,667,1257,2020-11-21 20:00:00,2020-11-21 00:00:00,LABORABLE
21,11,2020,22,511,649,1160,2020-11-21 21:00:00,2020-11-21 00:00:00,LABORABLE
21,11,2020,23,443,510,953,2020-11-21 22:00:00,2020-11-21 00:00:00,LABORABLE
21,11,2020,24,427,480,907,2020-11-21 23:00:00,2020-11-21 00:00:00,LABORABLE
22,11,2020,1,268,343,611,2020-11-22 00:00:00,2020-11-22 00:00:00,LABORABLE
22,11,2020,2,131,200,331,2020-11-22 01:00:00,2020-11-22 00:00:00,LABORABLE
22,11,2020,3,65,103,168,2020-11-22 02:00:00,2020-11-22 00:00:00,LABORABLE
22,11,2020,4,43,102,145,2020-11-22 03:00:00,2020-11-22 00:00:00,LABORABLE
22,11,2020,5,31,44,75,2020-11-22 04:00:00,2020-11-22 00:00:00,LABORABLE
22,11,2020,6,48,67,115,2020-11-22 05:00:00,2020-11-22 00:00:00,LABORABLE
22,11,2020,7,81,92,173,2020-11-22 06:00:00,2020-11-22 00:00:00,LABORABLE
22,11,2020,8,139,145,284,2020-11-22 07:00:00,2020-11-22 00:00:00,LABORABLE
22,11,2020,9,229,247,476,2020-11-22 08:00:00,2020-11-22 00:00:00,LABORABLE
22,11,2020,10,290,380,670,2020-11-22 09:00:00,2020-11-22 00:00:00,LABORABLE
22,11,2020,11,463,458,921,2020-11-22 10:00:00,2020-11-22 00:00:00,LABORABLE
22,11,2020,12,540,628,1168,2020-11-22 11:00:00,2020-11-22 00:00:00,LABORABLE
22,11,2020,13,573,736,1309,2020-11-22 12:00:00,2020-11-22 00:00:00,LABORABLE
22,11,2020,14,619,717,1336,2020-11-22 13:00:00,2020-11-22 00:00:00,LABORABLE
22,11,2020,15,564,782,1346,2020-11-22 14:00:00,2020-11-22 00:00:00,LABORABLE
22,11,2020,16,415,669,1084,2020-11-22 15:00:00,2020-11-22 00:00:00,LABORABLE
22,11,2020,17,446,647,1093,2020-11-22 16:00:00,2020-11-22 00:00:00,LABORABLE
22,11,2020,18,538,725,1263,2020-11-22 17:00:00,2020-11-22 00:00:00,LABORABLE
22,11,2020,19,523,710,1233,2020-11-22 18:00:00,2020-11-22 00:00:00,LABORABLE
22,11,2020,20,548,652,1200,2020-11-22 19:00:00,2020-11-22 00:00:00,LABORABLE
22,11,2020,21,443,560,1003,2020-11-22 20:00:00,2020-11-22 00:00:00,LABORABLE
22,11,2020,22,418,507,925,2020-11-22 21:00:00,2020-11-22 00:00:00,LABORABLE
22,11,2020,23,339,377,716,2020-11-22 22:00:00,2020-11-22 00:00:00,LABORABLE
22,11,2020,24,205,267,472,2020-11-22 23:00:00,2020-11-22 00:00:00,LABORABLE
23,11,2020,1,127,231,358,2020-11-23 00:00:00,2020-11-23 00:00:00,LABORABLE
23,11,2020,2,60,71,131,2020-11-23 01:00:00,2020-11-23 00:00:00,LABORABLE
23,11,2020,3,46,62,108,2020-11-23 02:00:00,2020-11-23 00:00:00,LABORABLE
23,11,2020,4,47,44,91,2020-11-23 03:00:00,2020-11-23 00:00:00,LABORABLE
23,11,2020,5,44,45,89,2020-11-23 04:00:00,2020-11-23 00:00:00,LABORABLE
23,11,2020,6,154,103,257,2020-11-23 05:00:00,2020-11-23 00:00:00,LABORABLE
23,11,2020,7,437,315,752,2020-11-23 06:00:00,2020-11-23 00:00:00,LABORABLE
23,11,2020,8,685,591,1276,2020-11-23 07:00:00,2020-11-23 00:00:00,LABORABLE
23,11,2020,9,697,726,1423,2020-11-23 08:00:00,2020-11-23 00:00:00,LABORABLE
23,11,2020,10,631,762,1393,2020-11-23 09:00:00,2020-11-23 00:00:00,LABORABLE
23,11,2020,11,431,667,1098,2020-11-23 10:00:00,2020-11-23 00:00:00,LABORABLE
23,11,2020,12,639,696,1335,2020-11-23 11:00:00,2020-11-23 00:00:00,LABORABLE
23,11,2020,13,621,714,1335,2020-11-23 12:00:00,2020-11-23 00:00:00,LABORABLE
23,11,2020,14,597,795,1392,2020-11-23 13:00:00,2020-11-23 00:00:00,LABORABLE
23,11,2020,15,649,783,1432,2020-11-23 14:00:00,2020-11-23 00:00:00,LABORABLE
23,11,2020,16,617,714,1331,2020-11-23 15:00:00,2020-11-23 00:00:00,LABORABLE
23,11,2020,17,620,670,1290,2020-11-23 16:00:00,2020-11-23 00:00:00,LABORABLE
23,11,2020,18,682,788,1470,2020-11-23 17:00:00,2020-11-23 00:00:00,LABORABLE
23,11,2020,19,666,849,1515,2020-11-23 18:00:00,2020-11-23 00:00:00,LABORABLE
23,11,2020,20,649,816,1465,2020-11-23 19:00:00,2020-11-23 00:00:00,LABORABLE
23,11,2020,21,555,719,1274,2020-11-23 20:00:00,2020-11-23 00:00:00,LABORABLE
23,11,2020,22,407,552,959,2020-11-23 21:00:00,2020-11-23 00:00:00,LABORABLE
23,11,2020,23,313,385,698,2020-11-23 22:00:00,2020-11-23 00:00:00,LABORABLE
23,11,2020,24,184,220,404,2020-11-23 23:00:00,2020-11-23 00:00:00,LABORABLE
24,11,2020,1,90,131,221,2020-11-24 00:00:00,2020-11-24 00:00:00,LABORABLE
24,11,2020,2,60,47,107,2020-11-24 01:00:00,2020-11-24 00:00:00,LABORABLE
24,11,2020,3,37,48,85,2020-11-24 02:00:00,2020-11-24 00:00:00,LABORABLE
24,11,2020,4,43,39,82,2020-11-24 03:00:00,2020-11-24 00:00:00,LABORABLE
24,11,2020,5,67,55,122,2020-11-24 04:00:00,2020-11-24 00:00:00,LABORABLE
24,11,2020,6,155,120,275,2020-11-24 05:00:00,2020-11-24 00:00:00,LABORABLE
24,11,2020,7,423,323,746,2020-11-24 06:00:00,2020-11-24 00:00:00,LABORABLE
24,11,2020,8,682,646,1328,2020-11-24 07:00:00,2020-11-24 00:00:00,LABORABLE
24,11,2020,9,698,749,1447,2020-11-24 08:00:00,2020-11-24 00:00:00,LABORABLE
24,11,2020,10,644,769,1413,2020-11-24 09:00:00,2020-11-24 00:00:00,LABORABLE
24,11,2020,11,566,710,1276,2020-11-24 10:00:00,2020-11-24 00:00:00,LABORABLE
24,11,2020,12,551,701,1252,2020-11-24 11:00:00,2020-11-24 00:00:00,LABORABLE
24,11,2020,13,616,725,1341,2020-11-24 12:00:00,2020-11-24 00:00:00,LABORABLE
24,11,2020,14,633,779,1412,2020-11-24 13:00:00,2020-11-24 00:00:00,LABORABLE
24,11,2020,15,676,772,1448,2020-11-24 14:00:00,2020-11-24 00:00:00,LABORABLE
24,11,2020,16,601,713,1314,2020-11-24 15:00:00,2020-11-24 00:00:00,LABORABLE
24,11,2020,17,621,744,1365,2020-11-24 16:00:00,2020-11-24 00:00:00,LABORABLE
24,11,2020,18,668,805,1473,2020-11-24 17:00:00,2020-11-24 00:00:00,LABORABLE
24,11,2020,19,668,774,1442,2020-11-24 18:00:00,2020-11-24 00:00:00,LABORABLE
24,11,2020,20,633,789,1422,2020-11-24 19:00:00,2020-11-24 00:00:00,LABORABLE
24,11,2020,21,594,695,1289,2020-11-24 20:00:00,2020-11-24 00:00:00,LABORABLE
24,11,2020,22,477,566,1043,2020-11-24 21:00:00,2020-11-24 00:00:00,LABORABLE
24,11,2020,23,337,389,726,2020-11-24 22:00:00,2020-11-24 00:00:00,LABORABLE
24,11,2020,24,211,233,444,2020-11-24 23:00:00,2020-11-24 00:00:00,LABORABLE
25,11,2020,1,101,174,275,2020-11-25 00:00:00,2020-11-25 00:00:00,LABORABLE
25,11,2020,2,50,68,118,2020-11-25 01:00:00,2020-11-25 00:00:00,LABORABLE
25,11,2020,3,47,54,101,2020-11-25 02:00:00,2020-11-25 00:00:00,LABORABLE
25,11,2020,4,41,33,74,2020-11-25 03:00:00,2020-11-25 00:00:00,LABORABLE
25,11,2020,5,59,44,103,2020-11-25 04:00:00,2020-11-25 00:00:00,LABORABLE
25,11,2020,6,153,115,268,2020-11-25 05:00:00,2020-11-25 00:00:00,LABORABLE
25,11,2020,7,452,327,779,2020-11-25 06:00:00,2020-11-25 00:00:00,LABORABLE
25,11,2020,8,666,549,1215,2020-11-25 07:00:00,2020-11-25 00:00:00,LABORABLE
25,11,2020,9,665,705,1370,2020-11-25 08:00:00,2020-11-25 00:00:00,LABORABLE
25,11,2020,10,667,729,1396,2020-11-25 09:00:00,2020-11-25 00:00:00,LABORABLE
25,11,2020,11,619,718,1337,2020-11-25 10:00:00,2020-11-25 00:00:00,LABORABLE
25,11,2020,12,604,725,1329,2020-11-25 11:00:00,2020-11-25 00:00:00,LABORABLE
25,11,2020,13,606,765,1371,2020-11-25 12:00:00,2020-11-25 00:00:00,LABORABLE
25,11,2020,14,656,738,1394,2020-11-25 13:00:00,2020-11-25 00:00:00,LABORABLE
25,11,2020,15,671,821,1492,2020-11-25 14:00:00,2020-11-25 00:00:00,LABORABLE
25,11,2020,16,667,662,1329,2020-11-25 15:00:00,2020-11-25 00:00:00,LABORABLE
25,11,2020,17,636,768,1404,2020-11-25 16:00:00,2020-11-25 00:00:00,LABORABLE
25,11,2020,18,735,695,1430,2020-11-25 17:00:00,2020-11-25 00:00:00,LABORABLE
25,11,2020,19,661,752,1413,2020-11-25 18:00:00,2020-11-25 00:00:00,LABORABLE
25,11,2020,20,630,787,1417,2020-11-25 19:00:00,2020-11-25 00:00:00,LABORABLE
25,11,2020,21,599,646,1245,2020-11-25 20:00:00,2020-11-25 00:00:00,LABORABLE
25,11,2020,22,453,556,1009,2020-11-25 21:00:00,2020-11-25 00:00:00,LABORABLE
25,11,2020,23,347,405,752,2020-11-25 22:00:00,2020-11-25 00:00:00,LABORABLE
25,11,2020,24,217,245,462,2020-11-25 23:00:00,2020-11-25 00:00:00,LABORABLE
26,11,2020,1,124,173,297,2020-11-26 00:00:00,2020-11-26 00:00:00,LABORABLE
26,11,2020,2,62,82,144,2020-11-26 01:00:00,2020-11-26 00:00:00,LABORABLE
26,11,2020,3,40,64,104,2020-11-26 02:00:00,2020-11-26 00:00:00,LABORABLE
26,11,2020,4,40,39,79,2020-11-26 03:00:00,2020-11-26 00:00:00,LABORABLE
26,11,2020,5,63,48,111,2020-11-26 04:00:00,2020-11-26 00:00:00,LABORABLE
26,11,2020,6,154,121,275,2020-11-26 05:00:00,2020-11-26 00:00:00,LABORABLE
26,11,2020,7,419,303,722,2020-11-26 06:00:00,2020-11-26 00:00:00,LABORABLE
26,11,2020,8,668,594,1262,2020-11-26 07:00:00,2020-11-26 00:00:00,LABORABLE
26,11,2020,9,643,743,1386,2020-11-26 08:00:00,2020-11-26 00:00:00,LABORABLE
26,11,2020,10,626,794,1420,2020-11-26 09:00:00,2020-11-26 00:00:00,LABORABLE
26,11,2020,11,568,711,1279,2020-11-26 10:00:00,2020-11-26 00:00:00,LABORABLE
26,11,2020,12,676,787,1463,2020-11-26 11:00:00,2020-11-26 00:00:00,LABORABLE
26,11,2020,13,656,762,1418,2020-11-26 12:00:00,2020-11-26 00:00:00,LABORABLE
26,11,2020,14,655,796,1451,2020-11-26 13:00:00,2020-11-26 00:00:00,LABORABLE
26,11,2020,15,666,825,1491,2020-11-26 14:00:00,2020-11-26 00:00:00,LABORABLE
26,11,2020,16,650,657,1307,2020-11-26 15:00:00,2020-11-26 00:00:00,LABORABLE
26,11,2020,17,684,775,1459,2020-11-26 16:00:00,2020-11-26 00:00:00,LABORABLE
26,11,2020,18,740,756,1496,2020-11-26 17:00:00,2020-11-26 00:00:00,LABORABLE
26,11,2020,19,668,832,1500,2020-11-26 18:00:00,2020-11-26 00:00:00,LABORABLE
26,11,2020,20,655,798,1453,2020-11-26 19:00:00,2020-11-26 00:00:00,LABORABLE
26,11,2020,21,591,691,1282,2020-11-26 20:00:00,2020-11-26 00:00:00,LABORABLE
26,11,2020,22,497,629,1126,2020-11-26 21:00:00,2020-11-26 00:00:00,LABORABLE
26,11,2020,23,343,412,755,2020-11-26 22:00:00,2020-11-26 00:00:00,LABORABLE
26,11,2020,24,242,267,509,2020-11-26 23:00:00,2020-11-26 00:00:00,LABORABLE
27,11,2020,1,147,169,316,2020-11-27 00:00:00,2020-11-27 00:00:00,LABORABLE
27,11,2020,2,64,94,158,2020-11-27 01:00:00,2020-11-27 00:00:00,LABORABLE
27,11,2020,3,37,63,100,2020-11-27 02:00:00,2020-11-27 00:00:00,LABORABLE
27,11,2020,4,45,42,87,2020-11-27 03:00:00,2020-11-27 00:00:00,LABORABLE
27,11,2020,5,64,57,121,2020-11-27 04:00:00,2020-11-27 00:00:00,LABORABLE
27,11,2020,6,160,107,267,2020-11-27 05:00:00,2020-11-27 00:00:00,LABORABLE
27,11,2020,7,399,294,693,2020-11-27 06:00:00,2020-11-27 00:00:00,LABORABLE
27,11,2020,8,663,619,1282,2020-11-27 07:00:00,2020-11-27 00:00:00,LABORABLE
27,11,2020,9,707,740,1447,2020-11-27 08:00:00,2020-11-27 00:00:00,LABORABLE
27,11,2020,10,658,798,1456,2020-11-27 09:00:00,2020-11-27 00:00:00,LABORABLE
27,11,2020,11,642,739,1381,2020-11-27 10:00:00,2020-11-27 00:00:00,LABORABLE
27,11,2020,12,568,752,1320,2020-11-27 11:00:00,2020-11-27 00:00:00,LABORABLE
27,11,2020,13,661,796,1457,2020-11-27 12:00:00,2020-11-27 00:00:00,LABORABLE
27,11,2020,14,684,817,1501,2020-11-27 13:00:00,2020-11-27 00:00:00,LABORABLE
27,11,2020,15,682,825,1507,2020-11-27 14:00:00,2020-11-27 00:00:00,LABORABLE
27,11,2020,16,639,729,1368,2020-11-27 15:00:00,2020-11-27 00:00:00,LABORABLE
27,11,2020,17,590,851,1441,2020-11-27 16:00:00,2020-11-27 00:00:00,LABORABLE
27,11,2020,18,676,822,1498,2020-11-27 17:00:00,2020-11-27 00:00:00,LABORABLE
27,11,2020,19,678,896,1574,2020-11-27 18:00:00,2020-11-27 00:00:00,LABORABLE
27,11,2020,20,650,776,1426,2020-11-27 19:00:00,2020-11-27 00:00:00,LABORABLE
27,11,2020,21,647,797,1444,2020-11-27 20:00:00,2020-11-27 00:00:00,LABORABLE
27,11,2020,22,496,684,1180,2020-11-27 21:00:00,2020-11-27 00:00:00,LABORABLE
27,11,2020,23,439,587,1026,2020-11-27 22:00:00,2020-11-27 00:00:00,LABORABLE
27,11,2020,24,368,411,779,2020-11-27 23:00:00,2020-11-27 00:00:00,LABORABLE
28,11,2020,1,243,292,535,2020-11-28 00:00:00,2020-11-28 00:00:00,LABORABLE
28,11,2020,2,111,172,283,2020-11-28 01:00:00,2020-11-28 00:00:00,LABORABLE
28,11,2020,3,75,77,152,2020-11-28 02:00:00,2020-11-28 00:00:00,LABORABLE
28,11,2020,4,59,59,118,2020-11-28 03:00:00,2020-11-28 00:00:00,LABORABLE
28,11,2020,5,52,53,105,2020-11-28 04:00:00,2020-11-28 00:00:00,LABORABLE
28,11,2020,6,94,85,179,2020-11-28 05:00:00,2020-11-28 00:00:00,LABORABLE
28,11,2020,7,176,164,340,2020-11-28 06:00:00,2020-11-28 00:00:00,LABORABLE
28,11,2020,8,295,260,555,2020-11-28 07:00:00,2020-11-28 00:00:00,LABORABLE
28,11,2020,9,345,379,724,2020-11-28 08:00:00,2020-11-28 00:00:00,LABORABLE
28,11,2020,10,474,521,995,2020-11-28 09:00:00,2020-11-28 00:00:00,LABORABLE
28,11,2020,11,619,631,1250,2020-11-28 10:00:00,2020-11-28 00:00:00,LABORABLE
28,11,2020,12,652,830,1482,2020-11-28 11:00:00,2020-11-28 00:00:00,LABORABLE
28,11,2020,13,670,892,1562,2020-11-28 12:00:00,2020-11-28 00:00:00,LABORABLE
28,11,2020,14,693,916,1609,2020-11-28 13:00:00,2020-11-28 00:00:00,LABORABLE
28,11,2020,15,671,836,1507,2020-11-28 14:00:00,2020-11-28 00:00:00,LABORABLE
28,11,2020,16,578,816,1394,2020-11-28 15:00:00,2020-11-28 00:00:00,LABORABLE
28,11,2020,17,566,703,1269,2020-11-28 16:00:00,2020-11-28 00:00:00,LABORABLE
28,11,2020,18,629,808,1437,2020-11-28 17:00:00,2020-11-28 00:00:00,LABORABLE
28,11,2020,19,652,859,1511,2020-11-28 18:00:00,2020-11-28 00:00:00,LABORABLE
28,11,2020,20,612,843,1455,2020-11-28 19:00:00,2020-11-28 00:00:00,LABORABLE
28,11,2020,21,552,721,1273,2020-11-28 20:00:00,2020-11-28 00:00:00,LABORABLE
28,11,2020,22,502,619,1121,2020-11-28 21:00:00,2020-11-28 00:00:00,LABORABLE
28,11,2020,23,473,504,977,2020-11-28 22:00:00,2020-11-28 00:00:00,LABORABLE
28,11,2020,24,440,509,949,2020-11-28 23:00:00,2020-11-28 00:00:00,LABORABLE
29,11,2020,1,292,358,650,2020-11-29 00:00:00,2020-11-29 00:00:00,LABORABLE
29,11,2020,2,117,220,337,2020-11-29 01:00:00,2020-11-29 00:00:00,LABORABLE
29,11,2020,3,80,124,204,2020-11-29 02:00:00,2020-11-29 00:00:00,LABORABLE
29,11,2020,4,40,108,148,2020-11-29 03:00:00,2020-11-29 00:00:00,LABORABLE
29,11,2020,5,38,64,102,2020-11-29 04:00:00,2020-11-29 00:00:00,LABORABLE
29,11,2020,6,60,77,137,2020-11-29 05:00:00,2020-11-29 00:00:00,LABORABLE
29,11,2020,7,102,119,221,2020-11-29 06:00:00,2020-11-29 00:00:00,LABORABLE
29,11,2020,8,147,159,306,2020-11-29 07:00:00,2020-11-29 00:00:00,LABORABLE
29,11,2020,9,194,241,435,2020-11-29 08:00:00,2020-11-29 00:00:00,LABORABLE
29,11,2020,10,301,386,687,2020-11-29 09:00:00,2020-11-29 00:00:00,LABORABLE
29,11,2020,11,442,519,961,2020-11-29 10:00:00,2020-11-29 00:00:00,LABORABLE
29,11,2020,12,479,706,1185,2020-11-29 11:00:00,2020-11-29 00:00:00,LABORABLE
29,11,2020,13,618,752,1370,2020-11-29 12:00:00,2020-11-29 00:00:00,LABORABLE
29,11,2020,14,625,775,1400,2020-11-29 13:00:00,2020-11-29 00:00:00,LABORABLE
29,11,2020,15,585,743,1328,2020-11-29 14:00:00,2020-11-29 00:00:00,LABORABLE
29,11,2020,16,483,683,1166,2020-11-29 15:00:00,2020-11-29 00:00:00,LABORABLE
29,11,2020,17,478,721,1199,2020-11-29 16:00:00,2020-11-29 00:00:00,LABORABLE
29,11,2020,18,501,784,1285,2020-11-29 17:00:00,2020-11-29 00:00:00,LABORABLE
29,11,2020,19,551,729,1280,2020-11-29 18:00:00,2020-11-29 00:00:00,LABORABLE
29,11,2020,20,541,704,1245,2020-11-29 19:00:00,2020-11-29 00:00:00,LABORABLE
29,11,2020,21,439,627,1066,2020-11-29 20:00:00,2020-11-29 00:00:00,LABORABLE
29,11,2020,22,441,513,954,2020-11-29 21:00:00,2020-11-29 00:00:00,LABORABLE
29,11,2020,23,391,416,807,2020-11-29 22:00:00,2020-11-29 00:00:00,LABORABLE
29,11,2020,24,249,296,545,2020-11-29 23:00:00,2020-11-29 00:00:00,LABORABLE
30,11,2020,1,160,248,408,2020-11-30 00:00:00,2020-11-30 00:00:00,LABORABLE
30,11,2020,2,54,87,141,2020-11-30 01:00:00,2020-11-30 00:00:00,LABORABLE
30,11,2020,3,55,64,119,2020-11-30 02:00:00,2020-11-30 00:00:00,LABORABLE
30,11,2020,4,42,42,84,2020-11-30 03:00:00,2020-11-30 00:00:00,LABORABLE
30,11,2020,5,50,43,93,2020-11-30 04:00:00,2020-11-30 00:00:00,LABORABLE
30,11,2020,6,153,131,284,2020-11-30 05:00:00,2020-11-30 00:00:00,LABORABLE
30,11,2020,7,430,326,756,2020-11-30 06:00:00,2020-11-30 00:00:00,LABORABLE
30,11,2020,8,685,620,1305,2020-11-30 07:00:00,2020-11-30 00:00:00,LABORABLE
30,11,2020,9,694,726,1420,2020-11-30 08:00:00,2020-11-30 00:00:00,LABORABLE
30,11,2020,10,646,805,1451,2020-11-30 09:00:00,2020-11-30 00:00:00,LABORABLE
30,11,2020,11,540,729,1269,2020-11-30 10:00:00,2020-11-30 00:00:00,LABORABLE
30,11,2020,12,610,722,1332,2020-11-30 11:00:00,2020-11-30 00:00:00,LABORABLE
30,11,2020,13,617,700,1317,2020-11-30 12:00:00,2020-11-30 00:00:00,LABORABLE
30,11,2020,14,648,842,1490,2020-11-30 13:00:00,2020-11-30 00:00:00,LABORABLE
30,11,2020,15,670,802,1472,2020-11-30 14:00:00,2020-11-30 00:00:00,LABORABLE
30,11,2020,16,686,694,1380,2020-11-30 15:00:00,2020-11-30 00:00:00,LABORABLE
30,11,2020,17,570,737,1307,2020-11-30 16:00:00,2020-11-30 00:00:00,LABORABLE
30,11,2020,18,680,787,1467,2020-11-30 17:00:00,2020-11-30 00:00:00,LABORABLE
30,11,2020,19,697,852,1549,2020-11-30 18:00:00,2020-11-30 00:00:00,LABORABLE
30,11,2020,20,666,863,1529,2020-11-30 19:00:00,2020-11-30 00:00:00,LABORABLE
30,11,2020,21,563,721,1284,2020-11-30 20:00:00,2020-11-30 00:00:00,LABORABLE
30,11,2020,22,438,533,971,2020-11-30 21:00:00,2020-11-30 00:00:00,LABORABLE
30,11,2020,23,349,424,773,2020-11-30 22:00:00,2020-11-30 00:00:00,LABORABLE
30,11,2020,24,197,253,450,2020-11-30 23:00:00,2020-11-30 00:00:00,LABORABLE
1,12,2020,1,106,162,268,2020-12-01 00:00:00,2020-01-12 00:00:00,LABORABLE
1,12,2020,2,49,67,116,2020-12-01 01:00:00,2020-01-12 00:00:00,LABORABLE
1,12,2020,3,40,73,113,2020-12-01 02:00:00,2020-01-12 00:00:00,LABORABLE
1,12,2020,4,45,35,80,2020-12-01 03:00:00,2020-01-12 00:00:00,LABORABLE
1,12,2020,5,71,50,121,2020-12-01 04:00:00,2020-01-12 00:00:00,LABORABLE
1,12,2020,6,157,111,268,2020-12-01 05:00:00,2020-01-12 00:00:00,LABORABLE
1,12,2020,7,438,315,753,2020-12-01 06:00:00,2020-01-12 00:00:00,LABORABLE
1,12,2020,8,669,607,1276,2020-12-01 07:00:00,2020-01-12 00:00:00,LABORABLE
1,12,2020,9,681,732,1413,2020-12-01 08:00:00,2020-01-12 00:00:00,LABORABLE
1,12,2020,10,629,784,1413,2020-12-01 09:00:00,2020-01-12 00:00:00,LABORABLE
1,12,2020,11,588,648,1236,2020-12-01 10:00:00,2020-01-12 00:00:00,LABORABLE
1,12,2020,12,576,760,1336,2020-12-01 11:00:00,2020-01-12 00:00:00,LABORABLE
1,12,2020,13,663,747,1410,2020-12-01 12:00:00,2020-01-12 00:00:00,LABORABLE
1,12,2020,14,624,830,1454,2020-12-01 13:00:00,2020-01-12 00:00:00,LABORABLE
1,12,2020,15,691,812,1503,2020-12-01 14:00:00,2020-01-12 00:00:00,LABORABLE
1,12,2020,16,651,759,1410,2020-12-01 15:00:00,2020-01-12 00:00:00,LABORABLE
1,12,2020,17,656,747,1403,2020-12-01 16:00:00,2020-01-12 00:00:00,LABORABLE
1,12,2020,18,676,784,1460,2020-12-01 17:00:00,2020-01-12 00:00:00,LABORABLE
1,12,2020,19,691,828,1519,2020-12-01 18:00:00,2020-01-12 00:00:00,LABORABLE
1,12,2020,20,629,813,1442,2020-12-01 19:00:00,2020-01-12 00:00:00,LABORABLE
1,12,2020,21,569,712,1281,2020-12-01 20:00:00,2020-01-12 00:00:00,LABORABLE
1,12,2020,22,441,543,984,2020-12-01 21:00:00,2020-01-12 00:00:00,LABORABLE
1,12,2020,23,367,442,809,2020-12-01 22:00:00,2020-01-12 00:00:00,LABORABLE
1,12,2020,24,223,263,486,2020-12-01 23:00:00,2020-01-12 00:00:00,LABORABLE
2,12,2020,1,122,201,323,2020-12-02 00:00:00,2020-02-12 00:00:00,LABORABLE
2,12,2020,2,65,89,154,2020-12-02 01:00:00,2020-02-12 00:00:00,LABORABLE
2,12,2020,3,35,62,97,2020-12-02 02:00:00,2020-02-12 00:00:00,LABORABLE
2,12,2020,4,43,36,79,2020-12-02 03:00:00,2020-02-12 00:00:00,LABORABLE
2,12,2020,5,60,60,120,2020-12-02 04:00:00,2020-02-12 00:00:00,LABORABLE
2,12,2020,6,161,160,321,2020-12-02 05:00:00,2020-02-12 00:00:00,LABORABLE
2,12,2020,7,445,330,775,2020-12-02 06:00:00,2020-02-12 00:00:00,LABORABLE
2,12,2020,8,676,631,1307,2020-12-02 07:00:00,2020-02-12 00:00:00,LABORABLE
2,12,2020,9,718,717,1435,2020-12-02 08:00:00,2020-02-12 00:00:00,LABORABLE
2,12,2020,10,685,784,1469,2020-12-02 09:00:00,2020-02-12 00:00:00,LABORABLE
2,12,2020,11,579,781,1360,2020-12-02 10:00:00,2020-02-12 00:00:00,LABORABLE
2,12,2020,12,640,795,1435,2020-12-02 11:00:00,2020-02-12 00:00:00,LABORABLE
2,12,2020,13,608,828,1436,2020-12-02 12:00:00,2020-02-12 00:00:00,LABORABLE
2,12,2020,14,626,884,1510,2020-12-02 13:00:00,2020-02-12 00:00:00,LABORABLE
2,12,2020,15,707,829,1536,2020-12-02 14:00:00,2020-02-12 00:00:00,LABORABLE
2,12,2020,16,666,700,1366,2020-12-02 15:00:00,2020-02-12 00:00:00,LABORABLE
2,12,2020,17,624,817,1441,2020-12-02 16:00:00,2020-02-12 00:00:00,LABORABLE
2,12,2020,18,679,747,1426,2020-12-02 17:00:00,2020-02-12 00:00:00,LABORABLE
2,12,2020,19,648,858,1506,2020-12-02 18:00:00,2020-02-12 00:00:00,LABORABLE
2,12,2020,20,694,785,1479,2020-12-02 19:00:00,2020-02-12 00:00:00,LABORABLE
2,12,2020,21,614,782,1396,2020-12-02 20:00:00,2020-02-12 00:00:00,LABORABLE
2,12,2020,22,503,588,1091,2020-12-02 21:00:00,2020-02-12 00:00:00,LABORABLE
2,12,2020,23,375,425,800,2020-12-02 22:00:00,2020-02-12 00:00:00,LABORABLE
2,12,2020,24,243,289,532,2020-12-02 23:00:00,2020-02-12 00:00:00,LABORABLE
3,12,2020,1,142,214,356,2020-12-03 00:00:00,2020-03-12 00:00:00,LABORABLE
3,12,2020,2,58,64,122,2020-12-03 01:00:00,2020-03-12 00:00:00,LABORABLE
3,12,2020,3,38,66,104,2020-12-03 02:00:00,2020-03-12 00:00:00,LABORABLE
3,12,2020,4,46,31,77,2020-12-03 03:00:00,2020-03-12 00:00:00,LABORABLE
3,12,2020,5,78,64,142,2020-12-03 04:00:00,2020-03-12 00:00:00,LABORABLE
3,12,2020,6,152,126,278,2020-12-03 05:00:00,2020-03-12 00:00:00,LABORABLE
3,12,2020,7,466,302,768,2020-12-03 06:00:00,2020-03-12 00:00:00,LABORABLE
3,12,2020,8,697,648,1345,2020-12-03 07:00:00,2020-03-12 00:00:00,LABORABLE
3,12,2020,9,709,755,1464,2020-12-03 08:00:00,2020-03-12 00:00:00,LABORABLE
3,12,2020,10,695,807,1502,2020-12-03 09:00:00,2020-03-12 00:00:00,LABORABLE
3,12,2020,11,575,683,1258,2020-12-03 10:00:00,2020-03-12 00:00:00,LABORABLE
3,12,2020,12,633,752,1385,2020-12-03 11:00:00,2020-03-12 00:00:00,LABORABLE
3,12,2020,13,644,815,1459,2020-12-03 12:00:00,2020-03-12 00:00:00,LABORABLE
3,12,2020,14,685,815,1500,2020-12-03 13:00:00,2020-03-12 00:00:00,LABORABLE
3,12,2020,15,688,825,1513,2020-12-03 14:00:00,2020-03-12 00:00:00,LABORABLE
3,12,2020,16,666,752,1418,2020-12-03 15:00:00,2020-03-12 00:00:00,LABORABLE
3,12,2020,17,621,794,1415,2020-12-03 16:00:00,2020-03-12 00:00:00,LABORABLE
3,12,2020,18,753,796,1549,2020-12-03 17:00:00,2020-03-12 00:00:00,LABORABLE
3,12,2020,19,694,852,1546,2020-12-03 18:00:00,2020-03-12 00:00:00,LABORABLE
3,12,2020,20,704,902,1606,2020-12-03 19:00:00,2020-03-12 00:00:00,LABORABLE
3,12,2020,21,654,832,1486,2020-12-03 20:00:00,2020-03-12 00:00:00,LABORABLE
3,12,2020,22,541,573,1114,2020-12-03 21:00:00,2020-03-12 00:00:00,LABORABLE
3,12,2020,23,384,531,915,2020-12-03 22:00:00,2020-03-12 00:00:00,LABORABLE
3,12,2020,24,268,296,564,2020-12-03 23:00:00,2020-03-12 00:00:00,LABORABLE
4,12,2020,1,150,249,399,2020-12-04 00:00:00,2020-04-12 00:00:00,LABORABLE
4,12,2020,2,75,110,185,2020-12-04 01:00:00,2020-04-12 00:00:00,LABORABLE
4,12,2020,3,52,70,122,2020-12-04 02:00:00,2020-04-12 00:00:00,LABORABLE
4,12,2020,4,46,72,118,2020-12-04 03:00:00,2020-04-12 00:00:00,LABORABLE
4,12,2020,5,65,70,135,2020-12-04 04:00:00,2020-04-12 00:00:00,LABORABLE
4,12,2020,6,182,125,307,2020-12-04 05:00:00,2020-04-12 00:00:00,LABORABLE
4,12,2020,7,436,309,745,2020-12-04 06:00:00,2020-04-12 00:00:00,LABORABLE
4,12,2020,8,688,625,1313,2020-12-04 07:00:00,2020-04-12 00:00:00,LABORABLE
4,12,2020,9,687,729,1416,2020-12-04 08:00:00,2020-04-12 00:00:00,LABORABLE
4,12,2020,10,687,819,1506,2020-12-04 09:00:00,2020-04-12 00:00:00,LABORABLE
4,12,2020,11,629,702,1331,2020-12-04 10:00:00,2020-04-12 00:00:00,LABORABLE
4,12,2020,12,638,845,1483,2020-12-04 11:00:00,2020-04-12 00:00:00,LABORABLE
4,12,2020,13,699,781,1480,2020-12-04 12:00:00,2020-04-12 00:00:00,LABORABLE
4,12,2020,14,661,899,1560,2020-12-04 13:00:00,2020-04-12 00:00:00,LABORABLE
4,12,2020,15,719,856,1575,2020-12-04 14:00:00,2020-04-12 00:00:00,LABORABLE
4,12,2020,16,694,760,1454,2020-12-04 15:00:00,2020-04-12 00:00:00,LABORABLE
4,12,2020,17,649,836,1485,2020-12-04 16:00:00,2020-04-12 00:00:00,LABORABLE
4,12,2020,18,767,837,1604,2020-12-04 17:00:00,2020-04-12 00:00:00,LABORABLE
4,12,2020,19,697,888,1585,2020-12-04 18:00:00,2020-04-12 00:00:00,LABORABLE
4,12,2020,20,734,851,1585,2020-12-04 19:00:00,2020-04-12 00:00:00,LABORABLE
4,12,2020,21,670,870,1540,2020-12-04 20:00:00,2020-04-12 00:00:00,LABORABLE
4,12,2020,22,568,734,1302,2020-12-04 21:00:00,2020-04-12 00:00:00,LABORABLE
4,12,2020,23,444,609,1053,2020-12-04 22:00:00,2020-04-12 00:00:00,LABORABLE
4,12,2020,24,368,477,845,2020-12-04 23:00:00,2020-04-12 00:00:00,LABORABLE
5,12,2020,1,236,117,353,2020-12-05 00:00:00,2020-05-12 00:00:00,LABORABLE
5,12,2020,2,124,928,1052,2020-12-05 01:00:00,2020-05-12 00:00:00,LABORABLE
5,12,2020,3,69,108,177,2020-12-05 02:00:00,2020-05-12 00:00:00,LABORABLE
5,12,2020,4,58,63,121,2020-12-05 03:00:00,2020-05-12 00:00:00,LABORABLE
5,12,2020,5,63,73,136,2020-12-05 04:00:00,2020-05-12 00:00:00,LABORABLE
5,12,2020,6,107,98,205,2020-12-05 05:00:00,2020-05-12 00:00:00,LABORABLE
5,12,2020,7,175,164,339,2020-12-05 06:00:00,2020-05-12 00:00:00,LABORABLE
5,12,2020,8,298,251,549,2020-12-05 07:00:00,2020-05-12 00:00:00,LABORABLE
5,12,2020,9,347,363,710,2020-12-05 08:00:00,2020-05-12 00:00:00,LABORABLE
5,12,2020,10,424,493,917,2020-12-05 09:00:00,2020-05-12 00:00:00,LABORABLE
5,12,2020,11,569,674,1243,2020-12-05 10:00:00,2020-05-12 00:00:00,LABORABLE
5,12,2020,12,664,785,1449,2020-12-05 11:00:00,2020-05-12 00:00:00,LABORABLE
5,12,2020,13,667,56,723,2020-12-05 12:00:00,2020-05-12 00:00:00,LABORABLE
5,12,2020,14,713,943,1656,2020-12-05 13:00:00,2020-05-12 00:00:00,LABORABLE
5,12,2020,15,655,898,1553,2020-12-05 14:00:00,2020-05-12 00:00:00,LABORABLE
5,12,2020,16,600,817,1417,2020-12-05 15:00:00,2020-05-12 00:00:00,LABORABLE
5,12,2020,17,584,762,1346,2020-12-05 16:00:00,2020-05-12 00:00:00,LABORABLE
5,12,2020,18,602,809,1411,2020-12-05 17:00:00,2020-05-12 00:00:00,LABORABLE
5,12,2020,19,651,854,1505,2020-12-05 18:00:00,2020-05-12 00:00:00,LABORABLE
5,12,2020,20,663,858,1521,2020-12-05 19:00:00,2020-05-12 00:00:00,LABORABLE
5,12,2020,21,504,800,1304,2020-12-05 20:00:00,2020-05-12 00:00:00,LABORABLE
5,12,2020,22,506,628,1134,2020-12-05 21:00:00,2020-05-12 00:00:00,LABORABLE
5,12,2020,23,434,565,999,2020-12-05 22:00:00,2020-05-12 00:00:00,LABORABLE
5,12,2020,24,449,477,926,2020-12-05 23:00:00,2020-05-12 00:00:00,LABORABLE
6,12,2020,1,309,418,727,2020-12-06 00:00:00,2020-06-12 00:00:00,LABORABLE
6,12,2020,2,132,226,358,2020-12-06 01:00:00,2020-06-12 00:00:00,LABORABLE
6,12,2020,3,61,88,149,2020-12-06 02:00:00,2020-06-12 00:00:00,LABORABLE
6,12,2020,4,45,76,121,2020-12-06 03:00:00,2020-06-12 00:00:00,LABORABLE
6,12,2020,5,48,60,108,2020-12-06 04:00:00,2020-06-12 00:00:00,LABORABLE
6,12,2020,6,56,61,117,2020-12-06 05:00:00,2020-06-12 00:00:00,LABORABLE
6,12,2020,7,111,121,232,2020-12-06 06:00:00,2020-06-12 00:00:00,LABORABLE
6,12,2020,8,155,142,297,2020-12-06 07:00:00,2020-06-12 00:00:00,LABORABLE
6,12,2020,9,218,224,442,2020-12-06 08:00:00,2020-06-12 00:00:00,LABORABLE
6,12,2020,10,334,397,731,2020-12-06 09:00:00,2020-06-12 00:00:00,LABORABLE
6,12,2020,11,443,560,1003,2020-12-06 10:00:00,2020-06-12 00:00:00,LABORABLE
6,12,2020,12,563,714,1277,2020-12-06 11:00:00,2020-06-12 00:00:00,LABORABLE
6,12,2020,13,621,797,1418,2020-12-06 12:00:00,2020-06-12 00:00:00,LABORABLE
6,12,2020,14,632,773,1405,2020-12-06 13:00:00,2020-06-12 00:00:00,LABORABLE
6,12,2020,15,590,848,1438,2020-12-06 14:00:00,2020-06-12 00:00:00,LABORABLE
6,12,2020,16,482,713,1195,2020-12-06 15:00:00,2020-06-12 00:00:00,LABORABLE
6,12,2020,17,476,636,1112,2020-12-06 16:00:00,2020-06-12 00:00:00,LABORABLE
6,12,2020,18,536,717,1253,2020-12-06 17:00:00,2020-06-12 00:00:00,LABORABLE
6,12,2020,19,562,724,1286,2020-12-06 18:00:00,2020-06-12 00:00:00,LABORABLE
6,12,2020,20,528,735,1263,2020-12-06 19:00:00,2020-06-12 00:00:00,LABORABLE
6,12,2020,21,470,675,1145,2020-12-06 20:00:00,2020-06-12 00:00:00,LABORABLE
6,12,2020,22,405,574,979,2020-12-06 21:00:00,2020-06-12 00:00:00,LABORABLE
6,12,2020,23,383,485,868,2020-12-06 22:00:00,2020-06-12 00:00:00,LABORABLE
6,12,2020,24,365,432,797,2020-12-06 23:00:00,2020-06-12 00:00:00,LABORABLE
7,12,2020,1,193,334,527,2020-12-07 00:00:00,2020-07-12 00:00:00,FESTIVO
7,12,2020,2,85,149,234,2020-12-07 01:00:00,2020-07-12 00:00:00,FESTIVO
7,12,2020,3,49,59,108,2020-12-07 02:00:00,2020-07-12 00:00:00,FESTIVO
7,12,2020,4,40,58,98,2020-12-07 03:00:00,2020-07-12 00:00:00,FESTIVO
7,12,2020,5,35,48,83,2020-12-07 04:00:00,2020-07-12 00:00:00,FESTIVO
7,12,2020,6,77,60,137,2020-12-07 05:00:00,2020-07-12 00:00:00,FESTIVO
7,12,2020,7,152,114,266,2020-12-07 06:00:00,2020-07-12 00:00:00,FESTIVO
7,12,2020,8,238,207,445,2020-12-07 07:00:00,2020-07-12 00:00:00,FESTIVO
7,12,2020,9,255,281,536,2020-12-07 08:00:00,2020-07-12 00:00:00,FESTIVO
7,12,2020,10,337,451,788,2020-12-07 09:00:00,2020-07-12 00:00:00,FESTIVO
7,12,2020,11,450,563,1013,2020-12-07 10:00:00,2020-07-12 00:00:00,FESTIVO
7,12,2020,12,532,650,1182,2020-12-07 11:00:00,2020-07-12 00:00:00,FESTIVO
7,12,2020,13,561,747,1308,2020-12-07 12:00:00,2020-07-12 00:00:00,FESTIVO
7,12,2020,14,566,807,1373,2020-12-07 13:00:00,2020-07-12 00:00:00,FESTIVO
7,12,2020,15,523,773,1296,2020-12-07 14:00:00,2020-07-12 00:00:00,FESTIVO
7,12,2020,16,450,651,1101,2020-12-07 15:00:00,2020-07-12 00:00:00,FESTIVO
7,12,2020,17,495,628,1123,2020-12-07 16:00:00,2020-07-12 00:00:00,FESTIVO
7,12,2020,18,558,704,1262,2020-12-07 17:00:00,2020-07-12 00:00:00,FESTIVO
7,12,2020,19,571,801,1372,2020-12-07 18:00:00,2020-07-12 00:00:00,FESTIVO
7,12,2020,20,546,760,1306,2020-12-07 19:00:00,2020-07-12 00:00:00,FESTIVO
7,12,2020,21,434,717,1151,2020-12-07 20:00:00,2020-07-12 00:00:00,FESTIVO
7,12,2020,22,405,556,961,2020-12-07 21:00:00,2020-07-12 00:00:00,FESTIVO
7,12,2020,23,345,467,812,2020-12-07 22:00:00,2020-07-12 00:00:00,FESTIVO
7,12,2020,24,296,400,696,2020-12-07 23:00:00,2020-07-12 00:00:00,FESTIVO
8,12,2020,1,194,280,474,2020-12-08 00:00:00,2020-08-12 00:00:00,FESTIVO
8,12,2020,2,73,143,216,2020-12-08 01:00:00,2020-08-12 00:00:00,FESTIVO
8,12,2020,3,46,68,114,2020-12-08 02:00:00,2020-08-12 00:00:00,FESTIVO
8,12,2020,4,40,53,93,2020-12-08 03:00:00,2020-08-12 00:00:00,FESTIVO
8,12,2020,5,24,60,84,2020-12-08 04:00:00,2020-08-12 00:00:00,FESTIVO
8,12,2020,6,59,61,120,2020-12-08 05:00:00,2020-08-12 00:00:00,FESTIVO
8,12,2020,7,123,105,228,2020-12-08 06:00:00,2020-08-12 00:00:00,FESTIVO
8,12,2020,8,214,171,385,2020-12-08 07:00:00,2020-08-12 00:00:00,FESTIVO
8,12,2020,9,213,255,468,2020-12-08 08:00:00,2020-08-12 00:00:00,FESTIVO
8,12,2020,10,330,409,739,2020-12-08 09:00:00,2020-08-12 00:00:00,FESTIVO
8,12,2020,11,361,535,896,2020-12-08 10:00:00,2020-08-12 00:00:00,FESTIVO
8,12,2020,12,458,518,976,2020-12-08 11:00:00,2020-08-12 00:00:00,FESTIVO
8,12,2020,13,550,656,1206,2020-12-08 12:00:00,2020-08-12 00:00:00,FESTIVO
8,12,2020,14,576,641,1217,2020-12-08 13:00:00,2020-08-12 00:00:00,FESTIVO
8,12,2020,15,528,612,1140,2020-12-08 14:00:00,2020-08-12 00:00:00,FESTIVO
8,12,2020,16,421,572,993,2020-12-08 15:00:00,2020-08-12 00:00:00,FESTIVO
8,12,2020,17,436,568,1004,2020-12-08 16:00:00,2020-08-12 00:00:00,FESTIVO
8,12,2020,18,491,565,1056,2020-12-08 17:00:00,2020-08-12 00:00:00,FESTIVO
8,12,2020,19,554,613,1167,2020-12-08 18:00:00,2020-08-12 00:00:00,FESTIVO
8,12,2020,20,473,566,1039,2020-12-08 19:00:00,2020-08-12 00:00:00,FESTIVO
8,12,2020,21,457,607,1064,2020-12-08 20:00:00,2020-08-12 00:00:00,FESTIVO
8,12,2020,22,382,529,911,2020-12-08 21:00:00,2020-08-12 00:00:00,FESTIVO
8,12,2020,23,323,387,710,2020-12-08 22:00:00,2020-08-12 00:00:00,FESTIVO
8,12,2020,24,216,274,490,2020-12-08 23:00:00,2020-08-12 00:00:00,FESTIVO
9,12,2020,1,124,182,306,2020-12-09 00:00:00,2020-09-12 00:00:00,LABORABLE
9,12,2020,2,49,91,140,2020-12-09 01:00:00,2020-09-12 00:00:00,LABORABLE
9,12,2020,3,41,76,117,2020-12-09 02:00:00,2020-09-12 00:00:00,LABORABLE
9,12,2020,4,51,50,101,2020-12-09 03:00:00,2020-09-12 00:00:00,LABORABLE
9,12,2020,5,64,52,116,2020-12-09 04:00:00,2020-09-12 00:00:00,LABORABLE
9,12,2020,6,159,106,265,2020-12-09 05:00:00,2020-09-12 00:00:00,LABORABLE
9,12,2020,7,430,291,721,2020-12-09 06:00:00,2020-09-12 00:00:00,LABORABLE
9,12,2020,8,675,537,1212,2020-12-09 07:00:00,2020-09-12 00:00:00,LABORABLE
9,12,2020,9,679,643,1322,2020-12-09 08:00:00,2020-09-12 00:00:00,LABORABLE
9,12,2020,10,692,705,1397,2020-12-09 09:00:00,2020-09-12 00:00:00,LABORABLE
9,12,2020,11,599,657,1256,2020-12-09 10:00:00,2020-09-12 00:00:00,LABORABLE
9,12,2020,12,689,737,1426,2020-12-09 11:00:00,2020-09-12 00:00:00,LABORABLE
9,12,2020,13,641,625,1266,2020-12-09 12:00:00,2020-09-12 00:00:00,LABORABLE
9,12,2020,14,649,700,1349,2020-12-09 13:00:00,2020-09-12 00:00:00,LABORABLE
9,12,2020,15,732,679,1411,2020-12-09 14:00:00,2020-09-12 00:00:00,LABORABLE
9,12,2020,16,644,652,1296,2020-12-09 15:00:00,2020-09-12 00:00:00,LABORABLE
9,12,2020,17,639,670,1309,2020-12-09 16:00:00,2020-09-12 00:00:00,LABORABLE
9,12,2020,18,586,672,1258,2020-12-09 17:00:00,2020-09-12 00:00:00,LABORABLE
9,12,2020,19,650,733,1383,2020-12-09 18:00:00,2020-09-12 00:00:00,LABORABLE
9,12,2020,20,631,735,1366,2020-12-09 19:00:00,2020-09-12 00:00:00,LABORABLE
9,12,2020,21,629,733,1362,2020-12-09 20:00:00,2020-09-12 00:00:00,LABORABLE
9,12,2020,22,463,560,1023,2020-12-09 21:00:00,2020-09-12 00:00:00,LABORABLE
9,12,2020,23,344,341,685,2020-12-09 22:00:00,2020-09-12 00:00:00,LABORABLE
9,12,2020,24,245,227,472,2020-12-09 23:00:00,2020-09-12 00:00:00,LABORABLE
10,12,2020,1,136,144,280,2020-12-10 00:00:00,2020-10-12 00:00:00,LABORABLE
10,12,2020,2,60,85,145,2020-12-10 01:00:00,2020-10-12 00:00:00,LABORABLE
10,12,2020,3,48,56,104,2020-12-10 02:00:00,2020-10-12 00:00:00,LABORABLE
10,12,2020,4,49,43,92,2020-12-10 03:00:00,2020-10-12 00:00:00,LABORABLE
10,12,2020,5,67,56,123,2020-12-10 04:00:00,2020-10-12 00:00:00,LABORABLE
10,12,2020,6,175,101,276,2020-12-10 05:00:00,2020-10-12 00:00:00,LABORABLE
10,12,2020,7,430,291,721,2020-12-10 06:00:00,2020-10-12 00:00:00,LABORABLE
10,12,2020,8,679,510,1189,2020-12-10 07:00:00,2020-10-12 00:00:00,LABORABLE
10,12,2020,9,715,658,1373,2020-12-10 08:00:00,2020-10-12 00:00:00,LABORABLE
10,12,2020,10,689,649,1338,2020-12-10 09:00:00,2020-10-12 00:00:00,LABORABLE
10,12,2020,11,599,746,1345,2020-12-10 10:00:00,2020-10-12 00:00:00,LABORABLE
10,12,2020,12,605,719,1324,2020-12-10 11:00:00,2020-10-12 00:00:00,LABORABLE
10,12,2020,13,678,855,1533,2020-12-10 12:00:00,2020-10-12 00:00:00,LABORABLE
10,12,2020,14,713,777,1490,2020-12-10 13:00:00,2020-10-12 00:00:00,LABORABLE
10,12,2020,15,742,815,1557,2020-12-10 14:00:00,2020-10-12 00:00:00,LABORABLE
10,12,2020,16,677,733,1410,2020-12-10 15:00:00,2020-10-12 00:00:00,LABORABLE
10,12,2020,17,662,757,1419,2020-12-10 16:00:00,2020-10-12 00:00:00,LABORABLE
10,12,2020,18,723,831,1554,2020-12-10 17:00:00,2020-10-12 00:00:00,LABORABLE
10,12,2020,19,680,847,1527,2020-12-10 18:00:00,2020-10-12 00:00:00,LABORABLE
10,12,2020,20,716,847,1563,2020-12-10 19:00:00,2020-10-12 00:00:00,LABORABLE
10,12,2020,21,610,739,1349,2020-12-10 20:00:00,2020-10-12 00:00:00,LABORABLE
10,12,2020,22,523,631,1154,2020-12-10 21:00:00,2020-10-12 00:00:00,LABORABLE
10,12,2020,23,357,470,827,2020-12-10 22:00:00,2020-10-12 00:00:00,LABORABLE
10,12,2020,24,241,330,571,2020-12-10 23:00:00,2020-10-12 00:00:00,LABORABLE
11,12,2020,1,140,222,362,2020-12-11 00:00:00,2020-11-12 00:00:00,LABORABLE
11,12,2020,2,69,97,166,2020-12-11 01:00:00,2020-11-12 00:00:00,LABORABLE
11,12,2020,3,56,69,125,2020-12-11 02:00:00,2020-11-12 00:00:00,LABORABLE
11,12,2020,4,48,36,84,2020-12-11 03:00:00,2020-11-12 00:00:00,LABORABLE
11,12,2020,5,75,51,126,2020-12-11 04:00:00,2020-11-12 00:00:00,LABORABLE
11,12,2020,6,172,125,297,2020-12-11 05:00:00,2020-11-12 00:00:00,LABORABLE
11,12,2020,7,419,301,720,2020-12-11 06:00:00,2020-11-12 00:00:00,LABORABLE
11,12,2020,8,665,578,1243,2020-12-11 07:00:00,2020-11-12 00:00:00,LABORABLE
11,12,2020,9,710,721,1431,2020-12-11 08:00:00,2020-11-12 00:00:00,LABORABLE
11,12,2020,10,624,842,1466,2020-12-11 09:00:00,2020-11-12 00:00:00,LABORABLE
11,12,2020,11,601,686,1287,2020-12-11 10:00:00,2020-11-12 00:00:00,LABORABLE
11,12,2020,12,628,731,1359,2020-12-11 11:00:00,2020-11-12 00:00:00,LABORABLE
11,12,2020,13,637,767,1404,2020-12-11 12:00:00,2020-11-12 00:00:00,LABORABLE
11,12,2020,14,701,886,1587,2020-12-11 13:00:00,2020-11-12 00:00:00,LABORABLE
11,12,2020,15,696,847,1543,2020-12-11 14:00:00,2020-11-12 00:00:00,LABORABLE
11,12,2020,16,648,761,1409,2020-12-11 15:00:00,2020-11-12 00:00:00,LABORABLE
11,12,2020,17,620,732,1352,2020-12-11 16:00:00,2020-11-12 00:00:00,LABORABLE
11,12,2020,18,719,737,1456,2020-12-11 17:00:00,2020-11-12 00:00:00,LABORABLE
11,12,2020,19,704,809,1513,2020-12-11 18:00:00,2020-11-12 00:00:00,LABORABLE
11,12,2020,20,684,796,1480,2020-12-11 19:00:00,2020-11-12 00:00:00,LABORABLE
11,12,2020,21,670,707,1377,2020-12-11 20:00:00,2020-11-12 00:00:00,LABORABLE
11,12,2020,22,533,604,1137,2020-12-11 21:00:00,2020-11-12 00:00:00,LABORABLE
11,12,2020,23,450,556,1006,2020-12-11 22:00:00,2020-11-12 00:00:00,LABORABLE
11,12,2020,24,388,387,775,2020-12-11 23:00:00,2020-11-12 00:00:00,LABORABLE
12,12,2020,1,241,322,563,2020-12-12 00:00:00,2020-12-12 00:00:00,LABORABLE
12,12,2020,2,124,145,269,2020-12-12 01:00:00,2020-12-12 00:00:00,LABORABLE
12,12,2020,3,67,79,146,2020-12-12 02:00:00,2020-12-12 00:00:00,LABORABLE
12,12,2020,4,73,62,135,2020-12-12 03:00:00,2020-12-12 00:00:00,LABORABLE
12,12,2020,5,69,62,131,2020-12-12 04:00:00,2020-12-12 00:00:00,LABORABLE
12,12,2020,6,107,106,213,2020-12-12 05:00:00,2020-12-12 00:00:00,LABORABLE
12,12,2020,7,177,128,305,2020-12-12 06:00:00,2020-12-12 00:00:00,LABORABLE
12,12,2020,8,287,242,529,2020-12-12 07:00:00,2020-12-12 00:00:00,LABORABLE
12,12,2020,9,347,276,623,2020-12-12 08:00:00,2020-12-12 00:00:00,LABORABLE
12,12,2020,10,332,403,735,2020-12-12 09:00:00,2020-12-12 00:00:00,LABORABLE
12,12,2020,11,533,521,1054,2020-12-12 10:00:00,2020-12-12 00:00:00,LABORABLE
12,12,2020,12,575,605,1180,2020-12-12 11:00:00,2020-12-12 00:00:00,LABORABLE
12,12,2020,13,740,674,1414,2020-12-12 12:00:00,2020-12-12 00:00:00,LABORABLE
12,12,2020,14,737,715,1452,2020-12-12 13:00:00,2020-12-12 00:00:00,LABORABLE
12,12,2020,15,668,763,1431,2020-12-12 14:00:00,2020-12-12 00:00:00,LABORABLE
12,12,2020,16,551,618,1169,2020-12-12 15:00:00,2020-12-12 00:00:00,LABORABLE
12,12,2020,17,550,670,1220,2020-12-12 16:00:00,2020-12-12 00:00:00,LABORABLE
12,12,2020,18,589,652,1241,2020-12-12 17:00:00,2020-12-12 00:00:00,LABORABLE
12,12,2020,19,656,678,1334,2020-12-12 18:00:00,2020-12-12 00:00:00,LABORABLE
12,12,2020,20,644,738,1382,2020-12-12 19:00:00,2020-12-12 00:00:00,LABORABLE
12,12,2020,21,604,638,1242,2020-12-12 20:00:00,2020-12-12 00:00:00,LABORABLE
12,12,2020,22,511,576,1087,2020-12-12 21:00:00,2020-12-12 00:00:00,LABORABLE
12,12,2020,23,425,483,908,2020-12-12 22:00:00,2020-12-12 00:00:00,LABORABLE
12,12,2020,24,454,414,868,2020-12-12 23:00:00,2020-12-12 00:00:00,LABORABLE
13,12,2020,1,279,351,630,2020-12-13 00:00:00,2020-12-13 00:00:00,LABORABLE
13,12,2020,2,124,193,317,2020-12-13 01:00:00,2020-12-13 00:00:00,LABORABLE
13,12,2020,3,71,89,160,2020-12-13 02:00:00,2020-12-13 00:00:00,LABORABLE
13,12,2020,4,45,70,115,2020-12-13 03:00:00,2020-12-13 00:00:00,LABORABLE
13,12,2020,5,45,47,92,2020-12-13 04:00:00,2020-12-13 00:00:00,LABORABLE
13,12,2020,6,63,74,137,2020-12-13 05:00:00,2020-12-13 00:00:00,LABORABLE
13,12,2020,7,109,103,212,2020-12-13 06:00:00,2020-12-13 00:00:00,LABORABLE
13,12,2020,8,145,146,291,2020-12-13 07:00:00,2020-12-13 00:00:00,LABORABLE
13,12,2020,9,198,182,380,2020-12-13 08:00:00,2020-12-13 00:00:00,LABORABLE
13,12,2020,10,312,311,623,2020-12-13 09:00:00,2020-12-13 00:00:00,LABORABLE
13,12,2020,11,407,474,881,2020-12-13 10:00:00,2020-12-13 00:00:00,LABORABLE
13,12,2020,12,523,567,1090,2020-12-13 11:00:00,2020-12-13 00:00:00,LABORABLE
13,12,2020,13,602,683,1285,2020-12-13 12:00:00,2020-12-13 00:00:00,LABORABLE
13,12,2020,16,455,608,1063,2020-12-13 15:00:00,2020-12-13 00:00:00,LABORABLE
13,12,2020,17,490,587,1077,2020-12-13 16:00:00,2020-12-13 00:00:00,LABORABLE
13,12,2020,18,551,572,1123,2020-12-13 17:00:00,2020-12-13 00:00:00,LABORABLE
13,12,2020,20,539,581,1120,2020-12-13 19:00:00,2020-12-13 00:00:00,LABORABLE
13,12,2020,21,457,532,989,2020-12-13 20:00:00,2020-12-13 00:00:00,LABORABLE
13,12,2020,22,409,421,830,2020-12-13 21:00:00,2020-12-13 00:00:00,LABORABLE
13,12,2020,23,343,350,693,2020-12-13 22:00:00,2020-12-13 00:00:00,LABORABLE
13,12,2020,24,252,261,513,2020-12-13 23:00:00,2020-12-13 00:00:00,LABORABLE
14,12,2020,1,161,230,391,2020-12-14 00:00:00,2020-12-14 00:00:00,LABORABLE
14,12,2020,2,76,80,156,2020-12-14 01:00:00,2020-12-14 00:00:00,LABORABLE
14,12,2020,3,51,59,110,2020-12-14 02:00:00,2020-12-14 00:00:00,LABORABLE
14,12,2020,4,46,33,79,2020-12-14 03:00:00,2020-12-14 00:00:00,LABORABLE
14,12,2020,5,70,55,125,2020-12-14 04:00:00,2020-12-14 00:00:00,LABORABLE
14,12,2020,6,164,97,261,2020-12-14 05:00:00,2020-12-14 00:00:00,LABORABLE
14,12,2020,7,437,292,729,2020-12-14 06:00:00,2020-12-14 00:00:00,LABORABLE
14,12,2020,8,672,504,1176,2020-12-14 07:00:00,2020-12-14 00:00:00,LABORABLE
14,12,2020,9,701,561,1262,2020-12-14 08:00:00,2020-12-14 00:00:00,LABORABLE
14,12,2020,10,651,673,1324,2020-12-14 09:00:00,2020-12-14 00:00:00,LABORABLE
14,12,2020,11,565,613,1178,2020-12-14 10:00:00,2020-12-14 00:00:00,LABORABLE
14,12,2020,12,600,612,1212,2020-12-14 11:00:00,2020-12-14 00:00:00,LABORABLE
14,12,2020,13,679,681,1360,2020-12-14 12:00:00,2020-12-14 00:00:00,LABORABLE
14,12,2020,14,645,669,1314,2020-12-14 13:00:00,2020-12-14 00:00:00,LABORABLE
14,12,2020,15,670,806,1476,2020-12-14 14:00:00,2020-12-14 00:00:00,LABORABLE
14,12,2020,16,655,733,1388,2020-12-14 15:00:00,2020-12-14 00:00:00,LABORABLE
14,12,2020,17,600,808,1408,2020-12-14 16:00:00,2020-12-14 00:00:00,LABORABLE
14,12,2020,18,687,836,1523,2020-12-14 17:00:00,2020-12-14 00:00:00,LABORABLE
14,12,2020,19,666,865,1531,2020-12-14 18:00:00,2020-12-14 00:00:00,LABORABLE
14,12,2020,20,602,877,1479,2020-12-14 19:00:00,2020-12-14 00:00:00,LABORABLE
14,12,2020,21,591,785,1376,2020-12-14 20:00:00,2020-12-14 00:00:00,LABORABLE
14,12,2020,22,500,611,1111,2020-12-14 21:00:00,2020-12-14 00:00:00,LABORABLE
14,12,2020,23,361,401,762,2020-12-14 22:00:00,2020-12-14 00:00:00,LABORABLE
14,12,2020,24,193,261,454,2020-12-14 23:00:00,2020-12-14 00:00:00,LABORABLE
15,12,2020,1,104,162,266,2020-12-15 00:00:00,2020-12-15 00:00:00,LABORABLE
15,12,2020,2,58,80,138,2020-12-15 01:00:00,2020-12-15 00:00:00,LABORABLE
15,12,2020,3,50,61,111,2020-12-15 02:00:00,2020-12-15 00:00:00,LABORABLE
15,12,2020,4,44,43,87,2020-12-15 03:00:00,2020-12-15 00:00:00,LABORABLE
15,12,2020,5,62,53,115,2020-12-15 04:00:00,2020-12-15 00:00:00,LABORABLE
15,12,2020,6,162,106,268,2020-12-15 05:00:00,2020-12-15 00:00:00,LABORABLE
15,12,2020,7,418,300,718,2020-12-15 06:00:00,2020-12-15 00:00:00,LABORABLE
15,12,2020,8,658,612,1270,2020-12-15 07:00:00,2020-12-15 00:00:00,LABORABLE
15,12,2020,9,714,733,1447,2020-12-15 08:00:00,2020-12-15 00:00:00,LABORABLE
15,12,2020,10,644,780,1424,2020-12-15 09:00:00,2020-12-15 00:00:00,LABORABLE
15,12,2020,11,579,672,1251,2020-12-15 10:00:00,2020-12-15 00:00:00,LABORABLE
15,12,2020,12,535,630,1165,2020-12-15 11:00:00,2020-12-15 00:00:00,LABORABLE
15,12,2020,13,656,774,1430,2020-12-15 12:00:00,2020-12-15 00:00:00,LABORABLE
15,12,2020,14,667,845,1512,2020-12-15 13:00:00,2020-12-15 00:00:00,LABORABLE
15,12,2020,15,724,820,1544,2020-12-15 14:00:00,2020-12-15 00:00:00,LABORABLE
15,12,2020,16,662,776,1438,2020-12-15 15:00:00,2020-12-15 00:00:00,LABORABLE
15,12,2020,17,698,757,1455,2020-12-15 16:00:00,2020-12-15 00:00:00,LABORABLE
15,12,2020,18,705,807,1512,2020-12-15 17:00:00,2020-12-15 00:00:00,LABORABLE
15,12,2020,19,688,825,1513,2020-12-15 18:00:00,2020-12-15 00:00:00,LABORABLE
15,12,2020,20,688,831,1519,2020-12-15 19:00:00,2020-12-15 00:00:00,LABORABLE
15,12,2020,21,637,795,1432,2020-12-15 20:00:00,2020-12-15 00:00:00,LABORABLE
15,12,2020,22,488,598,1086,2020-12-15 21:00:00,2020-12-15 00:00:00,LABORABLE
15,12,2020,23,380,414,794,2020-12-15 22:00:00,2020-12-15 00:00:00,LABORABLE
15,12,2020,24,195,280,475,2020-12-15 23:00:00,2020-12-15 00:00:00,LABORABLE
16,12,2020,1,123,192,315,2020-12-16 00:00:00,2020-12-16 00:00:00,LABORABLE
16,12,2020,2,71,82,153,2020-12-16 01:00:00,2020-12-16 00:00:00,LABORABLE
16,12,2020,3,46,56,102,2020-12-16 02:00:00,2020-12-16 00:00:00,LABORABLE
16,12,2020,4,46,46,92,2020-12-16 03:00:00,2020-12-16 00:00:00,LABORABLE
16,12,2020,5,67,53,120,2020-12-16 04:00:00,2020-12-16 00:00:00,LABORABLE
16,12,2020,6,169,109,278,2020-12-16 05:00:00,2020-12-16 00:00:00,LABORABLE
16,12,2020,7,400,302,702,2020-12-16 06:00:00,2020-12-16 00:00:00,LABORABLE
16,12,2020,8,675,606,1281,2020-12-16 07:00:00,2020-12-16 00:00:00,LABORABLE
16,12,2020,9,742,772,1514,2020-12-16 08:00:00,2020-12-16 00:00:00,LABORABLE
16,12,2020,10,618,794,1412,2020-12-16 09:00:00,2020-12-16 00:00:00,LABORABLE
16,12,2020,11,509,648,1157,2020-12-16 10:00:00,2020-12-16 00:00:00,LABORABLE
16,12,2020,12,633,812,1445,2020-12-16 11:00:00,2020-12-16 00:00:00,LABORABLE
16,12,2020,13,615,781,1396,2020-12-16 12:00:00,2020-12-16 00:00:00,LABORABLE
16,12,2020,14,657,861,1518,2020-12-16 13:00:00,2020-12-16 00:00:00,LABORABLE
16,12,2020,15,627,792,1419,2020-12-16 14:00:00,2020-12-16 00:00:00,LABORABLE
16,12,2020,16,633,740,1373,2020-12-16 15:00:00,2020-12-16 00:00:00,LABORABLE
16,12,2020,17,637,796,1433,2020-12-16 16:00:00,2020-12-16 00:00:00,LABORABLE
16,12,2020,18,699,849,1548,2020-12-16 17:00:00,2020-12-16 00:00:00,LABORABLE
16,12,2020,19,698,835,1533,2020-12-16 18:00:00,2020-12-16 00:00:00,LABORABLE
16,12,2020,20,626,871,1497,2020-12-16 19:00:00,2020-12-16 00:00:00,LABORABLE
16,12,2020,21,567,758,1325,2020-12-16 20:00:00,2020-12-16 00:00:00,LABORABLE
16,12,2020,22,517,615,1132,2020-12-16 21:00:00,2020-12-16 00:00:00,LABORABLE
16,12,2020,23,371,455,826,2020-12-16 22:00:00,2020-12-16 00:00:00,LABORABLE
16,12,2020,24,253,287,540,2020-12-16 23:00:00,2020-12-16 00:00:00,LABORABLE
17,12,2020,1,124,177,301,2020-12-17 00:00:00,2020-12-17 00:00:00,LABORABLE
17,12,2020,2,81,100,181,2020-12-17 01:00:00,2020-12-17 00:00:00,LABORABLE
17,12,2020,3,43,54,97,2020-12-17 02:00:00,2020-12-17 00:00:00,LABORABLE
17,12,2020,4,45,32,77,2020-12-17 03:00:00,2020-12-17 00:00:00,LABORABLE
17,12,2020,5,70,69,139,2020-12-17 04:00:00,2020-12-17 00:00:00,LABORABLE
17,12,2020,6,159,111,270,2020-12-17 05:00:00,2020-12-17 00:00:00,LABORABLE
17,12,2020,7,426,305,731,2020-12-17 06:00:00,2020-12-17 00:00:00,LABORABLE
17,12,2020,8,672,603,1275,2020-12-17 07:00:00,2020-12-17 00:00:00,LABORABLE
17,12,2020,9,721,740,1461,2020-12-17 08:00:00,2020-12-17 00:00:00,LABORABLE
17,12,2020,10,661,812,1473,2020-12-17 09:00:00,2020-12-17 00:00:00,LABORABLE
17,12,2020,11,632,759,1391,2020-12-17 10:00:00,2020-12-17 00:00:00,LABORABLE
17,12,2020,12,551,659,1210,2020-12-17 11:00:00,2020-12-17 00:00:00,LABORABLE
17,12,2020,13,629,818,1447,2020-12-17 12:00:00,2020-12-17 00:00:00,LABORABLE
17,12,2020,14,700,771,1471,2020-12-17 13:00:00,2020-12-17 00:00:00,LABORABLE
17,12,2020,15,681,842,1523,2020-12-17 14:00:00,2020-12-17 00:00:00,LABORABLE
17,12,2020,16,670,751,1421,2020-12-17 15:00:00,2020-12-17 00:00:00,LABORABLE
17,12,2020,17,669,832,1501,2020-12-17 16:00:00,2020-12-17 00:00:00,LABORABLE
17,12,2020,18,683,814,1497,2020-12-17 17:00:00,2020-12-17 00:00:00,LABORABLE
17,12,2020,19,665,857,1522,2020-12-17 18:00:00,2020-12-17 00:00:00,LABORABLE
17,12,2020,20,632,840,1472,2020-12-17 19:00:00,2020-12-17 00:00:00,LABORABLE
17,12,2020,21,648,802,1450,2020-12-17 20:00:00,2020-12-17 00:00:00,LABORABLE
17,12,2020,22,513,679,1192,2020-12-17 21:00:00,2020-12-17 00:00:00,LABORABLE
17,12,2020,23,369,505,874,2020-12-17 22:00:00,2020-12-17 00:00:00,LABORABLE
17,12,2020,24,256,372,628,2020-12-17 23:00:00,2020-12-17 00:00:00,LABORABLE
18,12,2020,1,152,237,389,2020-12-18 00:00:00,2020-12-18 00:00:00,LABORABLE
18,12,2020,2,62,121,183,2020-12-18 01:00:00,2020-12-18 00:00:00,LABORABLE
18,12,2020,3,47,71,118,2020-12-18 02:00:00,2020-12-18 00:00:00,LABORABLE
18,12,2020,4,46,36,82,2020-12-18 03:00:00,2020-12-18 00:00:00,LABORABLE
18,12,2020,5,65,60,125,2020-12-18 04:00:00,2020-12-18 00:00:00,LABORABLE
18,12,2020,6,174,123,297,2020-12-18 05:00:00,2020-12-18 00:00:00,LABORABLE
18,12,2020,7,428,333,761,2020-12-18 06:00:00,2020-12-18 00:00:00,LABORABLE
18,12,2020,8,685,567,1252,2020-12-18 07:00:00,2020-12-18 00:00:00,LABORABLE
18,12,2020,9,662,722,1384,2020-12-18 08:00:00,2020-12-18 00:00:00,LABORABLE
18,12,2020,10,629,828,1457,2020-12-18 09:00:00,2020-12-18 00:00:00,LABORABLE
18,12,2020,11,634,767,1401,2020-12-18 10:00:00,2020-12-18 00:00:00,LABORABLE
18,12,2020,12,629,824,1453,2020-12-18 11:00:00,2020-12-18 00:00:00,LABORABLE
18,12,2020,13,673,822,1495,2020-12-18 12:00:00,2020-12-18 00:00:00,LABORABLE
18,12,2020,14,683,867,1550,2020-12-18 13:00:00,2020-12-18 00:00:00,LABORABLE
18,12,2020,15,664,836,1500,2020-12-18 14:00:00,2020-12-18 00:00:00,LABORABLE
18,12,2020,16,677,819,1496,2020-12-18 15:00:00,2020-12-18 00:00:00,LABORABLE
18,12,2020,17,666,854,1520,2020-12-18 16:00:00,2020-12-18 00:00:00,LABORABLE
18,12,2020,18,726,854,1580,2020-12-18 17:00:00,2020-12-18 00:00:00,LABORABLE
18,12,2020,19,698,910,1608,2020-12-18 18:00:00,2020-12-18 00:00:00,LABORABLE
18,12,2020,20,649,921,1570,2020-12-18 19:00:00,2020-12-18 00:00:00,LABORABLE
18,12,2020,21,681,883,1564,2020-12-18 20:00:00,2020-12-18 00:00:00,LABORABLE
18,12,2020,22,580,777,1357,2020-12-18 21:00:00,2020-12-18 00:00:00,LABORABLE
18,12,2020,23,474,675,1149,2020-12-18 22:00:00,2020-12-18 00:00:00,LABORABLE
18,12,2020,24,395,490,885,2020-12-18 23:00:00,2020-12-18 00:00:00,LABORABLE
19,12,2020,1,266,400,666,2020-12-19 00:00:00,2020-12-19 00:00:00,LABORABLE
19,12,2020,2,126,183,309,2020-12-19 01:00:00,2020-12-19 00:00:00,LABORABLE
19,12,2020,3,62,103,165,2020-12-19 02:00:00,2020-12-19 00:00:00,LABORABLE
19,12,2020,4,78,72,150,2020-12-19 03:00:00,2020-12-19 00:00:00,LABORABLE
19,12,2020,5,63,68,131,2020-12-19 04:00:00,2020-12-19 00:00:00,LABORABLE
19,12,2020,6,101,96,197,2020-12-19 05:00:00,2020-12-19 00:00:00,LABORABLE
19,12,2020,7,169,126,295,2020-12-19 06:00:00,2020-12-19 00:00:00,LABORABLE
19,12,2020,8,282,256,538,2020-12-19 07:00:00,2020-12-19 00:00:00,LABORABLE
19,12,2020,9,357,300,657,2020-12-19 08:00:00,2020-12-19 00:00:00,LABORABLE
19,12,2020,10,419,551,970,2020-12-19 09:00:00,2020-12-19 00:00:00,LABORABLE
19,12,2020,11,533,662,1195,2020-12-19 10:00:00,2020-12-19 00:00:00,LABORABLE
19,12,2020,12,629,804,1433,2020-12-19 11:00:00,2020-12-19 00:00:00,LABORABLE
19,12,2020,13,675,850,1525,2020-12-19 12:00:00,2020-12-19 00:00:00,LABORABLE
19,12,2020,14,733,868,1601,2020-12-19 13:00:00,2020-12-19 00:00:00,LABORABLE
19,12,2020,15,688,917,1605,2020-12-19 14:00:00,2020-12-19 00:00:00,LABORABLE
19,12,2020,16,548,804,1352,2020-12-19 15:00:00,2020-12-19 00:00:00,LABORABLE
19,12,2020,17,483,779,1262,2020-12-19 16:00:00,2020-12-19 00:00:00,LABORABLE
19,12,2020,18,581,797,1378,2020-12-19 17:00:00,2020-12-19 00:00:00,LABORABLE
19,12,2020,19,610,879,1489,2020-12-19 18:00:00,2020-12-19 00:00:00,LABORABLE
19,12,2020,20,641,835,1476,2020-12-19 19:00:00,2020-12-19 00:00:00,LABORABLE
19,12,2020,21,568,756,1324,2020-12-19 20:00:00,2020-12-19 00:00:00,LABORABLE
19,12,2020,22,502,620,1122,2020-12-19 21:00:00,2020-12-19 00:00:00,LABORABLE
19,12,2020,23,466,590,1056,2020-12-19 22:00:00,2020-12-19 00:00:00,LABORABLE
19,12,2020,24,440,539,979,2020-12-19 23:00:00,2020-12-19 00:00:00,LABORABLE
20,12,2020,1,298,464,762,2020-12-20 00:00:00,2020-12-20 00:00:00,LABORABLE
20,12,2020,2,146,178,324,2020-12-20 01:00:00,2020-12-20 00:00:00,LABORABLE
20,12,2020,3,63,115,178,2020-12-20 02:00:00,2020-12-20 00:00:00,LABORABLE
20,12,2020,4,46,71,117,2020-12-20 03:00:00,2020-12-20 00:00:00,LABORABLE
20,12,2020,5,32,71,103,2020-12-20 04:00:00,2020-12-20 00:00:00,LABORABLE
20,12,2020,6,68,67,135,2020-12-20 05:00:00,2020-12-20 00:00:00,LABORABLE
20,12,2020,7,101,109,210,2020-12-20 06:00:00,2020-12-20 00:00:00,LABORABLE
20,12,2020,8,168,138,306,2020-12-20 07:00:00,2020-12-20 00:00:00,LABORABLE
20,12,2020,9,207,243,450,2020-12-20 08:00:00,2020-12-20 00:00:00,LABORABLE
20,12,2020,10,334,400,734,2020-12-20 09:00:00,2020-12-20 00:00:00,LABORABLE
20,12,2020,11,426,599,1025,2020-12-20 10:00:00,2020-12-20 00:00:00,LABORABLE
20,12,2020,12,596,644,1240,2020-12-20 11:00:00,2020-12-20 00:00:00,LABORABLE
20,12,2020,13,634,791,1425,2020-12-20 12:00:00,2020-12-20 00:00:00,LABORABLE
20,12,2020,14,664,841,1505,2020-12-20 13:00:00,2020-12-20 00:00:00,LABORABLE
20,12,2020,15,624,764,1388,2020-12-20 14:00:00,2020-12-20 00:00:00,LABORABLE
20,12,2020,16,463,679,1142,2020-12-20 15:00:00,2020-12-20 00:00:00,LABORABLE
20,12,2020,17,461,677,1138,2020-12-20 16:00:00,2020-12-20 00:00:00,LABORABLE
20,12,2020,18,541,729,1270,2020-12-20 17:00:00,2020-12-20 00:00:00,LABORABLE
20,12,2020,19,599,760,1359,2020-12-20 18:00:00,2020-12-20 00:00:00,LABORABLE
20,12,2020,20,600,762,1362,2020-12-20 19:00:00,2020-12-20 00:00:00,LABORABLE
20,12,2020,21,495,691,1186,2020-12-20 20:00:00,2020-12-20 00:00:00,LABORABLE
20,12,2020,22,434,612,1046,2020-12-20 21:00:00,2020-12-20 00:00:00,LABORABLE
20,12,2020,23,349,477,826,2020-12-20 22:00:00,2020-12-20 00:00:00,LABORABLE
20,12,2020,24,306,351,657,2020-12-20 23:00:00,2020-12-20 00:00:00,LABORABLE
21,12,2020,1,186,243,429,2020-12-21 00:00:00,2020-12-21 00:00:00,LABORABLE
21,12,2020,2,78,94,172,2020-12-21 01:00:00,2020-12-21 00:00:00,LABORABLE
21,12,2020,3,52,76,128,2020-12-21 02:00:00,2020-12-21 00:00:00,LABORABLE
21,12,2020,4,58,40,98,2020-12-21 03:00:00,2020-12-21 00:00:00,LABORABLE
21,12,2020,5,74,73,147,2020-12-21 04:00:00,2020-12-21 00:00:00,LABORABLE
21,12,2020,6,167,107,274,2020-12-21 05:00:00,2020-12-21 00:00:00,LABORABLE
21,12,2020,7,482,313,795,2020-12-21 06:00:00,2020-12-21 00:00:00,LABORABLE
21,12,2020,8,599,562,1161,2020-12-21 07:00:00,2020-12-21 00:00:00,LABORABLE
21,12,2020,9,682,731,1413,2020-12-21 08:00:00,2020-12-21 00:00:00,LABORABLE
21,12,2020,10,681,828,1509,2020-12-21 09:00:00,2020-12-21 00:00:00,LABORABLE
21,12,2020,11,597,727,1324,2020-12-21 10:00:00,2020-12-21 00:00:00,LABORABLE
21,12,2020,12,482,628,1110,2020-12-21 11:00:00,2020-12-21 00:00:00,LABORABLE
21,12,2020,13,660,796,1456,2020-12-21 12:00:00,2020-12-21 00:00:00,LABORABLE
21,12,2020,14,671,869,1540,2020-12-21 13:00:00,2020-12-21 00:00:00,LABORABLE
21,12,2020,15,682,850,1532,2020-12-21 14:00:00,2020-12-21 00:00:00,LABORABLE
21,12,2020,16,649,724,1373,2020-12-21 15:00:00,2020-12-21 00:00:00,LABORABLE
21,12,2020,17,650,837,1487,2020-12-21 16:00:00,2020-12-21 00:00:00,LABORABLE
21,12,2020,18,716,851,1567,2020-12-21 17:00:00,2020-12-21 00:00:00,LABORABLE
21,12,2020,19,706,951,1657,2020-12-21 18:00:00,2020-12-21 00:00:00,LABORABLE
21,12,2020,20,690,881,1571,2020-12-21 19:00:00,2020-12-21 00:00:00,LABORABLE
21,12,2020,21,572,807,1379,2020-12-21 20:00:00,2020-12-21 00:00:00,LABORABLE
21,12,2020,22,499,655,1154,2020-12-21 21:00:00,2020-12-21 00:00:00,LABORABLE
21,12,2020,23,385,453,838,2020-12-21 22:00:00,2020-12-21 00:00:00,LABORABLE
21,12,2020,24,216,301,517,2020-12-21 23:00:00,2020-12-21 00:00:00,LABORABLE
22,12,2020,1,122,193,315,2020-12-22 00:00:00,2020-12-22 00:00:00,LABORABLE
22,12,2020,2,67,89,156,2020-12-22 01:00:00,2020-12-22 00:00:00,LABORABLE
22,12,2020,3,43,71,114,2020-12-22 02:00:00,2020-12-22 00:00:00,LABORABLE
22,12,2020,4,55,30,85,2020-12-22 03:00:00,2020-12-22 00:00:00,LABORABLE
22,12,2020,5,68,52,120,2020-12-22 04:00:00,2020-12-22 00:00:00,LABORABLE
22,12,2020,6,156,111,267,2020-12-22 05:00:00,2020-12-22 00:00:00,LABORABLE
22,12,2020,7,423,271,694,2020-12-22 06:00:00,2020-12-22 00:00:00,LABORABLE
22,12,2020,8,637,562,1199,2020-12-22 07:00:00,2020-12-22 00:00:00,LABORABLE
22,12,2020,9,664,711,1375,2020-12-22 08:00:00,2020-12-22 00:00:00,LABORABLE
22,12,2020,10,720,814,1534,2020-12-22 09:00:00,2020-12-22 00:00:00,LABORABLE
22,12,2020,11,631,726,1357,2020-12-22 10:00:00,2020-12-22 00:00:00,LABORABLE
22,12,2020,12,649,797,1446,2020-12-22 11:00:00,2020-12-22 00:00:00,LABORABLE
22,12,2020,13,518,712,1230,2020-12-22 12:00:00,2020-12-22 00:00:00,LABORABLE
22,12,2020,14,700,875,1575,2020-12-22 13:00:00,2020-12-22 00:00:00,LABORABLE
22,12,2020,15,693,877,1570,2020-12-22 14:00:00,2020-12-22 00:00:00,LABORABLE
22,12,2020,16,638,724,1362,2020-12-22 15:00:00,2020-12-22 00:00:00,LABORABLE
22,12,2020,17,662,834,1496,2020-12-22 16:00:00,2020-12-22 00:00:00,LABORABLE
22,12,2020,18,657,852,1509,2020-12-22 17:00:00,2020-12-22 00:00:00,LABORABLE
22,12,2020,19,704,875,1579,2020-12-22 18:00:00,2020-12-22 00:00:00,LABORABLE
22,12,2020,20,664,920,1584,2020-12-22 19:00:00,2020-12-22 00:00:00,LABORABLE
22,12,2020,21,649,868,1517,2020-12-22 20:00:00,2020-12-22 00:00:00,LABORABLE
22,12,2020,22,521,682,1203,2020-12-22 21:00:00,2020-12-22 00:00:00,LABORABLE
22,12,2020,23,425,537,962,2020-12-22 22:00:00,2020-12-22 00:00:00,LABORABLE
22,12,2020,24,260,356,616,2020-12-22 23:00:00,2020-12-22 00:00:00,LABORABLE
23,12,2020,1,158,210,368,2020-12-23 00:00:00,2020-12-23 00:00:00,LABORABLE
23,12,2020,2,83,94,177,2020-12-23 01:00:00,2020-12-23 00:00:00,LABORABLE
23,12,2020,3,57,83,140,2020-12-23 02:00:00,2020-12-23 00:00:00,LABORABLE
23,12,2020,4,59,50,109,2020-12-23 03:00:00,2020-12-23 00:00:00,LABORABLE
23,12,2020,5,66,50,116,2020-12-23 04:00:00,2020-12-23 00:00:00,LABORABLE
23,12,2020,6,162,106,268,2020-12-23 05:00:00,2020-12-23 00:00:00,LABORABLE
23,12,2020,7,349,242,591,2020-12-23 06:00:00,2020-12-23 00:00:00,LABORABLE
23,12,2020,8,588,437,1025,2020-12-23 07:00:00,2020-12-23 00:00:00,LABORABLE
23,12,2020,9,579,558,1137,2020-12-23 08:00:00,2020-12-23 00:00:00,LABORABLE
23,12,2020,10,616,723,1339,2020-12-23 09:00:00,2020-12-23 00:00:00,LABORABLE
23,12,2020,11,625,715,1340,2020-12-23 10:00:00,2020-12-23 00:00:00,LABORABLE
23,12,2020,12,602,729,1331,2020-12-23 11:00:00,2020-12-23 00:00:00,LABORABLE
23,12,2020,13,703,711,1414,2020-12-23 12:00:00,2020-12-23 00:00:00,LABORABLE
23,12,2020,14,695,767,1462,2020-12-23 13:00:00,2020-12-23 00:00:00,LABORABLE
23,12,2020,15,654,735,1389,2020-12-23 14:00:00,2020-12-23 00:00:00,LABORABLE
23,12,2020,16,636,697,1333,2020-12-23 15:00:00,2020-12-23 00:00:00,LABORABLE
23,12,2020,17,682,756,1438,2020-12-23 16:00:00,2020-12-23 00:00:00,LABORABLE
23,12,2020,18,663,750,1413,2020-12-23 17:00:00,2020-12-23 00:00:00,LABORABLE
23,12,2020,19,674,712,1386,2020-12-23 18:00:00,2020-12-23 00:00:00,LABORABLE
23,12,2020,20,686,828,1514,2020-12-23 19:00:00,2020-12-23 00:00:00,LABORABLE
23,12,2020,21,661,775,1436,2020-12-23 20:00:00,2020-12-23 00:00:00,LABORABLE
23,12,2020,22,507,598,1105,2020-12-23 21:00:00,2020-12-23 00:00:00,LABORABLE
23,12,2020,23,443,446,889,2020-12-23 22:00:00,2020-12-23 00:00:00,LABORABLE
23,12,2020,24,334,290,624,2020-12-23 23:00:00,2020-12-23 00:00:00,LABORABLE
24,12,2020,1,185,182,367,2020-12-24 00:00:00,2020-12-24 00:00:00,LABORABLE
24,12,2020,2,77,89,166,2020-12-24 01:00:00,2020-12-24 00:00:00,LABORABLE
24,12,2020,3,62,65,127,2020-12-24 02:00:00,2020-12-24 00:00:00,LABORABLE
24,12,2020,4,54,41,95,2020-12-24 03:00:00,2020-12-24 00:00:00,LABORABLE
24,12,2020,5,73,60,133,2020-12-24 04:00:00,2020-12-24 00:00:00,LABORABLE
24,12,2020,6,130,91,221,2020-12-24 05:00:00,2020-12-24 00:00:00,LABORABLE
24,12,2020,7,226,227,453,2020-12-24 06:00:00,2020-12-24 00:00:00,LABORABLE
24,12,2020,8,348,368,716,2020-12-24 07:00:00,2020-12-24 00:00:00,LABORABLE
24,12,2020,9,425,506,931,2020-12-24 08:00:00,2020-12-24 00:00:00,LABORABLE
24,12,2020,10,567,624,1191,2020-12-24 09:00:00,2020-12-24 00:00:00,LABORABLE
24,12,2020,11,610,665,1275,2020-12-24 10:00:00,2020-12-24 00:00:00,LABORABLE
24,12,2020,12,662,736,1398,2020-12-24 11:00:00,2020-12-24 00:00:00,LABORABLE
24,12,2020,13,746,781,1527,2020-12-24 12:00:00,2020-12-24 00:00:00,LABORABLE
24,12,2020,14,701,741,1442,2020-12-24 13:00:00,2020-12-24 00:00:00,LABORABLE
24,12,2020,15,685,782,1467,2020-12-24 14:00:00,2020-12-24 00:00:00,LABORABLE
24,12,2020,16,598,723,1321,2020-12-24 15:00:00,2020-12-24 00:00:00,LABORABLE
24,12,2020,17,585,775,1360,2020-12-24 16:00:00,2020-12-24 00:00:00,LABORABLE
24,12,2020,18,668,782,1450,2020-12-24 17:00:00,2020-12-24 00:00:00,LABORABLE
24,12,2020,19,680,856,1536,2020-12-24 18:00:00,2020-12-24 00:00:00,LABORABLE
24,12,2020,20,744,869,1613,2020-12-24 19:00:00,2020-12-24 00:00:00,LABORABLE
24,12,2020,21,634,751,1385,2020-12-24 20:00:00,2020-12-24 00:00:00,LABORABLE
24,12,2020,22,362,562,924,2020-12-24 21:00:00,2020-12-24 00:00:00,LABORABLE
24,12,2020,23,280,362,642,2020-12-24 22:00:00,2020-12-24 00:00:00,LABORABLE
24,12,2020,24,317,364,681,2020-12-24 23:00:00,2020-12-24 00:00:00,LABORABLE
25,12,2020,1,430,401,831,2020-12-25 00:00:00,2020-12-25 00:00:00,FESTIVO
25,12,2020,2,286,261,547,2020-12-25 01:00:00,2020-12-25 00:00:00,FESTIVO
25,12,2020,3,85,112,197,2020-12-25 02:00:00,2020-12-25 00:00:00,FESTIVO
25,12,2020,4,52,51,103,2020-12-25 03:00:00,2020-12-25 00:00:00,FESTIVO
25,12,2020,5,38,44,82,2020-12-25 04:00:00,2020-12-25 00:00:00,FESTIVO
25,12,2020,6,57,77,134,2020-12-25 05:00:00,2020-12-25 00:00:00,FESTIVO
25,12,2020,7,92,152,244,2020-12-25 06:00:00,2020-12-25 00:00:00,FESTIVO
25,12,2020,8,103,233,336,2020-12-25 07:00:00,2020-12-25 00:00:00,FESTIVO
25,12,2020,9,96,308,404,2020-12-25 08:00:00,2020-12-25 00:00:00,FESTIVO
25,12,2020,10,114,441,555,2020-12-25 09:00:00,2020-12-25 00:00:00,FESTIVO
25,12,2020,11,176,463,639,2020-12-25 10:00:00,2020-12-25 00:00:00,FESTIVO
25,12,2020,12,283,541,824,2020-12-25 11:00:00,2020-12-25 00:00:00,FESTIVO
25,12,2020,13,396,611,1007,2020-12-25 12:00:00,2020-12-25 00:00:00,FESTIVO
25,12,2020,14,481,686,1167,2020-12-25 13:00:00,2020-12-25 00:00:00,FESTIVO
25,12,2020,15,438,638,1076,2020-12-25 14:00:00,2020-12-25 00:00:00,FESTIVO
25,12,2020,16,300,532,832,2020-12-25 15:00:00,2020-12-25 00:00:00,FESTIVO
25,12,2020,17,356,620,976,2020-12-25 16:00:00,2020-12-25 00:00:00,FESTIVO
25,12,2020,18,430,595,1025,2020-12-25 17:00:00,2020-12-25 00:00:00,FESTIVO
25,12,2020,19,511,689,1200,2020-12-25 18:00:00,2020-12-25 00:00:00,FESTIVO
25,12,2020,20,542,692,1234,2020-12-25 19:00:00,2020-12-25 00:00:00,FESTIVO
25,12,2020,21,450,584,1034,2020-12-25 20:00:00,2020-12-25 00:00:00,FESTIVO
25,12,2020,22,379,494,873,2020-12-25 21:00:00,2020-12-25 00:00:00,FESTIVO
25,12,2020,23,304,387,691,2020-12-25 22:00:00,2020-12-25 00:00:00,FESTIVO
25,12,2020,24,245,287,532,2020-12-25 23:00:00,2020-12-25 00:00:00,FESTIVO
26,12,2020,1,169,229,398,2020-12-26 00:00:00,2020-12-26 00:00:00,LABORABLE
26,12,2020,2,97,113,210,2020-12-26 01:00:00,2020-12-26 00:00:00,LABORABLE
26,12,2020,3,40,54,94,2020-12-26 02:00:00,2020-12-26 00:00:00,LABORABLE
26,12,2020,4,37,47,84,2020-12-26 03:00:00,2020-12-26 00:00:00,LABORABLE
26,12,2020,5,40,51,91,2020-12-26 04:00:00,2020-12-26 00:00:00,LABORABLE
26,12,2020,6,75,71,146,2020-12-26 05:00:00,2020-12-26 00:00:00,LABORABLE
26,12,2020,7,131,117,248,2020-12-26 06:00:00,2020-12-26 00:00:00,LABORABLE
26,12,2020,8,181,200,381,2020-12-26 07:00:00,2020-12-26 00:00:00,LABORABLE
26,12,2020,9,250,237,487,2020-12-26 08:00:00,2020-12-26 00:00:00,LABORABLE
26,12,2020,10,366,430,796,2020-12-26 09:00:00,2020-12-26 00:00:00,LABORABLE
26,12,2020,11,454,468,922,2020-12-26 10:00:00,2020-12-26 00:00:00,LABORABLE
26,12,2020,12,547,573,1120,2020-12-26 11:00:00,2020-12-26 00:00:00,LABORABLE
26,12,2020,13,634,699,1333,2020-12-26 12:00:00,2020-12-26 00:00:00,LABORABLE
26,12,2020,14,632,680,1312,2020-12-26 13:00:00,2020-12-26 00:00:00,LABORABLE
26,12,2020,15,583,751,1334,2020-12-26 14:00:00,2020-12-26 00:00:00,LABORABLE
26,12,2020,16,498,619,1117,2020-12-26 15:00:00,2020-12-26 00:00:00,LABORABLE
26,12,2020,17,502,630,1132,2020-12-26 16:00:00,2020-12-26 00:00:00,LABORABLE
26,12,2020,18,558,593,1151,2020-12-26 17:00:00,2020-12-26 00:00:00,LABORABLE
26,12,2020,19,507,634,1141,2020-12-26 18:00:00,2020-12-26 00:00:00,LABORABLE
26,12,2020,20,538,705,1243,2020-12-26 19:00:00,2020-12-26 00:00:00,LABORABLE
26,12,2020,21,546,608,1154,2020-12-26 20:00:00,2020-12-26 00:00:00,LABORABLE
26,12,2020,22,439,569,1008,2020-12-26 21:00:00,2020-12-26 00:00:00,LABORABLE
26,12,2020,23,464,454,918,2020-12-26 22:00:00,2020-12-26 00:00:00,LABORABLE
26,12,2020,24,377,409,786,2020-12-26 23:00:00,2020-12-26 00:00:00,LABORABLE
27,12,2020,1,247,281,528,2020-12-27 00:00:00,2020-12-27 00:00:00,LABORABLE
27,12,2020,2,94,154,248,2020-12-27 01:00:00,2020-12-27 00:00:00,LABORABLE
27,12,2020,3,54,80,134,2020-12-27 02:00:00,2020-12-27 00:00:00,LABORABLE
27,12,2020,4,53,50,103,2020-12-27 03:00:00,2020-12-27 00:00:00,LABORABLE
27,12,2020,5,30,45,75,2020-12-27 04:00:00,2020-12-27 00:00:00,LABORABLE
27,12,2020,6,52,69,121,2020-12-27 05:00:00,2020-12-27 00:00:00,LABORABLE
27,12,2020,7,103,96,199,2020-12-27 06:00:00,2020-12-27 00:00:00,LABORABLE
27,12,2020,8,119,143,262,2020-12-27 07:00:00,2020-12-27 00:00:00,LABORABLE
27,12,2020,9,165,170,335,2020-12-27 08:00:00,2020-12-27 00:00:00,LABORABLE
27,12,2020,10,265,306,571,2020-12-27 09:00:00,2020-12-27 00:00:00,LABORABLE
27,12,2020,11,330,425,755,2020-12-27 10:00:00,2020-12-27 00:00:00,LABORABLE
27,12,2020,12,521,560,1081,2020-12-27 11:00:00,2020-12-27 00:00:00,LABORABLE
27,12,2020,13,540,649,1189,2020-12-27 12:00:00,2020-12-27 00:00:00,LABORABLE
27,12,2020,14,522,646,1168,2020-12-27 13:00:00,2020-12-27 00:00:00,LABORABLE
27,12,2020,15,481,627,1108,2020-12-27 14:00:00,2020-12-27 00:00:00,LABORABLE
27,12,2020,16,436,578,1014,2020-12-27 15:00:00,2020-12-27 00:00:00,LABORABLE
27,12,2020,17,494,603,1097,2020-12-27 16:00:00,2020-12-27 00:00:00,LABORABLE
27,12,2020,18,440,562,1002,2020-12-27 17:00:00,2020-12-27 00:00:00,LABORABLE
27,12,2020,19,508,597,1105,2020-12-27 18:00:00,2020-12-27 00:00:00,LABORABLE
27,12,2020,20,476,593,1069,2020-12-27 19:00:00,2020-12-27 00:00:00,LABORABLE
27,12,2020,21,422,491,913,2020-12-27 20:00:00,2020-12-27 00:00:00,LABORABLE
27,12,2020,22,379,456,835,2020-12-27 21:00:00,2020-12-27 00:00:00,LABORABLE
27,12,2020,23,330,363,693,2020-12-27 22:00:00,2020-12-27 00:00:00,LABORABLE
27,12,2020,24,225,273,498,2020-12-27 23:00:00,2020-12-27 00:00:00,LABORABLE
28,12,2020,1,156,210,366,2020-12-28 00:00:00,2020-12-28 00:00:00,LABORABLE
28,12,2020,2,66,82,148,2020-12-28 01:00:00,2020-12-28 00:00:00,LABORABLE
28,12,2020,3,45,73,118,2020-12-28 02:00:00,2020-12-28 00:00:00,LABORABLE
28,12,2020,4,46,36,82,2020-12-28 03:00:00,2020-12-28 00:00:00,LABORABLE
28,12,2020,5,72,53,125,2020-12-28 04:00:00,2020-12-28 00:00:00,LABORABLE
28,12,2020,6,150,91,241,2020-12-28 05:00:00,2020-12-28 00:00:00,LABORABLE
28,12,2020,7,332,267,599,2020-12-28 06:00:00,2020-12-28 00:00:00,LABORABLE
28,12,2020,8,512,395,907,2020-12-28 07:00:00,2020-12-28 00:00:00,LABORABLE
28,12,2020,9,509,519,1028,2020-12-28 08:00:00,2020-12-28 00:00:00,LABORABLE
28,12,2020,10,566,609,1175,2020-12-28 09:00:00,2020-12-28 00:00:00,LABORABLE
28,12,2020,11,558,631,1189,2020-12-28 10:00:00,2020-12-28 00:00:00,LABORABLE
28,12,2020,12,642,630,1272,2020-12-28 11:00:00,2020-12-28 00:00:00,LABORABLE
28,12,2020,13,518,615,1133,2020-12-28 12:00:00,2020-12-28 00:00:00,LABORABLE
28,12,2020,14,646,728,1374,2020-12-28 13:00:00,2020-12-28 00:00:00,LABORABLE
28,12,2020,15,592,647,1239,2020-12-28 14:00:00,2020-12-28 00:00:00,LABORABLE
28,12,2020,16,589,598,1187,2020-12-28 15:00:00,2020-12-28 00:00:00,LABORABLE
28,12,2020,17,581,656,1237,2020-12-28 16:00:00,2020-12-28 00:00:00,LABORABLE
28,12,2020,18,653,627,1280,2020-12-28 17:00:00,2020-12-28 00:00:00,LABORABLE
28,12,2020,19,722,548,1270,2020-12-28 18:00:00,2020-12-28 00:00:00,LABORABLE
28,12,2020,20,641,680,1321,2020-12-28 19:00:00,2020-12-28 00:00:00,LABORABLE
28,12,2020,21,518,692,1210,2020-12-28 20:00:00,2020-12-28 00:00:00,LABORABLE
28,12,2020,22,454,494,948,2020-12-28 21:00:00,2020-12-28 00:00:00,LABORABLE
28,12,2020,23,365,391,756,2020-12-28 22:00:00,2020-12-28 00:00:00,LABORABLE
28,12,2020,24,221,236,457,2020-12-28 23:00:00,2020-12-28 00:00:00,LABORABLE
29,12,2020,1,122,145,267,2020-12-29 00:00:00,2020-12-29 00:00:00,LABORABLE
29,12,2020,2,66,85,151,2020-12-29 01:00:00,2020-12-29 00:00:00,LABORABLE
29,12,2020,3,39,44,83,2020-12-29 02:00:00,2020-12-29 00:00:00,LABORABLE
29,12,2020,4,45,31,76,2020-12-29 03:00:00,2020-12-29 00:00:00,LABORABLE
29,12,2020,5,62,35,97,2020-12-29 04:00:00,2020-12-29 00:00:00,LABORABLE
29,12,2020,6,147,95,242,2020-12-29 05:00:00,2020-12-29 00:00:00,LABORABLE
29,12,2020,7,326,259,585,2020-12-29 06:00:00,2020-12-29 00:00:00,LABORABLE
29,12,2020,8,548,394,942,2020-12-29 07:00:00,2020-12-29 00:00:00,LABORABLE
29,12,2020,9,537,557,1094,2020-12-29 08:00:00,2020-12-29 00:00:00,LABORABLE
29,12,2020,10,553,624,1177,2020-12-29 09:00:00,2020-12-29 00:00:00,LABORABLE
29,12,2020,11,544,606,1150,2020-12-29 10:00:00,2020-12-29 00:00:00,LABORABLE
29,12,2020,12,621,684,1305,2020-12-29 11:00:00,2020-12-29 00:00:00,LABORABLE
29,12,2020,13,668,742,1410,2020-12-29 12:00:00,2020-12-29 00:00:00,LABORABLE
29,12,2020,14,648,701,1349,2020-12-29 13:00:00,2020-12-29 00:00:00,LABORABLE
29,12,2020,15,672,714,1386,2020-12-29 14:00:00,2020-12-29 00:00:00,LABORABLE
29,12,2020,16,608,682,1290,2020-12-29 15:00:00,2020-12-29 00:00:00,LABORABLE
29,12,2020,17,637,708,1345,2020-12-29 16:00:00,2020-12-29 00:00:00,LABORABLE
29,12,2020,18,650,600,1250,2020-12-29 17:00:00,2020-12-29 00:00:00,LABORABLE
29,12,2020,19,716,678,1394,2020-12-29 18:00:00,2020-12-29 00:00:00,LABORABLE
29,12,2020,20,621,668,1289,2020-12-29 19:00:00,2020-12-29 00:00:00,LABORABLE
29,12,2020,21,558,721,1279,2020-12-29 20:00:00,2020-12-29 00:00:00,LABORABLE
29,12,2020,22,477,585,1062,2020-12-29 21:00:00,2020-12-29 00:00:00,LABORABLE
29,12,2020,23,366,411,777,2020-12-29 22:00:00,2020-12-29 00:00:00,LABORABLE
29,12,2020,24,230,306,536,2020-12-29 23:00:00,2020-12-29 00:00:00,LABORABLE
30,12,2020,1,140,184,324,2020-12-30 00:00:00,2020-12-30 00:00:00,LABORABLE
30,12,2020,2,65,89,154,2020-12-30 01:00:00,2020-12-30 00:00:00,LABORABLE
30,12,2020,3,43,86,129,2020-12-30 02:00:00,2020-12-30 00:00:00,LABORABLE
30,12,2020,4,45,48,93,2020-12-30 03:00:00,2020-12-30 00:00:00,LABORABLE
30,12,2020,5,70,60,130,2020-12-30 04:00:00,2020-12-30 00:00:00,LABORABLE
30,12,2020,6,160,93,253,2020-12-30 05:00:00,2020-12-30 00:00:00,LABORABLE
30,12,2020,7,333,268,601,2020-12-30 06:00:00,2020-12-30 00:00:00,LABORABLE
30,12,2020,8,511,416,927,2020-12-30 07:00:00,2020-12-30 00:00:00,LABORABLE
30,12,2020,9,528,550,1078,2020-12-30 08:00:00,2020-12-30 00:00:00,LABORABLE
30,12,2020,10,581,649,1230,2020-12-30 09:00:00,2020-12-30 00:00:00,LABORABLE
30,12,2020,11,602,697,1299,2020-12-30 10:00:00,2020-12-30 00:00:00,LABORABLE
30,12,2020,12,637,736,1373,2020-12-30 11:00:00,2020-12-30 00:00:00,LABORABLE
30,12,2020,13,712,669,1381,2020-12-30 12:00:00,2020-12-30 00:00:00,LABORABLE
30,12,2020,14,497,623,1120,2020-12-30 13:00:00,2020-12-30 00:00:00,LABORABLE
30,12,2020,15,653,679,1332,2020-12-30 14:00:00,2020-12-30 00:00:00,LABORABLE
30,12,2020,16,610,670,1280,2020-12-30 15:00:00,2020-12-30 00:00:00,LABORABLE
30,12,2020,17,641,669,1310,2020-12-30 16:00:00,2020-12-30 00:00:00,LABORABLE
30,12,2020,18,640,714,1354,2020-12-30 17:00:00,2020-12-30 00:00:00,LABORABLE
30,12,2020,19,704,714,1418,2020-12-30 18:00:00,2020-12-30 00:00:00,LABORABLE
30,12,2020,20,690,775,1465,2020-12-30 19:00:00,2020-12-30 00:00:00,LABORABLE
30,12,2020,21,606,827,1433,2020-12-30 20:00:00,2020-12-30 00:00:00,LABORABLE
30,12,2020,22,578,671,1249,2020-12-30 21:00:00,2020-12-30 00:00:00,LABORABLE
30,12,2020,23,470,431,901,2020-12-30 22:00:00,2020-12-30 00:00:00,LABORABLE
30,12,2020,24,376,332,708,2020-12-30 23:00:00,2020-12-30 00:00:00,LABORABLE
31,12,2020,1,197,217,414,2020-12-31 00:00:00,2020-12-31 00:00:00,LABORABLE
31,12,2020,2,98,109,207,2020-12-31 01:00:00,2020-12-31 00:00:00,LABORABLE
31,12,2020,3,61,60,121,2020-12-31 02:00:00,2020-12-31 00:00:00,LABORABLE
31,12,2020,4,65,49,114,2020-12-31 03:00:00,2020-12-31 00:00:00,LABORABLE
31,12,2020,5,73,54,127,2020-12-31 04:00:00,2020-12-31 00:00:00,LABORABLE
31,12,2020,6,134,83,217,2020-12-31 05:00:00,2020-12-31 00:00:00,LABORABLE
31,12,2020,7,224,205,429,2020-12-31 06:00:00,2020-12-31 00:00:00,LABORABLE
31,12,2020,8,331,287,618,2020-12-31 07:00:00,2020-12-31 00:00:00,LABORABLE
31,12,2020,9,425,491,916,2020-12-31 08:00:00,2020-12-31 00:00:00,LABORABLE
31,12,2020,10,487,621,1108,2020-12-31 09:00:00,2020-12-31 00:00:00,LABORABLE
31,12,2020,11,589,703,1292,2020-12-31 10:00:00,2020-12-31 00:00:00,LABORABLE
31,12,2020,12,668,728,1396,2020-12-31 11:00:00,2020-12-31 00:00:00,LABORABLE
31,12,2020,13,710,820,1530,2020-12-31 12:00:00,2020-12-31 00:00:00,LABORABLE
31,12,2020,14,741,799,1540,2020-12-31 13:00:00,2020-12-31 00:00:00,LABORABLE
31,12,2020,15,737,826,1563,2020-12-31 14:00:00,2020-12-31 00:00:00,LABORABLE
31,12,2020,16,611,783,1394,2020-12-31 15:00:00,2020-12-31 00:00:00,LABORABLE
31,12,2020,17,582,792,1374,2020-12-31 16:00:00,2020-12-31 00:00:00,LABORABLE
31,12,2020,18,638,746,1384,2020-12-31 17:00:00,2020-12-31 00:00:00,LABORABLE
31,12,2020,19,712,883,1595,2020-12-31 18:00:00,2020-12-31 00:00:00,LABORABLE
31,12,2020,20,701,865,1566,2020-12-31 19:00:00,2020-12-31 00:00:00,LABORABLE
31,12,2020,21,667,824,1491,2020-12-31 20:00:00,2020-12-31 00:00:00,LABORABLE
31,12,2020,22,421,588,1009,2020-12-31 21:00:00,2020-12-31 00:00:00,LABORABLE
31,12,2020,23,220,372,592,2020-12-31 22:00:00,2020-12-31 00:00:00,LABORABLE
31,12,2020,24,136,309,445,2020-12-31 23:00:00,2020-12-31 00:00:00,LABORABLE
1,1,2021,1,420,354,774,2021-01-01 00:00:00,2021-01-01 00:00:00,FESTIVO
1,1,2021,2,456,291,747,2021-01-01 01:00:00,2021-01-01 00:00:00,FESTIVO
1,1,2021,3,169,143,312,2021-01-01 02:00:00,2021-01-01 00:00:00,FESTIVO
1,1,2021,4,69,67,136,2021-01-01 03:00:00,2021-01-01 00:00:00,FESTIVO
1,1,2021,5,74,66,140,2021-01-01 04:00:00,2021-01-01 00:00:00,FESTIVO
1,1,2021,6,56,77,133,2021-01-01 05:00:00,2021-01-01 00:00:00,FESTIVO
1,1,2021,7,86,153,239,2021-01-01 06:00:00,2021-01-01 00:00:00,FESTIVO
1,1,2021,8,129,221,350,2021-01-01 07:00:00,2021-01-01 00:00:00,FESTIVO
1,1,2021,9,104,334,438,2021-01-01 08:00:00,2021-01-01 00:00:00,FESTIVO
1,1,2021,10,109,400,509,2021-01-01 09:00:00,2021-01-01 00:00:00,FESTIVO
1,1,2021,11,180,407,587,2021-01-01 10:00:00,2021-01-01 00:00:00,FESTIVO
1,1,2021,12,254,467,721,2021-01-01 11:00:00,2021-01-01 00:00:00,FESTIVO
1,1,2021,13,326,560,886,2021-01-01 12:00:00,2021-01-01 00:00:00,FESTIVO
1,1,2021,14,441,651,1092,2021-01-01 13:00:00,2021-01-01 00:00:00,FESTIVO
1,1,2021,15,394,631,1025,2021-01-01 14:00:00,2021-01-01 00:00:00,FESTIVO
1,1,2021,16,312,566,878,2021-01-01 15:00:00,2021-01-01 00:00:00,FESTIVO
1,1,2021,17,343,560,903,2021-01-01 16:00:00,2021-01-01 00:00:00,FESTIVO
1,1,2021,18,458,667,1125,2021-01-01 17:00:00,2021-01-01 00:00:00,FESTIVO
1,1,2021,19,502,711,1213,2021-01-01 18:00:00,2021-01-01 00:00:00,FESTIVO
1,1,2021,20,500,745,1245,2021-01-01 19:00:00,2021-01-01 00:00:00,FESTIVO
1,1,2021,21,410,653,1063,2021-01-01 20:00:00,2021-01-01 00:00:00,FESTIVO
1,1,2021,22,296,476,772,2021-01-01 21:00:00,2021-01-01 00:00:00,FESTIVO
1,1,2021,23,282,407,689,2021-01-01 22:00:00,2021-01-01 00:00:00,FESTIVO
1,1,2021,24,231,328,559,2021-01-01 23:00:00,2021-01-01 00:00:00,FESTIVO
2,1,2021,1,148,238,386,2021-01-02 00:00:00,2021-02-01 00:00:00,LABORABLE
2,1,2021,2,63,93,156,2021-01-02 01:00:00,2021-02-01 00:00:00,LABORABLE
2,1,2021,3,29,74,103,2021-01-02 02:00:00,2021-02-01 00:00:00,LABORABLE
2,1,2021,4,39,53,92,2021-01-02 03:00:00,2021-02-01 00:00:00,LABORABLE
2,1,2021,5,35,47,82,2021-01-02 04:00:00,2021-02-01 00:00:00,LABORABLE
2,1,2021,6,72,93,165,2021-01-02 05:00:00,2021-02-01 00:00:00,LABORABLE
2,1,2021,7,131,174,305,2021-01-02 06:00:00,2021-02-01 00:00:00,LABORABLE
2,1,2021,8,180,296,476,2021-01-02 07:00:00,2021-02-01 00:00:00,LABORABLE
2,1,2021,9,229,430,659,2021-01-02 08:00:00,2021-02-01 00:00:00,LABORABLE
2,1,2021,10,353,555,908,2021-01-02 09:00:00,2021-02-01 00:00:00,LABORABLE
2,1,2021,11,453,681,1134,2021-01-02 10:00:00,2021-02-01 00:00:00,LABORABLE
2,1,2021,12,495,721,1216,2021-01-02 11:00:00,2021-02-01 00:00:00,LABORABLE
2,1,2021,13,586,777,1363,2021-01-02 12:00:00,2021-02-01 00:00:00,LABORABLE
2,1,2021,14,607,824,1431,2021-01-02 13:00:00,2021-02-01 00:00:00,LABORABLE
2,1,2021,15,579,737,1316,2021-01-02 14:00:00,2021-02-01 00:00:00,LABORABLE
2,1,2021,16,481,699,1180,2021-01-02 15:00:00,2021-02-01 00:00:00,LABORABLE
2,1,2021,17,511,652,1163,2021-01-02 16:00:00,2021-02-01 00:00:00,LABORABLE
2,1,2021,18,490,727,1217,2021-01-02 17:00:00,2021-02-01 00:00:00,LABORABLE
2,1,2021,19,571,780,1351,2021-01-02 18:00:00,2021-02-01 00:00:00,LABORABLE
2,1,2021,20,548,795,1343,2021-01-02 19:00:00,2021-02-01 00:00:00,LABORABLE
2,1,2021,21,471,719,1190,2021-01-02 20:00:00,2021-02-01 00:00:00,LABORABLE
2,1,2021,22,451,639,1090,2021-01-02 21:00:00,2021-02-01 00:00:00,LABORABLE
2,1,2021,23,412,479,891,2021-01-02 22:00:00,2021-02-01 00:00:00,LABORABLE
2,1,2021,24,387,367,754,2021-01-02 23:00:00,2021-02-01 00:00:00,LABORABLE
3,1,2021,1,219,280,499,2021-01-03 00:00:00,2021-03-01 00:00:00,LABORABLE
3,1,2021,2,87,82,169,2021-01-03 01:00:00,2021-03-01 00:00:00,LABORABLE
3,1,2021,3,50,88,138,2021-01-03 02:00:00,2021-03-01 00:00:00,LABORABLE
3,1,2021,4,44,42,86,2021-01-03 03:00:00,2021-03-01 00:00:00,LABORABLE
3,1,2021,5,34,47,81,2021-01-03 04:00:00,2021-03-01 00:00:00,LABORABLE
3,1,2021,6,49,82,131,2021-01-03 05:00:00,2021-03-01 00:00:00,LABORABLE
3,1,2021,7,93,163,256,2021-01-03 06:00:00,2021-03-01 00:00:00,LABORABLE
3,1,2021,8,147,253,400,2021-01-03 07:00:00,2021-03-01 00:00:00,LABORABLE
3,1,2021,9,186,392,578,2021-01-03 08:00:00,2021-03-01 00:00:00,LABORABLE
3,1,2021,10,261,520,781,2021-01-03 09:00:00,2021-03-01 00:00:00,LABORABLE
3,1,2021,11,376,561,937,2021-01-03 10:00:00,2021-03-01 00:00:00,LABORABLE
3,1,2021,12,508,625,1133,2021-01-03 11:00:00,2021-03-01 00:00:00,LABORABLE
3,1,2021,13,513,734,1247,2021-01-03 12:00:00,2021-03-01 00:00:00,LABORABLE
3,1,2021,14,543,700,1243,2021-01-03 13:00:00,2021-03-01 00:00:00,LABORABLE
3,1,2021,15,542,706,1248,2021-01-03 14:00:00,2021-03-01 00:00:00,LABORABLE
3,1,2021,16,433,628,1061,2021-01-03 15:00:00,2021-03-01 00:00:00,LABORABLE
3,1,2021,17,437,640,1077,2021-01-03 16:00:00,2021-03-01 00:00:00,LABORABLE
3,1,2021,18,503,688,1191,2021-01-03 17:00:00,2021-03-01 00:00:00,LABORABLE
3,1,2021,19,556,828,1384,2021-01-03 18:00:00,2021-03-01 00:00:00,LABORABLE
3,1,2021,20,499,788,1287,2021-01-03 19:00:00,2021-03-01 00:00:00,LABORABLE
3,1,2021,21,466,723,1189,2021-01-03 20:00:00,2021-03-01 00:00:00,LABORABLE
3,1,2021,22,381,559,940,2021-01-03 21:00:00,2021-03-01 00:00:00,LABORABLE
3,1,2021,23,352,465,817,2021-01-03 22:00:00,2021-03-01 00:00:00,LABORABLE
3,1,2021,24,266,325,591,2021-01-03 23:00:00,2021-03-01 00:00:00,LABORABLE
4,1,2021,1,155,252,407,2021-01-04 00:00:00,2021-04-01 00:00:00,LABORABLE
4,1,2021,2,74,107,181,2021-01-04 01:00:00,2021-04-01 00:00:00,LABORABLE
4,1,2021,3,57,61,118,2021-01-04 02:00:00,2021-04-01 00:00:00,LABORABLE
4,1,2021,4,43,65,108,2021-01-04 03:00:00,2021-04-01 00:00:00,LABORABLE
4,1,2021,5,66,50,116,2021-01-04 04:00:00,2021-04-01 00:00:00,LABORABLE
4,1,2021,6,150,100,250,2021-01-04 05:00:00,2021-04-01 00:00:00,LABORABLE
4,1,2021,7,323,294,617,2021-01-04 06:00:00,2021-04-01 00:00:00,LABORABLE
4,1,2021,8,586,514,1100,2021-01-04 07:00:00,2021-04-01 00:00:00,LABORABLE
4,1,2021,9,501,625,1126,2021-01-04 08:00:00,2021-04-01 00:00:00,LABORABLE
4,1,2021,10,581,737,1318,2021-01-04 09:00:00,2021-04-01 00:00:00,LABORABLE
4,1,2021,11,611,737,1348,2021-01-04 10:00:00,2021-04-01 00:00:00,LABORABLE
4,1,2021,12,556,729,1285,2021-01-04 11:00:00,2021-04-01 00:00:00,LABORABLE
4,1,2021,13,688,845,1533,2021-01-04 12:00:00,2021-04-01 00:00:00,LABORABLE
4,1,2021,14,671,886,1557,2021-01-04 13:00:00,2021-04-01 00:00:00,LABORABLE
4,1,2021,15,626,810,1436,2021-01-04 14:00:00,2021-04-01 00:00:00,LABORABLE
4,1,2021,16,578,728,1306,2021-01-04 15:00:00,2021-04-01 00:00:00,LABORABLE
4,1,2021,17,612,745,1357,2021-01-04 16:00:00,2021-04-01 00:00:00,LABORABLE
4,1,2021,18,637,863,1500,2021-01-04 17:00:00,2021-04-01 00:00:00,LABORABLE
4,1,2021,19,725,881,1606,2021-01-04 18:00:00,2021-04-01 00:00:00,LABORABLE
4,1,2021,20,648,856,1504,2021-01-04 19:00:00,2021-04-01 00:00:00,LABORABLE
4,1,2021,21,594,879,1473,2021-01-04 20:00:00,2021-04-01 00:00:00,LABORABLE
4,1,2021,22,431,642,1073,2021-01-04 21:00:00,2021-04-01 00:00:00,LABORABLE
4,1,2021,23,358,480,838,2021-01-04 22:00:00,2021-04-01 00:00:00,LABORABLE
4,1,2021,24,207,367,574,2021-01-04 23:00:00,2021-04-01 00:00:00,LABORABLE
5,1,2021,1,111,296,407,2021-01-05 00:00:00,2021-05-01 00:00:00,LABORABLE
5,1,2021,2,54,132,186,2021-01-05 01:00:00,2021-05-01 00:00:00,LABORABLE
5,1,2021,3,42,84,126,2021-01-05 02:00:00,2021-05-01 00:00:00,LABORABLE
5,1,2021,4,61,58,119,2021-01-05 03:00:00,2021-05-01 00:00:00,LABORABLE
5,1,2021,5,62,64,126,2021-01-05 04:00:00,2021-05-01 00:00:00,LABORABLE
5,1,2021,6,139,119,258,2021-01-05 05:00:00,2021-05-01 00:00:00,LABORABLE
5,1,2021,7,341,255,596,2021-01-05 06:00:00,2021-05-01 00:00:00,LABORABLE
5,1,2021,8,520,385,905,2021-01-05 07:00:00,2021-05-01 00:00:00,LABORABLE
5,1,2021,9,520,513,1033,2021-01-05 08:00:00,2021-05-01 00:00:00,LABORABLE
5,1,2021,10,545,664,1209,2021-01-05 09:00:00,2021-05-01 00:00:00,LABORABLE
5,1,2021,11,598,741,1339,2021-01-05 10:00:00,2021-05-01 00:00:00,LABORABLE
5,1,2021,12,630,874,1504,2021-01-05 11:00:00,2021-05-01 00:00:00,LABORABLE
5,1,2021,13,664,844,1508,2021-01-05 12:00:00,2021-05-01 00:00:00,LABORABLE
5,1,2021,14,671,851,1522,2021-01-05 13:00:00,2021-05-01 00:00:00,LABORABLE
5,1,2021,15,662,948,1610,2021-01-05 14:00:00,2021-05-01 00:00:00,LABORABLE
5,1,2021,16,576,834,1410,2021-01-05 15:00:00,2021-05-01 00:00:00,LABORABLE
5,1,2021,17,609,762,1371,2021-01-05 16:00:00,2021-05-01 00:00:00,LABORABLE
5,1,2021,18,709,798,1507,2021-01-05 17:00:00,2021-05-01 00:00:00,LABORABLE
5,1,2021,19,725,881,1606,2021-01-05 18:00:00,2021-05-01 00:00:00,LABORABLE
5,1,2021,20,713,913,1626,2021-01-05 19:00:00,2021-05-01 00:00:00,LABORABLE
5,1,2021,21,612,825,1437,2021-01-05 20:00:00,2021-05-01 00:00:00,LABORABLE
5,1,2021,22,555,673,1228,2021-01-05 21:00:00,2021-05-01 00:00:00,LABORABLE
5,1,2021,23,443,585,1028,2021-01-05 22:00:00,2021-05-01 00:00:00,LABORABLE
5,1,2021,24,343,448,791,2021-01-05 23:00:00,2021-05-01 00:00:00,LABORABLE
6,1,2021,1,190,377,567,2021-01-06 00:00:00,2021-06-01 00:00:00,FESTIVO
6,1,2021,2,82,193,275,2021-01-06 01:00:00,2021-06-01 00:00:00,FESTIVO
6,1,2021,3,55,89,144,2021-01-06 02:00:00,2021-06-01 00:00:00,FESTIVO
6,1,2021,4,42,67,109,2021-01-06 03:00:00,2021-06-01 00:00:00,FESTIVO
6,1,2021,5,28,43,71,2021-01-06 04:00:00,2021-06-01 00:00:00,FESTIVO
6,1,2021,6,46,66,112,2021-01-06 05:00:00,2021-06-01 00:00:00,FESTIVO
6,1,2021,7,69,100,169,2021-01-06 06:00:00,2021-06-01 00:00:00,FESTIVO
6,1,2021,8,126,133,259,2021-01-06 07:00:00,2021-06-01 00:00:00,FESTIVO
6,1,2021,9,170,220,390,2021-01-06 08:00:00,2021-06-01 00:00:00,FESTIVO
6,1,2021,10,233,362,595,2021-01-06 09:00:00,2021-06-01 00:00:00,FESTIVO
6,1,2021,11,337,504,841,2021-01-06 10:00:00,2021-06-01 00:00:00,FESTIVO
6,1,2021,12,441,609,1050,2021-01-06 11:00:00,2021-06-01 00:00:00,FESTIVO
6,1,2021,13,590,757,1347,2021-01-06 12:00:00,2021-06-01 00:00:00,FESTIVO
6,1,2021,14,653,744,1397,2021-01-06 13:00:00,2021-06-01 00:00:00,FESTIVO
6,1,2021,15,604,795,1399,2021-01-06 14:00:00,2021-06-01 00:00:00,FESTIVO
6,1,2021,16,474,676,1150,2021-01-06 15:00:00,2021-06-01 00:00:00,FESTIVO
6,1,2021,17,497,629,1126,2021-01-06 16:00:00,2021-06-01 00:00:00,FESTIVO
6,1,2021,18,576,691,1267,2021-01-06 17:00:00,2021-06-01 00:00:00,FESTIVO
6,1,2021,19,649,723,1372,2021-01-06 18:00:00,2021-06-01 00:00:00,FESTIVO
6,1,2021,20,612,727,1339,2021-01-06 19:00:00,2021-06-01 00:00:00,FESTIVO
6,1,2021,21,510,650,1160,2021-01-06 20:00:00,2021-06-01 00:00:00,FESTIVO
6,1,2021,22,478,549,1027,2021-01-06 21:00:00,2021-06-01 00:00:00,FESTIVO
6,1,2021,23,351,433,784,2021-01-06 22:00:00,2021-06-01 00:00:00,FESTIVO
6,1,2021,24,286,395,681,2021-01-06 23:00:00,2021-06-01 00:00:00,FESTIVO
7,1,2021,1,158,269,427,2021-01-07 00:00:00,2021-07-01 00:00:00,LABORABLE
7,1,2021,2,49,126,175,2021-01-07 01:00:00,2021-07-01 00:00:00,LABORABLE
7,1,2021,3,45,69,114,2021-01-07 02:00:00,2021-07-01 00:00:00,LABORABLE
7,1,2021,4,43,54,97,2021-01-07 03:00:00,2021-07-01 00:00:00,LABORABLE
7,1,2021,5,61,49,110,2021-01-07 04:00:00,2021-07-01 00:00:00,LABORABLE
7,1,2021,6,153,92,245,2021-01-07 05:00:00,2021-07-01 00:00:00,LABORABLE
7,1,2021,7,350,249,599,2021-01-07 06:00:00,2021-07-01 00:00:00,LABORABLE
7,1,2021,8,530,379,909,2021-01-07 07:00:00,2021-07-01 00:00:00,LABORABLE
7,1,2021,9,508,476,984,2021-01-07 08:00:00,2021-07-01 00:00:00,LABORABLE
7,1,2021,10,572,629,1201,2021-01-07 09:00:00,2021-07-01 00:00:00,LABORABLE
7,1,2021,11,559,644,1203,2021-01-07 10:00:00,2021-07-01 00:00:00,LABORABLE
7,1,2021,12,581,716,1297,2021-01-07 11:00:00,2021-07-01 00:00:00,LABORABLE
7,1,2021,13,608,840,1448,2021-01-07 12:00:00,2021-07-01 00:00:00,LABORABLE
7,1,2021,14,589,869,1458,2021-01-07 13:00:00,2021-07-01 00:00:00,LABORABLE
7,1,2021,15,597,813,1410,2021-01-07 14:00:00,2021-07-01 00:00:00,LABORABLE
7,1,2021,16,503,748,1251,2021-01-07 15:00:00,2021-07-01 00:00:00,LABORABLE
7,1,2021,17,514,761,1275,2021-01-07 16:00:00,2021-07-01 00:00:00,LABORABLE
7,1,2021,18,608,730,1338,2021-01-07 17:00:00,2021-07-01 00:00:00,LABORABLE
7,1,2021,19,581,802,1383,2021-01-07 18:00:00,2021-07-01 00:00:00,LABORABLE
7,1,2021,20,634,857,1491,2021-01-07 19:00:00,2021-07-01 00:00:00,LABORABLE
7,1,2021,21,528,709,1237,2021-01-07 20:00:00,2021-07-01 00:00:00,LABORABLE
7,1,2021,22,406,575,981,2021-01-07 21:00:00,2021-07-01 00:00:00,LABORABLE
7,1,2021,23,325,439,764,2021-01-07 22:00:00,2021-07-01 00:00:00,LABORABLE
7,1,2021,24,208,309,517,2021-01-07 23:00:00,2021-07-01 00:00:00,LABORABLE
8,1,2021,1,133,222,355,2021-01-08 00:00:00,2021-08-01 00:00:00,LABORABLE
8,1,2021,2,70,121,191,2021-01-08 01:00:00,2021-08-01 00:00:00,LABORABLE
8,1,2021,3,46,71,117,2021-01-08 02:00:00,2021-08-01 00:00:00,LABORABLE
8,1,2021,4,57,36,93,2021-01-08 03:00:00,2021-08-01 00:00:00,LABORABLE
8,1,2021,5,64,48,112,2021-01-08 04:00:00,2021-08-01 00:00:00,LABORABLE
8,1,2021,6,170,118,288,2021-01-08 05:00:00,2021-08-01 00:00:00,LABORABLE
8,1,2021,7,335,218,553,2021-01-08 06:00:00,2021-08-01 00:00:00,LABORABLE
8,1,2021,8,531,371,902,2021-01-08 07:00:00,2021-08-01 00:00:00,LABORABLE
8,1,2021,9,520,423,943,2021-01-08 08:00:00,2021-08-01 00:00:00,LABORABLE
8,1,2021,10,534,564,1098,2021-01-08 09:00:00,2021-08-01 00:00:00,LABORABLE
8,1,2021,11,520,699,1219,2021-01-08 10:00:00,2021-08-01 00:00:00,LABORABLE
8,1,2021,12,589,607,1196,2021-01-08 11:00:00,2021-08-01 00:00:00,LABORABLE
8,1,2021,13,601,697,1298,2021-01-08 12:00:00,2021-08-01 00:00:00,LABORABLE
8,1,2021,14,561,647,1208,2021-01-08 13:00:00,2021-08-01 00:00:00,LABORABLE
8,1,2021,15,559,587,1146,2021-01-08 14:00:00,2021-08-01 00:00:00,LABORABLE
8,1,2021,16,469,619,1088,2021-01-08 15:00:00,2021-08-01 00:00:00,LABORABLE
8,1,2021,17,460,586,1046,2021-01-08 16:00:00,2021-08-01 00:00:00,LABORABLE
8,1,2021,18,446,518,964,2021-01-08 17:00:00,2021-08-01 00:00:00,LABORABLE
8,1,2021,19,437,554,991,2021-01-08 18:00:00,2021-08-01 00:00:00,LABORABLE
8,1,2021,20,343,490,833,2021-01-08 19:00:00,2021-08-01 00:00:00,LABORABLE
8,1,2021,21,252,417,669,2021-01-08 20:00:00,2021-08-01 00:00:00,LABORABLE
8,1,2021,22,154,345,499,2021-01-08 21:00:00,2021-08-01 00:00:00,LABORABLE
8,1,2021,23,66,229,295,2021-01-08 22:00:00,2021-08-01 00:00:00,LABORABLE
8,1,2021,24,29,146,175,2021-01-08 23:00:00,2021-08-01 00:00:00,LABORABLE
9,1,2021,1,29,119,148,2021-01-09 00:00:00,2021-09-01 00:00:00,LABORABLE
9,1,2021,2,15,51,66,2021-01-09 01:00:00,2021-09-01 00:00:00,LABORABLE
9,1,2021,3,5,52,57,2021-01-09 02:00:00,2021-09-01 00:00:00,LABORABLE
9,1,2021,4,2,24,26,2021-01-09 03:00:00,2021-09-01 00:00:00,LABORABLE
9,1,2021,5,3,20,23,2021-01-09 04:00:00,2021-09-01 00:00:00,LABORABLE
9,1,2021,6,2,21,23,2021-01-09 05:00:00,2021-09-01 00:00:00,LABORABLE
9,1,2021,7,1,70,71,2021-01-09 06:00:00,2021-09-01 00:00:00,LABORABLE
9,1,2021,8,0,105,105,2021-01-09 07:00:00,2021-09-01 00:00:00,LABORABLE
9,1,2021,9,0,191,191,2021-01-09 08:00:00,2021-09-01 00:00:00,LABORABLE
9,1,2021,10,1,231,232,2021-01-09 09:00:00,2021-09-01 00:00:00,LABORABLE
9,1,2021,11,1,199,200,2021-01-09 10:00:00,2021-09-01 00:00:00,LABORABLE
9,1,2021,12,0,192,192,2021-01-09 11:00:00,2021-09-01 00:00:00,LABORABLE
9,1,2021,13,0,211,211,2021-01-09 12:00:00,2021-09-01 00:00:00,LABORABLE
9,1,2021,14,0,212,212,2021-01-09 13:00:00,2021-09-01 00:00:00,LABORABLE
9,1,2021,15,0,247,247,2021-01-09 14:00:00,2021-09-01 00:00:00,LABORABLE
9,1,2021,16,0,211,211,2021-01-09 15:00:00,2021-09-01 00:00:00,LABORABLE
9,1,2021,17,0,212,212,2021-01-09 16:00:00,2021-09-01 00:00:00,LABORABLE
9,1,2021,18,0,215,215,2021-01-09 17:00:00,2021-09-01 00:00:00,LABORABLE
9,1,2021,19,1,228,229,2021-01-09 18:00:00,2021-09-01 00:00:00,LABORABLE
9,1,2021,20,2,290,292,2021-01-09 19:00:00,2021-09-01 00:00:00,LABORABLE
9,1,2021,21,0,282,282,2021-01-09 20:00:00,2021-09-01 00:00:00,LABORABLE
9,1,2021,22,0,236,236,2021-01-09 21:00:00,2021-09-01 00:00:00,LABORABLE
9,1,2021,23,2,129,131,2021-01-09 22:00:00,2021-09-01 00:00:00,LABORABLE
9,1,2021,24,3,94,97,2021-01-09 23:00:00,2021-09-01 00:00:00,LABORABLE
10,1,2021,1,2,72,74,2021-01-10 00:00:00,2021-10-01 00:00:00,LABORABLE
10,1,2021,2,2,39,41,2021-01-10 01:00:00,2021-10-01 00:00:00,LABORABLE
10,1,2021,3,1,23,24,2021-01-10 02:00:00,2021-10-01 00:00:00,LABORABLE
10,1,2021,4,4,14,18,2021-01-10 03:00:00,2021-10-01 00:00:00,LABORABLE
10,1,2021,5,5,19,24,2021-01-10 04:00:00,2021-10-01 00:00:00,LABORABLE
10,1,2021,6,4,23,27,2021-01-10 05:00:00,2021-10-01 00:00:00,LABORABLE
10,1,2021,7,3,71,74,2021-01-10 06:00:00,2021-10-01 00:00:00,LABORABLE
10,1,2021,8,0,111,111,2021-01-10 07:00:00,2021-10-01 00:00:00,LABORABLE
10,1,2021,9,4,194,198,2021-01-10 08:00:00,2021-10-01 00:00:00,LABORABLE
10,1,2021,10,6,156,162,2021-01-10 09:00:00,2021-10-01 00:00:00,LABORABLE
10,1,2021,11,13,313,326,2021-01-10 10:00:00,2021-10-01 00:00:00,LABORABLE
10,1,2021,12,14,307,321,2021-01-10 11:00:00,2021-10-01 00:00:00,LABORABLE
10,1,2021,13,15,365,380,2021-01-10 12:00:00,2021-10-01 00:00:00,LABORABLE
10,1,2021,14,25,325,350,2021-01-10 13:00:00,2021-10-01 00:00:00,LABORABLE
10,1,2021,15,12,364,376,2021-01-10 14:00:00,2021-10-01 00:00:00,LABORABLE
10,1,2021,16,22,333,355,2021-01-10 15:00:00,2021-10-01 00:00:00,LABORABLE
10,1,2021,17,43,334,377,2021-01-10 16:00:00,2021-10-01 00:00:00,LABORABLE
10,1,2021,18,39,397,436,2021-01-10 17:00:00,2021-10-01 00:00:00,LABORABLE
10,1,2021,19,44,386,430,2021-01-10 18:00:00,2021-10-01 00:00:00,LABORABLE
10,1,2021,20,37,414,451,2021-01-10 19:00:00,2021-10-01 00:00:00,LABORABLE
10,1,2021,21,25,378,403,2021-01-10 20:00:00,2021-10-01 00:00:00,LABORABLE
10,1,2021,22,15,314,329,2021-01-10 21:00:00,2021-10-01 00:00:00,LABORABLE
10,1,2021,23,27,224,251,2021-01-10 22:00:00,2021-10-01 00:00:00,LABORABLE
10,1,2021,24,14,155,169,2021-01-10 23:00:00,2021-10-01 00:00:00,LABORABLE
11,1,2021,1,14,130,144,2021-01-11 00:00:00,2021-11-01 00:00:00,LABORABLE
11,1,2021,2,2,72,74,2021-01-11 01:00:00,2021-11-01 00:00:00,LABORABLE
11,1,2021,3,4,34,38,2021-01-11 02:00:00,2021-11-01 00:00:00,LABORABLE
11,1,2021,4,7,16,23,2021-01-11 03:00:00,2021-11-01 00:00:00,LABORABLE
11,1,2021,5,4,29,33,2021-01-11 04:00:00,2021-11-01 00:00:00,LABORABLE
11,1,2021,6,6,48,54,2021-01-11 05:00:00,2021-11-01 00:00:00,LABORABLE
11,1,2021,7,25,94,119,2021-01-11 06:00:00,2021-11-01 00:00:00,LABORABLE
11,1,2021,8,35,173,208,2021-01-11 07:00:00,2021-11-01 00:00:00,LABORABLE
11,1,2021,9,38,319,357,2021-01-11 08:00:00,2021-11-01 00:00:00,LABORABLE
11,1,2021,10,51,404,455,2021-01-11 09:00:00,2021-11-01 00:00:00,LABORABLE
11,1,2021,11,53,344,397,2021-01-11 10:00:00,2021-11-01 00:00:00,LABORABLE
11,1,2021,12,87,321,408,2021-01-11 11:00:00,2021-11-01 00:00:00,LABORABLE
11,1,2021,13,79,402,481,2021-01-11 12:00:00,2021-11-01 00:00:00,LABORABLE
11,1,2021,14,106,470,576,2021-01-11 13:00:00,2021-11-01 00:00:00,LABORABLE
11,1,2021,15,93,452,545,2021-01-11 14:00:00,2021-11-01 00:00:00,LABORABLE
11,1,2021,16,85,408,493,2021-01-11 15:00:00,2021-11-01 00:00:00,LABORABLE
11,1,2021,17,97,389,486,2021-01-11 16:00:00,2021-11-01 00:00:00,LABORABLE
11,1,2021,18,121,351,472,2021-01-11 17:00:00,2021-11-01 00:00:00,LABORABLE
11,1,2021,19,124,402,526,2021-01-11 18:00:00,2021-11-01 00:00:00,LABORABLE
11,1,2021,20,118,405,523,2021-01-11 19:00:00,2021-11-01 00:00:00,LABORABLE
11,1,2021,21,82,351,433,2021-01-11 20:00:00,2021-11-01 00:00:00,LABORABLE
11,1,2021,22,55,265,320,2021-01-11 21:00:00,2021-11-01 00:00:00,LABORABLE
11,1,2021,23,50,239,289,2021-01-11 22:00:00,2021-11-01 00:00:00,LABORABLE
11,1,2021,24,33,157,190,2021-01-11 23:00:00,2021-11-01 00:00:00,LABORABLE
12,1,2021,1,37,140,177,2021-01-12 00:00:00,2021-12-01 00:00:00,LABORABLE
12,1,2021,2,17,72,89,2021-01-12 01:00:00,2021-12-01 00:00:00,LABORABLE
12,1,2021,3,12,42,54,2021-01-12 02:00:00,2021-12-01 00:00:00,LABORABLE
12,1,2021,4,17,35,52,2021-01-12 03:00:00,2021-12-01 00:00:00,LABORABLE
12,1,2021,5,28,40,68,2021-01-12 04:00:00,2021-12-01 00:00:00,LABORABLE
12,1,2021,6,23,43,66,2021-01-12 05:00:00,2021-12-01 00:00:00,LABORABLE
12,1,2021,7,67,58,125,2021-01-12 06:00:00,2021-12-01 00:00:00,LABORABLE
12,1,2021,8,114,114,228,2021-01-12 07:00:00,2021-12-01 00:00:00,LABORABLE
12,1,2021,9,115,159,274,2021-01-12 08:00:00,2021-12-01 00:00:00,LABORABLE
12,1,2021,10,139,237,376,2021-01-12 09:00:00,2021-12-01 00:00:00,LABORABLE
12,1,2021,11,150,256,406,2021-01-12 10:00:00,2021-12-01 00:00:00,LABORABLE
12,1,2021,12,193,329,522,2021-01-12 11:00:00,2021-12-01 00:00:00,LABORABLE
12,1,2021,13,201,340,541,2021-01-12 12:00:00,2021-12-01 00:00:00,LABORABLE
12,1,2021,14,216,355,571,2021-01-12 13:00:00,2021-12-01 00:00:00,LABORABLE
12,1,2021,15,200,463,663,2021-01-12 14:00:00,2021-12-01 00:00:00,LABORABLE
12,1,2021,16,194,382,576,2021-01-12 15:00:00,2021-12-01 00:00:00,LABORABLE
12,1,2021,17,208,393,601,2021-01-12 16:00:00,2021-12-01 00:00:00,LABORABLE
12,1,2021,18,206,373,579,2021-01-12 17:00:00,2021-12-01 00:00:00,LABORABLE
12,1,2021,19,218,348,566,2021-01-12 18:00:00,2021-12-01 00:00:00,LABORABLE
12,1,2021,20,186,431,617,2021-01-12 19:00:00,2021-12-01 00:00:00,LABORABLE
12,1,2021,21,164,333,497,2021-01-12 20:00:00,2021-12-01 00:00:00,LABORABLE
12,1,2021,22,110,275,385,2021-01-12 21:00:00,2021-12-01 00:00:00,LABORABLE
12,1,2021,23,81,240,321,2021-01-12 22:00:00,2021-12-01 00:00:00,LABORABLE
12,1,2021,24,60,203,263,2021-01-12 23:00:00,2021-12-01 00:00:00,LABORABLE
13,1,2021,1,43,150,193,2021-01-13 00:00:00,2021-01-13 00:00:00,LABORABLE
13,1,2021,2,32,119,151,2021-01-13 01:00:00,2021-01-13 00:00:00,LABORABLE
13,1,2021,3,22,68,90,2021-01-13 02:00:00,2021-01-13 00:00:00,LABORABLE
13,1,2021,4,25,46,71,2021-01-13 03:00:00,2021-01-13 00:00:00,LABORABLE
13,1,2021,5,34,46,80,2021-01-13 04:00:00,2021-01-13 00:00:00,LABORABLE
13,1,2021,6,70,65,135,2021-01-13 05:00:00,2021-01-13 00:00:00,LABORABLE
13,1,2021,7,127,88,215,2021-01-13 06:00:00,2021-01-13 00:00:00,LABORABLE
13,1,2021,8,241,141,382,2021-01-13 07:00:00,2021-01-13 00:00:00,LABORABLE
13,1,2021,9,248,184,432,2021-01-13 08:00:00,2021-01-13 00:00:00,LABORABLE
13,1,2021,10,221,301,522,2021-01-13 09:00:00,2021-01-13 00:00:00,LABORABLE
13,1,2021,11,235,358,593,2021-01-13 10:00:00,2021-01-13 00:00:00,LABORABLE
13,1,2021,12,259,358,617,2021-01-13 11:00:00,2021-01-13 00:00:00,LABORABLE
13,1,2021,13,289,481,770,2021-01-13 12:00:00,2021-01-13 00:00:00,LABORABLE
13,1,2021,14,335,478,813,2021-01-13 13:00:00,2021-01-13 00:00:00,LABORABLE
13,1,2021,15,272,443,715,2021-01-13 14:00:00,2021-01-13 00:00:00,LABORABLE
13,1,2021,16,282,409,691,2021-01-13 15:00:00,2021-01-13 00:00:00,LABORABLE
13,1,2021,17,281,441,722,2021-01-13 16:00:00,2021-01-13 00:00:00,LABORABLE
13,1,2021,18,331,399,730,2021-01-13 17:00:00,2021-01-13 00:00:00,LABORABLE
13,1,2021,19,325,400,725,2021-01-13 18:00:00,2021-01-13 00:00:00,LABORABLE
13,1,2021,20,268,447,715,2021-01-13 19:00:00,2021-01-13 00:00:00,LABORABLE
13,1,2021,21,239,355,594,2021-01-13 20:00:00,2021-01-13 00:00:00,LABORABLE
13,1,2021,22,190,304,494,2021-01-13 21:00:00,2021-01-13 00:00:00,LABORABLE
13,1,2021,23,130,220,350,2021-01-13 22:00:00,2021-01-13 00:00:00,LABORABLE
13,1,2021,24,82,177,259,2021-01-13 23:00:00,2021-01-13 00:00:00,LABORABLE
14,1,2021,1,41,143,184,2021-01-14 00:00:00,2021-01-14 00:00:00,LABORABLE
14,1,2021,2,44,61,105,2021-01-14 01:00:00,2021-01-14 00:00:00,LABORABLE
14,1,2021,3,34,57,91,2021-01-14 02:00:00,2021-01-14 00:00:00,LABORABLE
14,1,2021,4,36,34,70,2021-01-14 03:00:00,2021-01-14 00:00:00,LABORABLE
14,1,2021,5,54,49,103,2021-01-14 04:00:00,2021-01-14 00:00:00,LABORABLE
14,1,2021,6,65,49,114,2021-01-14 05:00:00,2021-01-14 00:00:00,LABORABLE
14,1,2021,7,179,170,349,2021-01-14 06:00:00,2021-01-14 00:00:00,LABORABLE
14,1,2021,8,367,242,609,2021-01-14 07:00:00,2021-01-14 00:00:00,LABORABLE
14,1,2021,9,333,329,662,2021-01-14 08:00:00,2021-01-14 00:00:00,LABORABLE
14,1,2021,10,327,431,758,2021-01-14 09:00:00,2021-01-14 00:00:00,LABORABLE
14,1,2021,11,32,196,228,2021-01-14 10:00:00,2021-01-14 00:00:00,LABORABLE
14,1,2021,12,0,162,162,2021-01-14 11:00:00,2021-01-14 00:00:00,LABORABLE
14,1,2021,13,306,473,779,2021-01-14 12:00:00,2021-01-14 00:00:00,LABORABLE
14,1,2021,14,358,477,835,2021-01-14 13:00:00,2021-01-14 00:00:00,LABORABLE
14,1,2021,15,345,590,935,2021-01-14 14:00:00,2021-01-14 00:00:00,LABORABLE
14,1,2021,16,375,551,926,2021-01-14 15:00:00,2021-01-14 00:00:00,LABORABLE
14,1,2021,17,349,608,957,2021-01-14 16:00:00,2021-01-14 00:00:00,LABORABLE
14,1,2021,18,398,695,1093,2021-01-14 17:00:00,2021-01-14 00:00:00,LABORABLE
14,1,2021,19,394,693,1087,2021-01-14 18:00:00,2021-01-14 00:00:00,LABORABLE
14,1,2021,20,335,742,1077,2021-01-14 19:00:00,2021-01-14 00:00:00,LABORABLE
14,1,2021,21,301,658,959,2021-01-14 20:00:00,2021-01-14 00:00:00,LABORABLE
14,1,2021,22,221,472,693,2021-01-14 21:00:00,2021-01-14 00:00:00,LABORABLE
14,1,2021,23,158,321,479,2021-01-14 22:00:00,2021-01-14 00:00:00,LABORABLE
14,1,2021,24,90,241,331,2021-01-14 23:00:00,2021-01-14 00:00:00,LABORABLE
15,1,2021,1,86,151,237,2021-01-15 00:00:00,2021-01-15 00:00:00,LABORABLE
15,1,2021,2,35,91,126,2021-01-15 01:00:00,2021-01-15 00:00:00,LABORABLE
15,1,2021,3,43,61,104,2021-01-15 02:00:00,2021-01-15 00:00:00,LABORABLE
15,1,2021,4,40,56,96,2021-01-15 03:00:00,2021-01-15 00:00:00,LABORABLE
15,1,2021,5,64,41,105,2021-01-15 04:00:00,2021-01-15 00:00:00,LABORABLE
15,1,2021,6,100,77,177,2021-01-15 05:00:00,2021-01-15 00:00:00,LABORABLE
15,1,2021,7,202,203,405,2021-01-15 06:00:00,2021-01-15 00:00:00,LABORABLE
15,1,2021,8,402,382,784,2021-01-15 07:00:00,2021-01-15 00:00:00,LABORABLE
15,1,2021,9,389,534,923,2021-01-15 08:00:00,2021-01-15 00:00:00,LABORABLE
15,1,2021,10,349,588,937,2021-01-15 09:00:00,2021-01-15 00:00:00,LABORABLE
15,1,2021,11,354,560,914,2021-01-15 10:00:00,2021-01-15 00:00:00,LABORABLE
15,1,2021,12,391,618,1009,2021-01-15 11:00:00,2021-01-15 00:00:00,LABORABLE
15,1,2021,13,375,646,1021,2021-01-15 12:00:00,2021-01-15 00:00:00,LABORABLE
15,1,2021,14,468,685,1153,2021-01-15 13:00:00,2021-01-15 00:00:00,LABORABLE
15,1,2021,15,459,683,1142,2021-01-15 14:00:00,2021-01-15 00:00:00,LABORABLE
15,1,2021,16,405,629,1034,2021-01-15 15:00:00,2021-01-15 00:00:00,LABORABLE
15,1,2021,17,428,653,1081,2021-01-15 16:00:00,2021-01-15 00:00:00,LABORABLE
15,1,2021,18,488,715,1203,2021-01-15 17:00:00,2021-01-15 00:00:00,LABORABLE
15,1,2021,19,457,689,1146,2021-01-15 18:00:00,2021-01-15 00:00:00,LABORABLE
15,1,2021,20,441,709,1150,2021-01-15 19:00:00,2021-01-15 00:00:00,LABORABLE
15,1,2021,21,382,687,1069,2021-01-15 20:00:00,2021-01-15 00:00:00,LABORABLE
15,1,2021,22,325,523,848,2021-01-15 21:00:00,2021-01-15 00:00:00,LABORABLE
15,1,2021,23,243,389,632,2021-01-15 22:00:00,2021-01-15 00:00:00,LABORABLE
15,1,2021,24,174,313,487,2021-01-15 23:00:00,2021-01-15 00:00:00,LABORABLE
16,1,2021,1,127,228,355,2021-01-16 00:00:00,2021-01-16 00:00:00,LABORABLE
16,1,2021,2,73,118,191,2021-01-16 01:00:00,2021-01-16 00:00:00,LABORABLE
16,1,2021,3,55,87,142,2021-01-16 02:00:00,2021-01-16 00:00:00,LABORABLE
16,1,2021,4,46,49,95,2021-01-16 03:00:00,2021-01-16 00:00:00,LABORABLE
16,1,2021,5,59,62,121,2021-01-16 04:00:00,2021-01-16 00:00:00,LABORABLE
16,1,2021,6,77,78,155,2021-01-16 05:00:00,2021-01-16 00:00:00,LABORABLE
16,1,2021,7,148,179,327,2021-01-16 06:00:00,2021-01-16 00:00:00,LABORABLE
16,1,2021,8,209,291,500,2021-01-16 07:00:00,2021-01-16 00:00:00,LABORABLE
16,1,2021,9,276,445,721,2021-01-16 08:00:00,2021-01-16 00:00:00,LABORABLE
16,1,2021,10,320,565,885,2021-01-16 09:00:00,2021-01-16 00:00:00,LABORABLE
16,1,2021,11,393,582,975,2021-01-16 10:00:00,2021-01-16 00:00:00,LABORABLE
16,1,2021,12,415,661,1076,2021-01-16 11:00:00,2021-01-16 00:00:00,LABORABLE
16,1,2021,13,471,652,1123,2021-01-16 12:00:00,2021-01-16 00:00:00,LABORABLE
16,1,2021,14,454,718,1172,2021-01-16 13:00:00,2021-01-16 00:00:00,LABORABLE
16,1,2021,15,482,681,1163,2021-01-16 14:00:00,2021-01-16 00:00:00,LABORABLE
16,1,2021,16,414,608,1022,2021-01-16 15:00:00,2021-01-16 00:00:00,LABORABLE
16,1,2021,17,388,684,1072,2021-01-16 16:00:00,2021-01-16 00:00:00,LABORABLE
16,1,2021,18,390,677,1067,2021-01-16 17:00:00,2021-01-16 00:00:00,LABORABLE
16,1,2021,19,430,709,1139,2021-01-16 18:00:00,2021-01-16 00:00:00,LABORABLE
16,1,2021,20,425,728,1153,2021-01-16 19:00:00,2021-01-16 00:00:00,LABORABLE
16,1,2021,21,350,674,1024,2021-01-16 20:00:00,2021-01-16 00:00:00,LABORABLE
16,1,2021,22,369,581,950,2021-01-16 21:00:00,2021-01-16 00:00:00,LABORABLE
16,1,2021,23,292,419,711,2021-01-16 22:00:00,2021-01-16 00:00:00,LABORABLE
16,1,2021,24,256,299,555,2021-01-16 23:00:00,2021-01-16 00:00:00,LABORABLE
17,1,2021,1,154,245,399,2021-01-17 00:00:00,2021-01-17 00:00:00,LABORABLE
17,1,2021,2,87,145,232,2021-01-17 01:00:00,2021-01-17 00:00:00,LABORABLE
17,1,2021,3,66,86,152,2021-01-17 02:00:00,2021-01-17 00:00:00,LABORABLE
17,1,2021,4,44,55,99,2021-01-17 03:00:00,2021-01-17 00:00:00,LABORABLE
17,1,2021,5,39,67,106,2021-01-17 04:00:00,2021-01-17 00:00:00,LABORABLE
17,1,2021,6,50,68,118,2021-01-17 05:00:00,2021-01-17 00:00:00,LABORABLE
17,1,2021,7,86,156,242,2021-01-17 06:00:00,2021-01-17 00:00:00,LABORABLE
17,1,2021,8,135,249,384,2021-01-17 07:00:00,2021-01-17 00:00:00,LABORABLE
17,1,2021,9,141,367,508,2021-01-17 08:00:00,2021-01-17 00:00:00,LABORABLE
17,1,2021,10,208,518,726,2021-01-17 09:00:00,2021-01-17 00:00:00,LABORABLE
17,1,2021,11,281,552,833,2021-01-17 10:00:00,2021-01-17 00:00:00,LABORABLE
17,1,2021,12,368,610,978,2021-01-17 11:00:00,2021-01-17 00:00:00,LABORABLE
17,1,2021,13,460,661,1121,2021-01-17 12:00:00,2021-01-17 00:00:00,LABORABLE
17,1,2021,14,474,642,1116,2021-01-17 13:00:00,2021-01-17 00:00:00,LABORABLE
17,1,2021,15,407,649,1056,2021-01-17 14:00:00,2021-01-17 00:00:00,LABORABLE
17,1,2021,16,308,653,961,2021-01-17 15:00:00,2021-01-17 00:00:00,LABORABLE
17,1,2021,17,334,630,964,2021-01-17 16:00:00,2021-01-17 00:00:00,LABORABLE
17,1,2021,18,452,708,1160,2021-01-17 17:00:00,2021-01-17 00:00:00,LABORABLE
17,1,2021,19,401,729,1130,2021-01-17 18:00:00,2021-01-17 00:00:00,LABORABLE
17,1,2021,20,384,706,1090,2021-01-17 19:00:00,2021-01-17 00:00:00,LABORABLE
17,1,2021,21,370,670,1040,2021-01-17 20:00:00,2021-01-17 00:00:00,LABORABLE
17,1,2021,22,314,531,845,2021-01-17 21:00:00,2021-01-17 00:00:00,LABORABLE
17,1,2021,23,227,408,635,2021-01-17 22:00:00,2021-01-17 00:00:00,LABORABLE
17,1,2021,24,171,311,482,2021-01-17 23:00:00,2021-01-17 00:00:00,LABORABLE
18,1,2021,1,110,238,348,2021-01-18 00:00:00,2021-01-18 00:00:00,LABORABLE
18,1,2021,2,55,142,197,2021-01-18 01:00:00,2021-01-18 00:00:00,LABORABLE
18,1,2021,3,40,83,123,2021-01-18 02:00:00,2021-01-18 00:00:00,LABORABLE
18,1,2021,4,48,47,95,2021-01-18 03:00:00,2021-01-18 00:00:00,LABORABLE
18,1,2021,5,59,70,129,2021-01-18 04:00:00,2021-01-18 00:00:00,LABORABLE
18,1,2021,6,154,128,282,2021-01-18 05:00:00,2021-01-18 00:00:00,LABORABLE
18,1,2021,7,326,277,603,2021-01-18 06:00:00,2021-01-18 00:00:00,LABORABLE
18,1,2021,8,559,468,1027,2021-01-18 07:00:00,2021-01-18 00:00:00,LABORABLE
18,1,2021,9,484,601,1085,2021-01-18 08:00:00,2021-01-18 00:00:00,LABORABLE
18,1,2021,10,429,740,1169,2021-01-18 09:00:00,2021-01-18 00:00:00,LABORABLE
18,1,2021,11,474,633,1107,2021-01-18 10:00:00,2021-01-18 00:00:00,LABORABLE
18,1,2021,12,460,677,1137,2021-01-18 11:00:00,2021-01-18 00:00:00,LABORABLE
18,1,2021,13,566,715,1281,2021-01-18 12:00:00,2021-01-18 00:00:00,LABORABLE
18,1,2021,14,539,743,1282,2021-01-18 13:00:00,2021-01-18 00:00:00,LABORABLE
18,1,2021,15,542,756,1298,2021-01-18 14:00:00,2021-01-18 00:00:00,LABORABLE
18,1,2021,16,485,651,1136,2021-01-18 15:00:00,2021-01-18 00:00:00,LABORABLE
18,1,2021,17,499,766,1265,2021-01-18 16:00:00,2021-01-18 00:00:00,LABORABLE
18,1,2021,18,551,734,1285,2021-01-18 17:00:00,2021-01-18 00:00:00,LABORABLE
18,1,2021,19,561,794,1355,2021-01-18 18:00:00,2021-01-18 00:00:00,LABORABLE
18,1,2021,20,510,742,1252,2021-01-18 19:00:00,2021-01-18 00:00:00,LABORABLE
18,1,2021,21,470,749,1219,2021-01-18 20:00:00,2021-01-18 00:00:00,LABORABLE
18,1,2021,22,387,611,998,2021-01-18 21:00:00,2021-01-18 00:00:00,LABORABLE
18,1,2021,23,299,514,813,2021-01-18 22:00:00,2021-01-18 00:00:00,LABORABLE
18,1,2021,24,120,334,454,2021-01-18 23:00:00,2021-01-18 00:00:00,LABORABLE
19,1,2021,1,39,254,293,2021-01-19 00:00:00,2021-01-19 00:00:00,LABORABLE
19,1,2021,2,45,129,174,2021-01-19 01:00:00,2021-01-19 00:00:00,LABORABLE
19,1,2021,3,27,90,117,2021-01-19 02:00:00,2021-01-19 00:00:00,LABORABLE
19,1,2021,4,43,67,110,2021-01-19 03:00:00,2021-01-19 00:00:00,LABORABLE
19,1,2021,5,64,71,135,2021-01-19 04:00:00,2021-01-19 00:00:00,LABORABLE
19,1,2021,6,143,102,245,2021-01-19 05:00:00,2021-01-19 00:00:00,LABORABLE
19,1,2021,7,334,250,584,2021-01-19 06:00:00,2021-01-19 00:00:00,LABORABLE
19,1,2021,8,554,450,1004,2021-01-19 07:00:00,2021-01-19 00:00:00,LABORABLE
19,1,2021,9,516,474,990,2021-01-19 08:00:00,2021-01-19 00:00:00,LABORABLE
19,1,2021,10,499,639,1138,2021-01-19 09:00:00,2021-01-19 00:00:00,LABORABLE
19,1,2021,11,464,618,1082,2021-01-19 10:00:00,2021-01-19 00:00:00,LABORABLE
19,1,2021,12,523,703,1226,2021-01-19 11:00:00,2021-01-19 00:00:00,LABORABLE
19,1,2021,13,530,730,1260,2021-01-19 12:00:00,2021-01-19 00:00:00,LABORABLE
19,1,2021,14,549,757,1306,2021-01-19 13:00:00,2021-01-19 00:00:00,LABORABLE
19,1,2021,15,580,787,1367,2021-01-19 14:00:00,2021-01-19 00:00:00,LABORABLE
19,1,2021,16,520,738,1258,2021-01-19 15:00:00,2021-01-19 00:00:00,LABORABLE
19,1,2021,17,544,722,1266,2021-01-19 16:00:00,2021-01-19 00:00:00,LABORABLE
19,1,2021,18,562,741,1303,2021-01-19 17:00:00,2021-01-19 00:00:00,LABORABLE
19,1,2021,19,558,778,1336,2021-01-19 18:00:00,2021-01-19 00:00:00,LABORABLE
19,1,2021,20,564,793,1357,2021-01-19 19:00:00,2021-01-19 00:00:00,LABORABLE
19,1,2021,21,478,653,1131,2021-01-19 20:00:00,2021-01-19 00:00:00,LABORABLE
19,1,2021,22,402,632,1034,2021-01-19 21:00:00,2021-01-19 00:00:00,LABORABLE
19,1,2021,23,333,491,824,2021-01-19 22:00:00,2021-01-19 00:00:00,LABORABLE
19,1,2021,24,108,350,458,2021-01-19 23:00:00,2021-01-19 00:00:00,LABORABLE
20,1,2021,1,44,276,320,2021-01-20 00:00:00,2021-01-20 00:00:00,LABORABLE
20,1,2021,2,36,122,158,2021-01-20 01:00:00,2021-01-20 00:00:00,LABORABLE
20,1,2021,3,50,92,142,2021-01-20 02:00:00,2021-01-20 00:00:00,LABORABLE
20,1,2021,4,50,63,113,2021-01-20 03:00:00,2021-01-20 00:00:00,LABORABLE
20,1,2021,5,66,75,141,2021-01-20 04:00:00,2021-01-20 00:00:00,LABORABLE
20,1,2021,6,162,111,273,2021-01-20 05:00:00,2021-01-20 00:00:00,LABORABLE
20,1,2021,7,371,296,667,2021-01-20 06:00:00,2021-01-20 00:00:00,LABORABLE
20,1,2021,8,609,416,1025,2021-01-20 07:00:00,2021-01-20 00:00:00,LABORABLE
20,1,2021,9,621,510,1131,2021-01-20 08:00:00,2021-01-20 00:00:00,LABORABLE
20,1,2021,10,565,634,1199,2021-01-20 09:00:00,2021-01-20 00:00:00,LABORABLE
20,1,2021,11,535,639,1174,2021-01-20 10:00:00,2021-01-20 00:00:00,LABORABLE
20,1,2021,12,526,665,1191,2021-01-20 11:00:00,2021-01-20 00:00:00,LABORABLE
20,1,2021,13,525,816,1341,2021-01-20 12:00:00,2021-01-20 00:00:00,LABORABLE
20,1,2021,14,584,770,1354,2021-01-20 13:00:00,2021-01-20 00:00:00,LABORABLE
20,1,2021,15,608,781,1389,2021-01-20 14:00:00,2021-01-20 00:00:00,LABORABLE
20,1,2021,16,613,747,1360,2021-01-20 15:00:00,2021-01-20 00:00:00,LABORABLE
20,1,2021,17,516,739,1255,2021-01-20 16:00:00,2021-01-20 00:00:00,LABORABLE
20,1,2021,18,579,753,1332,2021-01-20 17:00:00,2021-01-20 00:00:00,LABORABLE
20,1,2021,19,556,743,1299,2021-01-20 18:00:00,2021-01-20 00:00:00,LABORABLE
20,1,2021,20,501,709,1210,2021-01-20 19:00:00,2021-01-20 00:00:00,LABORABLE
20,1,2021,21,494,681,1175,2021-01-20 20:00:00,2021-01-20 00:00:00,LABORABLE
20,1,2021,22,388,546,934,2021-01-20 21:00:00,2021-01-20 00:00:00,LABORABLE
20,1,2021,23,330,427,757,2021-01-20 22:00:00,2021-01-20 00:00:00,LABORABLE
20,1,2021,24,130,286,416,2021-01-20 23:00:00,2021-01-20 00:00:00,LABORABLE
21,1,2021,1,44,172,216,2021-01-21 00:00:00,2021-01-21 00:00:00,LABORABLE
21,1,2021,2,39,82,121,2021-01-21 01:00:00,2021-01-21 00:00:00,LABORABLE
21,1,2021,3,40,76,116,2021-01-21 02:00:00,2021-01-21 00:00:00,LABORABLE
21,1,2021,4,46,38,84,2021-01-21 03:00:00,2021-01-21 00:00:00,LABORABLE
21,1,2021,5,60,62,122,2021-01-21 04:00:00,2021-01-21 00:00:00,LABORABLE
21,1,2021,6,150,129,279,2021-01-21 05:00:00,2021-01-21 00:00:00,LABORABLE
21,1,2021,7,397,339,736,2021-01-21 06:00:00,2021-01-21 00:00:00,LABORABLE
21,1,2021,8,614,537,1151,2021-01-21 07:00:00,2021-01-21 00:00:00,LABORABLE
21,1,2021,9,650,686,1336,2021-01-21 08:00:00,2021-01-21 00:00:00,LABORABLE
21,1,2021,10,660,765,1425,2021-01-21 09:00:00,2021-01-21 00:00:00,LABORABLE
21,1,2021,11,558,712,1270,2021-01-21 10:00:00,2021-01-21 00:00:00,LABORABLE
21,1,2021,12,408,608,1016,2021-01-21 11:00:00,2021-01-21 00:00:00,LABORABLE
21,1,2021,13,649,749,1398,2021-01-21 12:00:00,2021-01-21 00:00:00,LABORABLE
21,1,2021,14,626,856,1482,2021-01-21 13:00:00,2021-01-21 00:00:00,LABORABLE
21,1,2021,15,660,791,1451,2021-01-21 14:00:00,2021-01-21 00:00:00,LABORABLE
21,1,2021,16,607,719,1326,2021-01-21 15:00:00,2021-01-21 00:00:00,LABORABLE
21,1,2021,17,606,808,1414,2021-01-21 16:00:00,2021-01-21 00:00:00,LABORABLE
21,1,2021,18,629,756,1385,2021-01-21 17:00:00,2021-01-21 00:00:00,LABORABLE
21,1,2021,19,673,861,1534,2021-01-21 18:00:00,2021-01-21 00:00:00,LABORABLE
21,1,2021,20,566,847,1413,2021-01-21 19:00:00,2021-01-21 00:00:00,LABORABLE
21,1,2021,21,543,735,1278,2021-01-21 20:00:00,2021-01-21 00:00:00,LABORABLE
21,1,2021,22,433,613,1046,2021-01-21 21:00:00,2021-01-21 00:00:00,LABORABLE
21,1,2021,23,376,440,816,2021-01-21 22:00:00,2021-01-21 00:00:00,LABORABLE
21,1,2021,24,137,240,377,2021-01-21 23:00:00,2021-01-21 00:00:00,LABORABLE
22,1,2021,1,79,157,236,2021-01-22 00:00:00,2021-01-22 00:00:00,LABORABLE
22,1,2021,2,36,82,118,2021-01-22 01:00:00,2021-01-22 00:00:00,LABORABLE
22,1,2021,3,42,69,111,2021-01-22 02:00:00,2021-01-22 00:00:00,LABORABLE
22,1,2021,4,44,42,86,2021-01-22 03:00:00,2021-01-22 00:00:00,LABORABLE
22,1,2021,5,62,48,110,2021-01-22 04:00:00,2021-01-22 00:00:00,LABORABLE
22,1,2021,6,163,109,272,2021-01-22 05:00:00,2021-01-22 00:00:00,LABORABLE
22,1,2021,7,358,304,662,2021-01-22 06:00:00,2021-01-22 00:00:00,LABORABLE
22,1,2021,8,664,553,1217,2021-01-22 07:00:00,2021-01-22 00:00:00,LABORABLE
22,1,2021,9,679,686,1365,2021-01-22 08:00:00,2021-01-22 00:00:00,LABORABLE
22,1,2021,10,635,771,1406,2021-01-22 09:00:00,2021-01-22 00:00:00,LABORABLE
22,1,2021,11,514,720,1234,2021-01-22 10:00:00,2021-01-22 00:00:00,LABORABLE
22,1,2021,12,578,787,1365,2021-01-22 11:00:00,2021-01-22 00:00:00,LABORABLE
22,1,2021,13,649,841,1490,2021-01-22 12:00:00,2021-01-22 00:00:00,LABORABLE
22,1,2021,14,677,821,1498,2021-01-22 13:00:00,2021-01-22 00:00:00,LABORABLE
22,1,2021,15,635,879,1514,2021-01-22 14:00:00,2021-01-22 00:00:00,LABORABLE
22,1,2021,16,692,704,1396,2021-01-22 15:00:00,2021-01-22 00:00:00,LABORABLE
22,1,2021,17,622,762,1384,2021-01-22 16:00:00,2021-01-22 00:00:00,LABORABLE
22,1,2021,18,672,840,1512,2021-01-22 17:00:00,2021-01-22 00:00:00,LABORABLE
22,1,2021,19,685,886,1571,2021-01-22 18:00:00,2021-01-22 00:00:00,LABORABLE
22,1,2021,20,677,857,1534,2021-01-22 19:00:00,2021-01-22 00:00:00,LABORABLE
22,1,2021,21,594,806,1400,2021-01-22 20:00:00,2021-01-22 00:00:00,LABORABLE
22,1,2021,22,463,624,1087,2021-01-22 21:00:00,2021-01-22 00:00:00,LABORABLE
22,1,2021,23,523,567,1090,2021-01-22 22:00:00,2021-01-22 00:00:00,LABORABLE
22,1,2021,24,216,335,551,2021-01-22 23:00:00,2021-01-22 00:00:00,LABORABLE
23,1,2021,1,96,188,284,2021-01-23 00:00:00,2021-01-23 00:00:00,LABORABLE
23,1,2021,2,47,80,127,2021-01-23 01:00:00,2021-01-23 00:00:00,LABORABLE
23,1,2021,3,60,81,141,2021-01-23 02:00:00,2021-01-23 00:00:00,LABORABLE
23,1,2021,4,51,45,96,2021-01-23 03:00:00,2021-01-23 00:00:00,LABORABLE
23,1,2021,5,45,46,91,2021-01-23 04:00:00,2021-01-23 00:00:00,LABORABLE
23,1,2021,6,94,90,184,2021-01-23 05:00:00,2021-01-23 00:00:00,LABORABLE
23,1,2021,7,152,174,326,2021-01-23 06:00:00,2021-01-23 00:00:00,LABORABLE
23,1,2021,8,271,267,538,2021-01-23 07:00:00,2021-01-23 00:00:00,LABORABLE
23,1,2021,9,286,379,665,2021-01-23 08:00:00,2021-01-23 00:00:00,LABORABLE
23,1,2021,10,387,524,911,2021-01-23 09:00:00,2021-01-23 00:00:00,LABORABLE
23,1,2021,11,518,610,1128,2021-01-23 10:00:00,2021-01-23 00:00:00,LABORABLE
23,1,2021,12,571,669,1240,2021-01-23 11:00:00,2021-01-23 00:00:00,LABORABLE
23,1,2021,13,655,675,1330,2021-01-23 12:00:00,2021-01-23 00:00:00,LABORABLE
23,1,2021,14,630,732,1362,2021-01-23 13:00:00,2021-01-23 00:00:00,LABORABLE
23,1,2021,15,670,718,1388,2021-01-23 14:00:00,2021-01-23 00:00:00,LABORABLE
23,1,2021,16,472,585,1057,2021-01-23 15:00:00,2021-01-23 00:00:00,LABORABLE
23,1,2021,17,465,647,1112,2021-01-23 16:00:00,2021-01-23 00:00:00,LABORABLE
23,1,2021,18,554,669,1223,2021-01-23 17:00:00,2021-01-23 00:00:00,LABORABLE
23,1,2021,19,593,640,1233,2021-01-23 18:00:00,2021-01-23 00:00:00,LABORABLE
23,1,2021,20,572,736,1308,2021-01-23 19:00:00,2021-01-23 00:00:00,LABORABLE
23,1,2021,21,447,630,1077,2021-01-23 20:00:00,2021-01-23 00:00:00,LABORABLE
23,1,2021,22,438,529,967,2021-01-23 21:00:00,2021-01-23 00:00:00,LABORABLE
23,1,2021,23,522,470,992,2021-01-23 22:00:00,2021-01-23 00:00:00,LABORABLE
23,1,2021,24,221,245,466,2021-01-23 23:00:00,2021-01-23 00:00:00,LABORABLE
24,1,2021,1,99,130,229,2021-01-24 00:00:00,2021-01-24 00:00:00,LABORABLE
24,1,2021,2,58,69,127,2021-01-24 01:00:00,2021-01-24 00:00:00,LABORABLE
24,1,2021,3,49,58,107,2021-01-24 02:00:00,2021-01-24 00:00:00,LABORABLE
24,1,2021,4,30,37,67,2021-01-24 03:00:00,2021-01-24 00:00:00,LABORABLE
24,1,2021,5,27,46,73,2021-01-24 04:00:00,2021-01-24 00:00:00,LABORABLE
24,1,2021,6,46,68,114,2021-01-24 05:00:00,2021-01-24 00:00:00,LABORABLE
24,1,2021,7,96,149,245,2021-01-24 06:00:00,2021-01-24 00:00:00,LABORABLE
24,1,2021,8,115,216,331,2021-01-24 07:00:00,2021-01-24 00:00:00,LABORABLE
24,1,2021,9,177,314,491,2021-01-24 08:00:00,2021-01-24 00:00:00,LABORABLE
24,1,2021,10,285,426,711,2021-01-24 09:00:00,2021-01-24 00:00:00,LABORABLE
24,1,2021,11,404,550,954,2021-01-24 10:00:00,2021-01-24 00:00:00,LABORABLE
24,1,2021,12,507,616,1123,2021-01-24 11:00:00,2021-01-24 00:00:00,LABORABLE
24,1,2021,13,579,688,1267,2021-01-24 12:00:00,2021-01-24 00:00:00,LABORABLE
24,1,2021,14,595,681,1276,2021-01-24 13:00:00,2021-01-24 00:00:00,LABORABLE
24,1,2021,15,550,628,1178,2021-01-24 14:00:00,2021-01-24 00:00:00,LABORABLE
24,1,2021,16,445,580,1025,2021-01-24 15:00:00,2021-01-24 00:00:00,LABORABLE
24,1,2021,17,444,616,1060,2021-01-24 16:00:00,2021-01-24 00:00:00,LABORABLE
24,1,2021,18,455,636,1091,2021-01-24 17:00:00,2021-01-24 00:00:00,LABORABLE
24,1,2021,19,501,738,1239,2021-01-24 18:00:00,2021-01-24 00:00:00,LABORABLE
24,1,2021,20,511,820,1331,2021-01-24 19:00:00,2021-01-24 00:00:00,LABORABLE
24,1,2021,21,442,690,1132,2021-01-24 20:00:00,2021-01-24 00:00:00,LABORABLE
24,1,2021,22,416,556,972,2021-01-24 21:00:00,2021-01-24 00:00:00,LABORABLE
24,1,2021,23,334,442,776,2021-01-24 22:00:00,2021-01-24 00:00:00,LABORABLE
24,1,2021,24,151,240,391,2021-01-24 23:00:00,2021-01-24 00:00:00,LABORABLE
25,1,2021,1,56,161,217,2021-01-25 00:00:00,2021-01-25 00:00:00,LABORABLE
25,1,2021,2,28,89,117,2021-01-25 01:00:00,2021-01-25 00:00:00,LABORABLE
25,1,2021,3,29,64,93,2021-01-25 02:00:00,2021-01-25 00:00:00,LABORABLE
25,1,2021,4,42,27,69,2021-01-25 03:00:00,2021-01-25 00:00:00,LABORABLE
25,1,2021,5,59,44,103,2021-01-25 04:00:00,2021-01-25 00:00:00,LABORABLE
25,1,2021,6,146,136,282,2021-01-25 05:00:00,2021-01-25 00:00:00,LABORABLE
25,1,2021,7,390,332,722,2021-01-25 06:00:00,2021-01-25 00:00:00,LABORABLE
25,1,2021,8,634,565,1199,2021-01-25 07:00:00,2021-01-25 00:00:00,LABORABLE
25,1,2021,9,719,629,1348,2021-01-25 08:00:00,2021-01-25 00:00:00,LABORABLE
25,1,2021,10,650,808,1458,2021-01-25 09:00:00,2021-01-25 00:00:00,LABORABLE
25,1,2021,11,575,733,1308,2021-01-25 10:00:00,2021-01-25 00:00:00,LABORABLE
25,1,2021,12,620,735,1355,2021-01-25 11:00:00,2021-01-25 00:00:00,LABORABLE
25,1,2021,13,646,771,1417,2021-01-25 12:00:00,2021-01-25 00:00:00,LABORABLE
25,1,2021,14,641,786,1427,2021-01-25 13:00:00,2021-01-25 00:00:00,LABORABLE
25,1,2021,15,662,769,1431,2021-01-25 14:00:00,2021-01-25 00:00:00,LABORABLE
25,1,2021,16,690,650,1340,2021-01-25 15:00:00,2021-01-25 00:00:00,LABORABLE
25,1,2021,17,639,771,1410,2021-01-25 16:00:00,2021-01-25 00:00:00,LABORABLE
25,1,2021,18,669,738,1407,2021-01-25 17:00:00,2021-01-25 00:00:00,LABORABLE
25,1,2021,19,677,717,1394,2021-01-25 18:00:00,2021-01-25 00:00:00,LABORABLE
25,1,2021,20,579,762,1341,2021-01-25 19:00:00,2021-01-25 00:00:00,LABORABLE
25,1,2021,21,536,666,1202,2021-01-25 20:00:00,2021-01-25 00:00:00,LABORABLE
25,1,2021,22,494,500,994,2021-01-25 21:00:00,2021-01-25 00:00:00,LABORABLE
25,1,2021,23,161,297,458,2021-01-25 22:00:00,2021-01-25 00:00:00,LABORABLE
25,1,2021,24,70,182,252,2021-01-25 23:00:00,2021-01-25 00:00:00,LABORABLE
26,1,2021,1,36,146,182,2021-01-26 00:00:00,2021-01-26 00:00:00,LABORABLE
26,1,2021,2,40,78,118,2021-01-26 01:00:00,2021-01-26 00:00:00,LABORABLE
26,1,2021,3,27,60,87,2021-01-26 02:00:00,2021-01-26 00:00:00,LABORABLE
26,1,2021,4,47,44,91,2021-01-26 03:00:00,2021-01-26 00:00:00,LABORABLE
26,1,2021,5,62,62,124,2021-01-26 04:00:00,2021-01-26 00:00:00,LABORABLE
26,1,2021,6,150,102,252,2021-01-26 05:00:00,2021-01-26 00:00:00,LABORABLE
26,1,2021,7,368,259,627,2021-01-26 06:00:00,2021-01-26 00:00:00,LABORABLE
26,1,2021,8,650,469,1119,2021-01-26 07:00:00,2021-01-26 00:00:00,LABORABLE
26,1,2021,9,685,509,1194,2021-01-26 08:00:00,2021-01-26 00:00:00,LABORABLE
26,1,2021,10,612,625,1237,2021-01-26 09:00:00,2021-01-26 00:00:00,LABORABLE
26,1,2021,11,438,435,873,2021-01-26 10:00:00,2021-01-26 00:00:00,LABORABLE
26,1,2021,12,579,620,1199,2021-01-26 11:00:00,2021-01-26 00:00:00,LABORABLE
26,1,2021,13,594,704,1298,2021-01-26 12:00:00,2021-01-26 00:00:00,LABORABLE
26,1,2021,14,646,621,1267,2021-01-26 13:00:00,2021-01-26 00:00:00,LABORABLE
26,1,2021,15,677,774,1451,2021-01-26 14:00:00,2021-01-26 00:00:00,LABORABLE
26,1,2021,16,626,666,1292,2021-01-26 15:00:00,2021-01-26 00:00:00,LABORABLE
26,1,2021,17,595,689,1284,2021-01-26 16:00:00,2021-01-26 00:00:00,LABORABLE
26,1,2021,18,690,623,1313,2021-01-26 17:00:00,2021-01-26 00:00:00,LABORABLE
26,1,2021,19,685,658,1343,2021-01-26 18:00:00,2021-01-26 00:00:00,LABORABLE
26,1,2021,20,614,711,1325,2021-01-26 19:00:00,2021-01-26 00:00:00,LABORABLE
26,1,2021,21,555,624,1179,2021-01-26 20:00:00,2021-01-26 00:00:00,LABORABLE
26,1,2021,22,524,490,1014,2021-01-26 21:00:00,2021-01-26 00:00:00,LABORABLE
26,1,2021,23,208,271,479,2021-01-26 22:00:00,2021-01-26 00:00:00,LABORABLE
26,1,2021,24,86,216,302,2021-01-26 23:00:00,2021-01-26 00:00:00,LABORABLE
27,1,2021,1,38,125,163,2021-01-27 00:00:00,2021-01-27 00:00:00,LABORABLE
27,1,2021,2,38,108,146,2021-01-27 01:00:00,2021-01-27 00:00:00,LABORABLE
27,1,2021,3,33,62,95,2021-01-27 02:00:00,2021-01-27 00:00:00,LABORABLE
27,1,2021,4,46,38,84,2021-01-27 03:00:00,2021-01-27 00:00:00,LABORABLE
27,1,2021,5,62,68,130,2021-01-27 04:00:00,2021-01-27 00:00:00,LABORABLE
27,1,2021,6,151,105,256,2021-01-27 05:00:00,2021-01-27 00:00:00,LABORABLE
27,1,2021,7,349,259,608,2021-01-27 06:00:00,2021-01-27 00:00:00,LABORABLE
27,1,2021,8,659,446,1105,2021-01-27 07:00:00,2021-01-27 00:00:00,LABORABLE
27,1,2021,9,697,471,1168,2021-01-27 08:00:00,2021-01-27 00:00:00,LABORABLE
27,1,2021,10,641,591,1232,2021-01-27 09:00:00,2021-01-27 00:00:00,LABORABLE
27,1,2021,11,612,556,1168,2021-01-27 10:00:00,2021-01-27 00:00:00,LABORABLE
27,1,2021,12,590,631,1221,2021-01-27 11:00:00,2021-01-27 00:00:00,LABORABLE
27,1,2021,13,580,704,1284,2021-01-27 12:00:00,2021-01-27 00:00:00,LABORABLE
27,1,2021,14,646,718,1364,2021-01-27 13:00:00,2021-01-27 00:00:00,LABORABLE
27,1,2021,15,662,651,1313,2021-01-27 14:00:00,2021-01-27 00:00:00,LABORABLE
27,1,2021,16,655,631,1286,2021-01-27 15:00:00,2021-01-27 00:00:00,LABORABLE
27,1,2021,17,635,678,1313,2021-01-27 16:00:00,2021-01-27 00:00:00,LABORABLE
27,1,2021,18,652,640,1292,2021-01-27 17:00:00,2021-01-27 00:00:00,LABORABLE
27,1,2021,19,671,620,1291,2021-01-27 18:00:00,2021-01-27 00:00:00,LABORABLE
27,1,2021,20,626,602,1228,2021-01-27 19:00:00,2021-01-27 00:00:00,LABORABLE
27,1,2021,21,567,589,1156,2021-01-27 20:00:00,2021-01-27 00:00:00,LABORABLE
27,1,2021,22,510,478,988,2021-01-27 21:00:00,2021-01-27 00:00:00,LABORABLE
27,1,2021,23,197,259,456,2021-01-27 22:00:00,2021-01-27 00:00:00,LABORABLE
27,1,2021,24,119,176,295,2021-01-27 23:00:00,2021-01-27 00:00:00,LABORABLE
28,1,2021,1,53,135,188,2021-01-28 00:00:00,2021-01-28 00:00:00,LABORABLE
28,1,2021,2,38,60,98,2021-01-28 01:00:00,2021-01-28 00:00:00,LABORABLE
28,1,2021,3,36,65,101,2021-01-28 02:00:00,2021-01-28 00:00:00,LABORABLE
28,1,2021,4,48,34,82,2021-01-28 03:00:00,2021-01-28 00:00:00,LABORABLE
28,1,2021,5,67,66,133,2021-01-28 04:00:00,2021-01-28 00:00:00,LABORABLE
28,1,2021,6,147,102,249,2021-01-28 05:00:00,2021-01-28 00:00:00,LABORABLE
28,1,2021,7,389,295,684,2021-01-28 06:00:00,2021-01-28 00:00:00,LABORABLE
28,1,2021,8,665,461,1126,2021-01-28 07:00:00,2021-01-28 00:00:00,LABORABLE
28,1,2021,9,713,608,1321,2021-01-28 08:00:00,2021-01-28 00:00:00,LABORABLE
28,1,2021,10,693,707,1400,2021-01-28 09:00:00,2021-01-28 00:00:00,LABORABLE
28,1,2021,11,510,555,1065,2021-01-28 10:00:00,2021-01-28 00:00:00,LABORABLE
28,1,2021,12,602,612,1214,2021-01-28 11:00:00,2021-01-28 00:00:00,LABORABLE
28,1,2021,13,610,676,1286,2021-01-28 12:00:00,2021-01-28 00:00:00,LABORABLE
28,1,2021,14,652,739,1391,2021-01-28 13:00:00,2021-01-28 00:00:00,LABORABLE
28,1,2021,15,664,630,1294,2021-01-28 14:00:00,2021-01-28 00:00:00,LABORABLE
28,1,2021,16,632,605,1237,2021-01-28 15:00:00,2021-01-28 00:00:00,LABORABLE
28,1,2021,17,664,626,1290,2021-01-28 16:00:00,2021-01-28 00:00:00,LABORABLE
28,1,2021,18,677,646,1323,2021-01-28 17:00:00,2021-01-28 00:00:00,LABORABLE
28,1,2021,19,593,599,1192,2021-01-28 18:00:00,2021-01-28 00:00:00,LABORABLE
28,1,2021,20,611,613,1224,2021-01-28 19:00:00,2021-01-28 00:00:00,LABORABLE
28,1,2021,21,601,657,1258,2021-01-28 20:00:00,2021-01-28 00:00:00,LABORABLE
28,1,2021,22,583,547,1130,2021-01-28 21:00:00,2021-01-28 00:00:00,LABORABLE
28,1,2021,23,198,337,535,2021-01-28 22:00:00,2021-01-28 00:00:00,LABORABLE
28,1,2021,24,73,142,215,2021-01-28 23:00:00,2021-01-28 00:00:00,LABORABLE
29,1,2021,1,43,84,127,2021-01-29 00:00:00,2021-01-29 00:00:00,LABORABLE
29,1,2021,2,34,90,124,2021-01-29 01:00:00,2021-01-29 00:00:00,LABORABLE
29,1,2021,3,37,40,77,2021-01-29 02:00:00,2021-01-29 00:00:00,LABORABLE
29,1,2021,4,46,37,83,2021-01-29 03:00:00,2021-01-29 00:00:00,LABORABLE
29,1,2021,5,62,48,110,2021-01-29 04:00:00,2021-01-29 00:00:00,LABORABLE
29,1,2021,6,163,108,271,2021-01-29 05:00:00,2021-01-29 00:00:00,LABORABLE
29,1,2021,7,388,285,673,2021-01-29 06:00:00,2021-01-29 00:00:00,LABORABLE
29,1,2021,8,716,514,1230,2021-01-29 07:00:00,2021-01-29 00:00:00,LABORABLE
29,1,2021,9,690,593,1283,2021-01-29 08:00:00,2021-01-29 00:00:00,LABORABLE
29,1,2021,10,671,718,1389,2021-01-29 09:00:00,2021-01-29 00:00:00,LABORABLE
29,1,2021,11,592,641,1233,2021-01-29 10:00:00,2021-01-29 00:00:00,LABORABLE
29,1,2021,12,593,665,1258,2021-01-29 11:00:00,2021-01-29 00:00:00,LABORABLE
29,1,2021,13,642,709,1351,2021-01-29 12:00:00,2021-01-29 00:00:00,LABORABLE
29,1,2021,14,675,683,1358,2021-01-29 13:00:00,2021-01-29 00:00:00,LABORABLE
29,1,2021,15,729,755,1484,2021-01-29 14:00:00,2021-01-29 00:00:00,LABORABLE
29,1,2021,16,685,646,1331,2021-01-29 15:00:00,2021-01-29 00:00:00,LABORABLE
29,1,2021,17,623,703,1326,2021-01-29 16:00:00,2021-01-29 00:00:00,LABORABLE
29,1,2021,18,669,652,1321,2021-01-29 17:00:00,2021-01-29 00:00:00,LABORABLE
29,1,2021,19,733,691,1424,2021-01-29 18:00:00,2021-01-29 00:00:00,LABORABLE
29,1,2021,20,637,729,1366,2021-01-29 19:00:00,2021-01-29 00:00:00,LABORABLE
29,1,2021,21,635,754,1389,2021-01-29 20:00:00,2021-01-29 00:00:00,LABORABLE
29,1,2021,22,697,699,1396,2021-01-29 21:00:00,2021-01-29 00:00:00,LABORABLE
29,1,2021,23,294,411,705,2021-01-29 22:00:00,2021-01-29 00:00:00,LABORABLE
29,1,2021,24,103,218,321,2021-01-29 23:00:00,2021-01-29 00:00:00,LABORABLE
30,1,2021,1,76,129,205,2021-01-30 00:00:00,2021-01-30 00:00:00,LABORABLE
30,1,2021,2,51,85,136,2021-01-30 01:00:00,2021-01-30 00:00:00,LABORABLE
30,1,2021,3,31,71,102,2021-01-30 02:00:00,2021-01-30 00:00:00,LABORABLE
30,1,2021,4,43,51,94,2021-01-30 03:00:00,2021-01-30 00:00:00,LABORABLE
30,1,2021,5,54,47,101,2021-01-30 04:00:00,2021-01-30 00:00:00,LABORABLE
30,1,2021,6,89,73,162,2021-01-30 05:00:00,2021-01-30 00:00:00,LABORABLE
30,1,2021,7,167,162,329,2021-01-30 06:00:00,2021-01-30 00:00:00,LABORABLE
30,1,2021,8,247,254,501,2021-01-30 07:00:00,2021-01-30 00:00:00,LABORABLE
30,1,2021,9,366,406,772,2021-01-30 08:00:00,2021-01-30 00:00:00,LABORABLE
30,1,2021,10,401,524,925,2021-01-30 09:00:00,2021-01-30 00:00:00,LABORABLE
30,1,2021,11,602,629,1231,2021-01-30 10:00:00,2021-01-30 00:00:00,LABORABLE
30,1,2021,12,626,671,1297,2021-01-30 11:00:00,2021-01-30 00:00:00,LABORABLE
30,1,2021,13,670,690,1360,2021-01-30 12:00:00,2021-01-30 00:00:00,LABORABLE
30,1,2021,14,674,749,1423,2021-01-30 13:00:00,2021-01-30 00:00:00,LABORABLE
30,1,2021,15,684,667,1351,2021-01-30 14:00:00,2021-01-30 00:00:00,LABORABLE
30,1,2021,16,586,608,1194,2021-01-30 15:00:00,2021-01-30 00:00:00,LABORABLE
30,1,2021,17,548,649,1197,2021-01-30 16:00:00,2021-01-30 00:00:00,LABORABLE
30,1,2021,18,618,605,1223,2021-01-30 17:00:00,2021-01-30 00:00:00,LABORABLE
30,1,2021,19,602,654,1256,2021-01-30 18:00:00,2021-01-30 00:00:00,LABORABLE
30,1,2021,20,554,694,1248,2021-01-30 19:00:00,2021-01-30 00:00:00,LABORABLE
30,1,2021,21,487,687,1174,2021-01-30 20:00:00,2021-01-30 00:00:00,LABORABLE
30,1,2021,22,730,651,1381,2021-01-30 21:00:00,2021-01-30 00:00:00,LABORABLE
30,1,2021,23,292,364,656,2021-01-30 22:00:00,2021-01-30 00:00:00,LABORABLE
30,1,2021,24,114,173,287,2021-01-30 23:00:00,2021-01-30 00:00:00,LABORABLE
31,1,2021,1,49,111,160,2021-01-31 00:00:00,2021-01-31 00:00:00,LABORABLE
31,1,2021,2,49,76,125,2021-01-31 01:00:00,2021-01-31 00:00:00,LABORABLE
31,1,2021,3,46,55,101,2021-01-31 02:00:00,2021-01-31 00:00:00,LABORABLE
31,1,2021,4,34,42,76,2021-01-31 03:00:00,2021-01-31 00:00:00,LABORABLE
31,1,2021,5,28,52,80,2021-01-31 04:00:00,2021-01-31 00:00:00,LABORABLE
31,1,2021,6,40,63,103,2021-01-31 05:00:00,2021-01-31 00:00:00,LABORABLE
31,1,2021,7,80,148,228,2021-01-31 06:00:00,2021-01-31 00:00:00,LABORABLE
31,1,2021,8,140,213,353,2021-01-31 07:00:00,2021-01-31 00:00:00,LABORABLE
31,1,2021,9,177,350,527,2021-01-31 08:00:00,2021-01-31 00:00:00,LABORABLE
31,1,2021,10,322,452,774,2021-01-31 09:00:00,2021-01-31 00:00:00,LABORABLE
31,1,2021,11,442,557,999,2021-01-31 10:00:00,2021-01-31 00:00:00,LABORABLE
31,1,2021,12,558,610,1168,2021-01-31 11:00:00,2021-01-31 00:00:00,LABORABLE
31,1,2021,13,584,731,1315,2021-01-31 12:00:00,2021-01-31 00:00:00,LABORABLE
31,1,2021,14,570,687,1257,2021-01-31 13:00:00,2021-01-31 00:00:00,LABORABLE
31,1,2021,15,541,679,1220,2021-01-31 14:00:00,2021-01-31 00:00:00,LABORABLE
31,1,2021,16,434,619,1053,2021-01-31 15:00:00,2021-01-31 00:00:00,LABORABLE
31,1,2021,17,476,615,1091,2021-01-31 16:00:00,2021-01-31 00:00:00,LABORABLE
31,1,2021,18,444,630,1074,2021-01-31 17:00:00,2021-01-31 00:00:00,LABORABLE
31,1,2021,19,473,826,1299,2021-01-31 18:00:00,2021-01-31 00:00:00,LABORABLE
31,1,2021,20,531,727,1258,2021-01-31 19:00:00,2021-01-31 00:00:00,LABORABLE
31,1,2021,21,460,735,1195,2021-01-31 20:00:00,2021-01-31 00:00:00,LABORABLE
31,1,2021,22,482,624,1106,2021-01-31 21:00:00,2021-01-31 00:00:00,LABORABLE
31,1,2021,23,218,369,587,2021-01-31 22:00:00,2021-01-31 00:00:00,LABORABLE
31,1,2021,24,94,232,326,2021-01-31 23:00:00,2021-01-31 00:00:00,LABORABLE
1,2,2021,1,32,92,124,2021-02-01 00:00:00,2021-01-02 00:00:00,LABORABLE
1,2,2021,2,32,41,73,2021-02-01 01:00:00,2021-01-02 00:00:00,LABORABLE
1,2,2021,3,45,40,85,2021-02-01 02:00:00,2021-01-02 00:00:00,LABORABLE
1,2,2021,4,47,30,77,2021-02-01 03:00:00,2021-01-02 00:00:00,LABORABLE
1,2,2021,5,62,41,103,2021-02-01 04:00:00,2021-01-02 00:00:00,LABORABLE
1,2,2021,6,140,114,254,2021-02-01 05:00:00,2021-01-02 00:00:00,LABORABLE
1,2,2021,7,389,298,687,2021-02-01 06:00:00,2021-01-02 00:00:00,LABORABLE
1,2,2021,8,659,575,1234,2021-02-01 07:00:00,2021-01-02 00:00:00,LABORABLE
1,2,2021,9,717,633,1350,2021-02-01 08:00:00,2021-01-02 00:00:00,LABORABLE
1,2,2021,10,650,683,1333,2021-02-01 09:00:00,2021-01-02 00:00:00,LABORABLE
1,2,2021,11,608,680,1288,2021-02-01 10:00:00,2021-01-02 00:00:00,LABORABLE
1,2,2021,12,589,711,1300,2021-02-01 11:00:00,2021-01-02 00:00:00,LABORABLE
1,2,2021,13,588,734,1322,2021-02-01 12:00:00,2021-01-02 00:00:00,LABORABLE
1,2,2021,14,669,774,1443,2021-02-01 13:00:00,2021-01-02 00:00:00,LABORABLE
1,2,2021,15,690,716,1406,2021-02-01 14:00:00,2021-01-02 00:00:00,LABORABLE
1,2,2021,16,676,654,1330,2021-02-01 15:00:00,2021-01-02 00:00:00,LABORABLE
1,2,2021,17,638,700,1338,2021-02-01 16:00:00,2021-01-02 00:00:00,LABORABLE
1,2,2021,18,663,754,1417,2021-02-01 17:00:00,2021-01-02 00:00:00,LABORABLE
1,2,2021,19,704,747,1451,2021-02-01 18:00:00,2021-01-02 00:00:00,LABORABLE
1,2,2021,20,658,799,1457,2021-02-01 19:00:00,2021-01-02 00:00:00,LABORABLE
1,2,2021,21,546,683,1229,2021-02-01 20:00:00,2021-01-02 00:00:00,LABORABLE
1,2,2021,22,523,561,1084,2021-02-01 21:00:00,2021-01-02 00:00:00,LABORABLE
1,2,2021,23,181,277,458,2021-02-01 22:00:00,2021-01-02 00:00:00,LABORABLE
1,2,2021,24,86,142,228,2021-02-01 23:00:00,2021-01-02 00:00:00,LABORABLE
2,2,2021,1,49,47,96,2021-02-02 00:00:00,2021-02-02 00:00:00,LABORABLE
2,2,2021,2,35,42,77,2021-02-02 01:00:00,2021-02-02 00:00:00,LABORABLE
2,2,2021,3,28,48,76,2021-02-02 02:00:00,2021-02-02 00:00:00,LABORABLE
2,2,2021,4,38,35,73,2021-02-02 03:00:00,2021-02-02 00:00:00,LABORABLE
2,2,2021,5,66,61,127,2021-02-02 04:00:00,2021-02-02 00:00:00,LABORABLE
2,2,2021,6,160,88,248,2021-02-02 05:00:00,2021-02-02 00:00:00,LABORABLE
2,2,2021,7,396,289,685,2021-02-02 06:00:00,2021-02-02 00:00:00,LABORABLE
2,2,2021,8,656,596,1252,2021-02-02 07:00:00,2021-02-02 00:00:00,LABORABLE
2,2,2021,9,682,693,1375,2021-02-02 08:00:00,2021-02-02 00:00:00,LABORABLE
2,2,2021,10,699,719,1418,2021-02-02 09:00:00,2021-02-02 00:00:00,LABORABLE
2,2,2021,11,539,648,1187,2021-02-02 10:00:00,2021-02-02 00:00:00,LABORABLE
2,2,2021,12,546,857,1403,2021-02-02 11:00:00,2021-02-02 00:00:00,LABORABLE
2,2,2021,13,593,710,1303,2021-02-02 12:00:00,2021-02-02 00:00:00,LABORABLE
2,2,2021,14,666,734,1400,2021-02-02 13:00:00,2021-02-02 00:00:00,LABORABLE
2,2,2021,15,668,728,1396,2021-02-02 14:00:00,2021-02-02 00:00:00,LABORABLE
2,2,2021,16,636,730,1366,2021-02-02 15:00:00,2021-02-02 00:00:00,LABORABLE
2,2,2021,17,574,689,1263,2021-02-02 16:00:00,2021-02-02 00:00:00,LABORABLE
2,2,2021,18,649,737,1386,2021-02-02 17:00:00,2021-02-02 00:00:00,LABORABLE
2,2,2021,19,681,771,1452,2021-02-02 18:00:00,2021-02-02 00:00:00,LABORABLE
2,2,2021,20,642,752,1394,2021-02-02 19:00:00,2021-02-02 00:00:00,LABORABLE
2,2,2021,21,566,664,1230,2021-02-02 20:00:00,2021-02-02 00:00:00,LABORABLE
2,2,2021,22,485,532,1017,2021-02-02 21:00:00,2021-02-02 00:00:00,LABORABLE
2,2,2021,23,205,252,457,2021-02-02 22:00:00,2021-02-02 00:00:00,LABORABLE
2,2,2021,24,89,127,216,2021-02-02 23:00:00,2021-02-02 00:00:00,LABORABLE
3,2,2021,1,47,75,122,2021-02-03 00:00:00,2021-03-02 00:00:00,LABORABLE
3,2,2021,2,27,49,76,2021-02-03 01:00:00,2021-03-02 00:00:00,LABORABLE
3,2,2021,3,39,48,87,2021-02-03 02:00:00,2021-03-02 00:00:00,LABORABLE
3,2,2021,4,46,34,80,2021-02-03 03:00:00,2021-03-02 00:00:00,LABORABLE
3,2,2021,5,60,50,110,2021-02-03 04:00:00,2021-03-02 00:00:00,LABORABLE
3,2,2021,6,144,117,261,2021-02-03 05:00:00,2021-03-02 00:00:00,LABORABLE
3,2,2021,7,381,327,708,2021-02-03 06:00:00,2021-03-02 00:00:00,LABORABLE
3,2,2021,8,693,581,1274,2021-02-03 07:00:00,2021-03-02 00:00:00,LABORABLE
3,2,2021,9,704,681,1385,2021-02-03 08:00:00,2021-03-02 00:00:00,LABORABLE
3,2,2021,10,655,728,1383,2021-02-03 09:00:00,2021-03-02 00:00:00,LABORABLE
3,2,2021,11,598,685,1283,2021-02-03 10:00:00,2021-03-02 00:00:00,LABORABLE
3,2,2021,12,554,709,1263,2021-02-03 11:00:00,2021-03-02 00:00:00,LABORABLE
3,2,2021,13,612,679,1291,2021-02-03 12:00:00,2021-03-02 00:00:00,LABORABLE
3,2,2021,14,554,688,1242,2021-02-03 13:00:00,2021-03-02 00:00:00,LABORABLE
3,2,2021,15,52,293,345,2021-02-03 14:00:00,2021-03-02 00:00:00,LABORABLE
3,2,2021,16,697,625,1322,2021-02-03 15:00:00,2021-03-02 00:00:00,LABORABLE
3,2,2021,17,0,276,276,2021-02-03 16:00:00,2021-03-02 00:00:00,LABORABLE
3,2,2021,18,612,827,1439,2021-02-03 17:00:00,2021-03-02 00:00:00,LABORABLE
3,2,2021,19,673,773,1446,2021-02-03 18:00:00,2021-03-02 00:00:00,LABORABLE
3,2,2021,20,600,726,1326,2021-02-03 19:00:00,2021-03-02 00:00:00,LABORABLE
3,2,2021,21,739,682,1421,2021-02-03 20:00:00,2021-03-02 00:00:00,LABORABLE
3,2,2021,22,573,524,1097,2021-02-03 21:00:00,2021-03-02 00:00:00,LABORABLE
3,2,2021,23,257,305,562,2021-02-03 22:00:00,2021-03-02 00:00:00,LABORABLE
3,2,2021,24,108,131,239,2021-02-03 23:00:00,2021-03-02 00:00:00,LABORABLE
4,2,2021,1,46,60,106,2021-02-04 00:00:00,2021-04-02 00:00:00,LABORABLE
4,2,2021,2,26,40,66,2021-02-04 01:00:00,2021-04-02 00:00:00,LABORABLE
4,2,2021,3,36,46,82,2021-02-04 02:00:00,2021-04-02 00:00:00,LABORABLE
4,2,2021,4,43,30,73,2021-02-04 03:00:00,2021-04-02 00:00:00,LABORABLE
4,2,2021,5,64,45,109,2021-02-04 04:00:00,2021-04-02 00:00:00,LABORABLE
4,2,2021,6,145,120,265,2021-02-04 05:00:00,2021-04-02 00:00:00,LABORABLE
4,2,2021,7,424,322,746,2021-02-04 06:00:00,2021-04-02 00:00:00,LABORABLE
4,2,2021,8,648,558,1206,2021-02-04 07:00:00,2021-04-02 00:00:00,LABORABLE
4,2,2021,9,727,698,1425,2021-02-04 08:00:00,2021-04-02 00:00:00,LABORABLE
4,2,2021,10,681,751,1432,2021-02-04 09:00:00,2021-04-02 00:00:00,LABORABLE
4,2,2021,11,608,682,1290,2021-02-04 10:00:00,2021-04-02 00:00:00,LABORABLE
4,2,2021,12,525,503,1028,2021-02-04 11:00:00,2021-04-02 00:00:00,LABORABLE
4,2,2021,13,648,758,1406,2021-02-04 12:00:00,2021-04-02 00:00:00,LABORABLE
4,2,2021,14,654,802,1456,2021-02-04 13:00:00,2021-04-02 00:00:00,LABORABLE
4,2,2021,15,686,751,1437,2021-02-04 14:00:00,2021-04-02 00:00:00,LABORABLE
4,2,2021,16,658,706,1364,2021-02-04 15:00:00,2021-04-02 00:00:00,LABORABLE
4,2,2021,17,639,721,1360,2021-02-04 16:00:00,2021-04-02 00:00:00,LABORABLE
4,2,2021,18,720,744,1464,2021-02-04 17:00:00,2021-04-02 00:00:00,LABORABLE
4,2,2021,19,710,796,1506,2021-02-04 18:00:00,2021-04-02 00:00:00,LABORABLE
4,2,2021,20,543,756,1299,2021-02-04 19:00:00,2021-04-02 00:00:00,LABORABLE
4,2,2021,21,612,669,1281,2021-02-04 20:00:00,2021-04-02 00:00:00,LABORABLE
4,2,2021,22,585,584,1169,2021-02-04 21:00:00,2021-04-02 00:00:00,LABORABLE
4,2,2021,23,245,263,508,2021-02-04 22:00:00,2021-04-02 00:00:00,LABORABLE
4,2,2021,24,99,159,258,2021-02-04 23:00:00,2021-04-02 00:00:00,LABORABLE
5,2,2021,1,64,77,141,2021-02-05 00:00:00,2021-05-02 00:00:00,LABORABLE
5,2,2021,2,38,45,83,2021-02-05 01:00:00,2021-05-02 00:00:00,LABORABLE
5,2,2021,3,42,58,100,2021-02-05 02:00:00,2021-05-02 00:00:00,LABORABLE
5,2,2021,4,45,32,77,2021-02-05 03:00:00,2021-05-02 00:00:00,LABORABLE
5,2,2021,5,57,56,113,2021-02-05 04:00:00,2021-05-02 00:00:00,LABORABLE
5,2,2021,6,143,106,249,2021-02-05 05:00:00,2021-05-02 00:00:00,LABORABLE
5,2,2021,7,395,304,699,2021-02-05 06:00:00,2021-05-02 00:00:00,LABORABLE
5,2,2021,8,715,587,1302,2021-02-05 07:00:00,2021-05-02 00:00:00,LABORABLE
5,2,2021,9,691,648,1339,2021-02-05 08:00:00,2021-05-02 00:00:00,LABORABLE
5,2,2021,10,640,734,1374,2021-02-05 09:00:00,2021-05-02 00:00:00,LABORABLE
5,2,2021,11,604,693,1297,2021-02-05 10:00:00,2021-05-02 00:00:00,LABORABLE
5,2,2021,12,653,699,1352,2021-02-05 11:00:00,2021-05-02 00:00:00,LABORABLE
5,2,2021,13,652,772,1424,2021-02-05 12:00:00,2021-05-02 00:00:00,LABORABLE
5,2,2021,14,688,797,1485,2021-02-05 13:00:00,2021-05-02 00:00:00,LABORABLE
5,2,2021,15,707,790,1497,2021-02-05 14:00:00,2021-05-02 00:00:00,LABORABLE
5,2,2021,16,670,701,1371,2021-02-05 15:00:00,2021-05-02 00:00:00,LABORABLE
5,2,2021,17,651,713,1364,2021-02-05 16:00:00,2021-05-02 00:00:00,LABORABLE
5,2,2021,18,700,801,1501,2021-02-05 17:00:00,2021-05-02 00:00:00,LABORABLE
5,2,2021,19,694,822,1516,2021-02-05 18:00:00,2021-05-02 00:00:00,LABORABLE
5,2,2021,20,622,783,1405,2021-02-05 19:00:00,2021-05-02 00:00:00,LABORABLE
5,2,2021,21,621,783,1404,2021-02-05 20:00:00,2021-05-02 00:00:00,LABORABLE
5,2,2021,22,720,655,1375,2021-02-05 21:00:00,2021-05-02 00:00:00,LABORABLE
5,2,2021,23,313,424,737,2021-02-05 22:00:00,2021-05-02 00:00:00,LABORABLE
5,2,2021,24,126,227,353,2021-02-05 23:00:00,2021-05-02 00:00:00,LABORABLE
6,2,2021,1,97,133,230,2021-02-06 00:00:00,2021-06-02 00:00:00,LABORABLE
6,2,2021,2,46,69,115,2021-02-06 01:00:00,2021-06-02 00:00:00,LABORABLE
6,2,2021,3,51,60,111,2021-02-06 02:00:00,2021-06-02 00:00:00,LABORABLE
6,2,2021,4,41,42,83,2021-02-06 03:00:00,2021-06-02 00:00:00,LABORABLE
6,2,2021,5,55,51,106,2021-02-06 04:00:00,2021-06-02 00:00:00,LABORABLE
6,2,2021,6,71,71,142,2021-02-06 05:00:00,2021-06-02 00:00:00,LABORABLE
6,2,2021,7,150,143,293,2021-02-06 06:00:00,2021-06-02 00:00:00,LABORABLE
6,2,2021,8,250,287,537,2021-02-06 07:00:00,2021-06-02 00:00:00,LABORABLE
6,2,2021,9,326,361,687,2021-02-06 08:00:00,2021-06-02 00:00:00,LABORABLE
6,2,2021,10,472,527,999,2021-02-06 09:00:00,2021-06-02 00:00:00,LABORABLE
6,2,2021,11,549,590,1139,2021-02-06 10:00:00,2021-06-02 00:00:00,LABORABLE
6,2,2021,12,640,792,1432,2021-02-06 11:00:00,2021-06-02 00:00:00,LABORABLE
6,2,2021,13,654,808,1462,2021-02-06 12:00:00,2021-06-02 00:00:00,LABORABLE
6,2,2021,14,640,844,1484,2021-02-06 13:00:00,2021-06-02 00:00:00,LABORABLE
6,2,2021,15,657,774,1431,2021-02-06 14:00:00,2021-06-02 00:00:00,LABORABLE
6,2,2021,16,518,678,1196,2021-02-06 15:00:00,2021-06-02 00:00:00,LABORABLE
6,2,2021,17,530,682,1212,2021-02-06 16:00:00,2021-06-02 00:00:00,LABORABLE
6,2,2021,18,596,739,1335,2021-02-06 17:00:00,2021-06-02 00:00:00,LABORABLE
6,2,2021,19,615,744,1359,2021-02-06 18:00:00,2021-06-02 00:00:00,LABORABLE
6,2,2021,20,548,697,1245,2021-02-06 19:00:00,2021-06-02 00:00:00,LABORABLE
6,2,2021,21,506,654,1160,2021-02-06 20:00:00,2021-06-02 00:00:00,LABORABLE
6,2,2021,22,652,676,1328,2021-02-06 21:00:00,2021-06-02 00:00:00,LABORABLE
6,2,2021,23,285,419,704,2021-02-06 22:00:00,2021-06-02 00:00:00,LABORABLE
6,2,2021,24,125,235,360,2021-02-06 23:00:00,2021-06-02 00:00:00,LABORABLE
7,2,2021,1,58,103,161,2021-02-07 00:00:00,2021-07-02 00:00:00,LABORABLE
7,2,2021,2,36,58,94,2021-02-07 01:00:00,2021-07-02 00:00:00,LABORABLE
7,2,2021,3,28,53,81,2021-02-07 02:00:00,2021-07-02 00:00:00,LABORABLE
7,2,2021,4,42,51,93,2021-02-07 03:00:00,2021-07-02 00:00:00,LABORABLE
7,2,2021,5,29,35,64,2021-02-07 04:00:00,2021-07-02 00:00:00,LABORABLE
7,2,2021,6,31,45,76,2021-02-07 05:00:00,2021-07-02 00:00:00,LABORABLE
7,2,2021,7,99,114,213,2021-02-07 06:00:00,2021-07-02 00:00:00,LABORABLE
7,2,2021,8,134,150,284,2021-02-07 07:00:00,2021-07-02 00:00:00,LABORABLE
7,2,2021,9,212,230,442,2021-02-07 08:00:00,2021-07-02 00:00:00,LABORABLE
7,2,2021,10,305,380,685,2021-02-07 09:00:00,2021-07-02 00:00:00,LABORABLE
7,2,2021,11,446,506,952,2021-02-07 10:00:00,2021-07-02 00:00:00,LABORABLE
7,2,2021,12,545,624,1169,2021-02-07 11:00:00,2021-07-02 00:00:00,LABORABLE
7,2,2021,13,575,725,1300,2021-02-07 12:00:00,2021-07-02 00:00:00,LABORABLE
7,2,2021,14,582,680,1262,2021-02-07 13:00:00,2021-07-02 00:00:00,LABORABLE
7,2,2021,15,561,707,1268,2021-02-07 14:00:00,2021-07-02 00:00:00,LABORABLE
7,2,2021,16,481,678,1159,2021-02-07 15:00:00,2021-07-02 00:00:00,LABORABLE
7,2,2021,17,448,620,1068,2021-02-07 16:00:00,2021-07-02 00:00:00,LABORABLE
7,2,2021,18,484,672,1156,2021-02-07 17:00:00,2021-07-02 00:00:00,LABORABLE
7,2,2021,19,543,640,1183,2021-02-07 18:00:00,2021-07-02 00:00:00,LABORABLE
7,2,2021,20,508,659,1167,2021-02-07 19:00:00,2021-07-02 00:00:00,LABORABLE
7,2,2021,21,464,550,1014,2021-02-07 20:00:00,2021-07-02 00:00:00,LABORABLE
7,2,2021,22,530,494,1024,2021-02-07 21:00:00,2021-07-02 00:00:00,LABORABLE
7,2,2021,23,206,269,475,2021-02-07 22:00:00,2021-07-02 00:00:00,LABORABLE
7,2,2021,24,95,175,270,2021-02-07 23:00:00,2021-07-02 00:00:00,LABORABLE
8,2,2021,1,49,82,131,2021-02-08 00:00:00,2021-08-02 00:00:00,LABORABLE
8,2,2021,2,39,45,84,2021-02-08 01:00:00,2021-08-02 00:00:00,LABORABLE
8,2,2021,3,44,43,87,2021-02-08 02:00:00,2021-08-02 00:00:00,LABORABLE
8,2,2021,4,39,32,71,2021-02-08 03:00:00,2021-08-02 00:00:00,LABORABLE
8,2,2021,5,57,42,99,2021-02-08 04:00:00,2021-08-02 00:00:00,LABORABLE
8,2,2021,6,139,138,277,2021-02-08 05:00:00,2021-08-02 00:00:00,LABORABLE
8,2,2021,7,408,322,730,2021-02-08 06:00:00,2021-08-02 00:00:00,LABORABLE
8,2,2021,8,693,537,1230,2021-02-08 07:00:00,2021-08-02 00:00:00,LABORABLE
8,2,2021,9,702,632,1334,2021-02-08 08:00:00,2021-08-02 00:00:00,LABORABLE
8,2,2021,10,613,664,1277,2021-02-08 09:00:00,2021-08-02 00:00:00,LABORABLE
8,2,2021,11,569,714,1283,2021-02-08 10:00:00,2021-08-02 00:00:00,LABORABLE
8,2,2021,12,591,725,1316,2021-02-08 11:00:00,2021-08-02 00:00:00,LABORABLE
8,2,2021,13,607,773,1380,2021-02-08 12:00:00,2021-08-02 00:00:00,LABORABLE
8,2,2021,14,637,789,1426,2021-02-08 13:00:00,2021-08-02 00:00:00,LABORABLE
8,2,2021,15,661,757,1418,2021-02-08 14:00:00,2021-08-02 00:00:00,LABORABLE
8,2,2021,16,637,625,1262,2021-02-08 15:00:00,2021-08-02 00:00:00,LABORABLE
8,2,2021,17,611,726,1337,2021-02-08 16:00:00,2021-08-02 00:00:00,LABORABLE
8,2,2021,18,652,766,1418,2021-02-08 17:00:00,2021-08-02 00:00:00,LABORABLE
8,2,2021,19,647,751,1398,2021-02-08 18:00:00,2021-08-02 00:00:00,LABORABLE
8,2,2021,20,589,756,1345,2021-02-08 19:00:00,2021-08-02 00:00:00,LABORABLE
8,2,2021,21,569,638,1207,2021-02-08 20:00:00,2021-08-02 00:00:00,LABORABLE
8,2,2021,22,480,520,1000,2021-02-08 21:00:00,2021-08-02 00:00:00,LABORABLE
8,2,2021,23,187,291,478,2021-02-08 22:00:00,2021-08-02 00:00:00,LABORABLE
8,2,2021,24,80,135,215,2021-02-08 23:00:00,2021-08-02 00:00:00,LABORABLE
9,2,2021,1,42,55,97,2021-02-09 00:00:00,2021-09-02 00:00:00,LABORABLE
9,2,2021,2,40,42,82,2021-02-09 01:00:00,2021-09-02 00:00:00,LABORABLE
9,2,2021,3,33,49,82,2021-02-09 02:00:00,2021-09-02 00:00:00,LABORABLE
9,2,2021,4,39,36,75,2021-02-09 03:00:00,2021-09-02 00:00:00,LABORABLE
9,2,2021,5,58,57,115,2021-02-09 04:00:00,2021-09-02 00:00:00,LABORABLE
9,2,2021,6,160,114,274,2021-02-09 05:00:00,2021-09-02 00:00:00,LABORABLE
9,2,2021,7,410,289,699,2021-02-09 06:00:00,2021-09-02 00:00:00,LABORABLE
9,2,2021,8,667,579,1246,2021-02-09 07:00:00,2021-09-02 00:00:00,LABORABLE
9,2,2021,9,670,723,1393,2021-02-09 08:00:00,2021-09-02 00:00:00,LABORABLE
9,2,2021,10,652,528,1180,2021-02-09 09:00:00,2021-09-02 00:00:00,LABORABLE
9,2,2021,11,535,695,1230,2021-02-09 10:00:00,2021-09-02 00:00:00,LABORABLE
9,2,2021,12,603,708,1311,2021-02-09 11:00:00,2021-09-02 00:00:00,LABORABLE
9,2,2021,13,652,663,1315,2021-02-09 12:00:00,2021-09-02 00:00:00,LABORABLE
9,2,2021,14,634,707,1341,2021-02-09 13:00:00,2021-09-02 00:00:00,LABORABLE
9,2,2021,15,657,768,1425,2021-02-09 14:00:00,2021-09-02 00:00:00,LABORABLE
9,2,2021,16,642,741,1383,2021-02-09 15:00:00,2021-09-02 00:00:00,LABORABLE
9,2,2021,17,638,736,1374,2021-02-09 16:00:00,2021-09-02 00:00:00,LABORABLE
9,2,2021,18,670,731,1401,2021-02-09 17:00:00,2021-09-02 00:00:00,LABORABLE
9,2,2021,19,676,748,1424,2021-02-09 18:00:00,2021-09-02 00:00:00,LABORABLE
9,2,2021,20,650,707,1357,2021-02-09 19:00:00,2021-09-02 00:00:00,LABORABLE
9,2,2021,21,546,678,1224,2021-02-09 20:00:00,2021-09-02 00:00:00,LABORABLE
9,2,2021,22,515,522,1037,2021-02-09 21:00:00,2021-09-02 00:00:00,LABORABLE
9,2,2021,23,243,274,517,2021-02-09 22:00:00,2021-09-02 00:00:00,LABORABLE
9,2,2021,24,92,133,225,2021-02-09 23:00:00,2021-09-02 00:00:00,LABORABLE
10,2,2021,1,50,76,126,2021-02-10 00:00:00,2021-10-02 00:00:00,LABORABLE
10,2,2021,2,36,45,81,2021-02-10 01:00:00,2021-10-02 00:00:00,LABORABLE
10,2,2021,3,35,40,75,2021-02-10 02:00:00,2021-10-02 00:00:00,LABORABLE
10,2,2021,4,40,34,74,2021-02-10 03:00:00,2021-10-02 00:00:00,LABORABLE
10,2,2021,5,65,56,121,2021-02-10 04:00:00,2021-10-02 00:00:00,LABORABLE
10,2,2021,6,140,121,261,2021-02-10 05:00:00,2021-10-02 00:00:00,LABORABLE
10,2,2021,7,406,290,696,2021-02-10 06:00:00,2021-10-02 00:00:00,LABORABLE
10,2,2021,8,654,592,1246,2021-02-10 07:00:00,2021-10-02 00:00:00,LABORABLE
10,2,2021,9,717,652,1369,2021-02-10 08:00:00,2021-10-02 00:00:00,LABORABLE
10,2,2021,10,676,779,1455,2021-02-10 09:00:00,2021-10-02 00:00:00,LABORABLE
10,2,2021,11,577,736,1313,2021-02-10 10:00:00,2021-10-02 00:00:00,LABORABLE
10,2,2021,12,598,675,1273,2021-02-10 11:00:00,2021-10-02 00:00:00,LABORABLE
10,2,2021,13,590,658,1248,2021-02-10 12:00:00,2021-10-02 00:00:00,LABORABLE
10,2,2021,14,637,723,1360,2021-02-10 13:00:00,2021-10-02 00:00:00,LABORABLE
10,2,2021,15,701,748,1449,2021-02-10 14:00:00,2021-10-02 00:00:00,LABORABLE
10,2,2021,16,633,692,1325,2021-02-10 15:00:00,2021-10-02 00:00:00,LABORABLE
10,2,2021,17,622,675,1297,2021-02-10 16:00:00,2021-10-02 00:00:00,LABORABLE
10,2,2021,18,665,764,1429,2021-02-10 17:00:00,2021-10-02 00:00:00,LABORABLE
10,2,2021,19,664,761,1425,2021-02-10 18:00:00,2021-10-02 00:00:00,LABORABLE
10,2,2021,20,615,764,1379,2021-02-10 19:00:00,2021-10-02 00:00:00,LABORABLE
10,2,2021,21,593,678,1271,2021-02-10 20:00:00,2021-10-02 00:00:00,LABORABLE
10,2,2021,22,555,577,1132,2021-02-10 21:00:00,2021-10-02 00:00:00,LABORABLE
10,2,2021,23,258,296,554,2021-02-10 22:00:00,2021-10-02 00:00:00,LABORABLE
10,2,2021,24,108,142,250,2021-02-10 23:00:00,2021-10-02 00:00:00,LABORABLE
11,2,2021,1,55,60,115,2021-02-11 00:00:00,2021-11-02 00:00:00,LABORABLE
11,2,2021,2,29,50,79,2021-02-11 01:00:00,2021-11-02 00:00:00,LABORABLE
11,2,2021,3,30,46,76,2021-02-11 02:00:00,2021-11-02 00:00:00,LABORABLE
11,2,2021,4,40,26,66,2021-02-11 03:00:00,2021-11-02 00:00:00,LABORABLE
11,2,2021,5,53,50,103,2021-02-11 04:00:00,2021-11-02 00:00:00,LABORABLE
11,2,2021,6,137,110,247,2021-02-11 05:00:00,2021-11-02 00:00:00,LABORABLE
11,2,2021,7,428,311,739,2021-02-11 06:00:00,2021-11-02 00:00:00,LABORABLE
11,2,2021,8,685,575,1260,2021-02-11 07:00:00,2021-11-02 00:00:00,LABORABLE
11,2,2021,9,678,671,1349,2021-02-11 08:00:00,2021-11-02 00:00:00,LABORABLE
11,2,2021,10,692,751,1443,2021-02-11 09:00:00,2021-11-02 00:00:00,LABORABLE
11,2,2021,11,611,706,1317,2021-02-11 10:00:00,2021-11-02 00:00:00,LABORABLE
11,2,2021,12,587,544,1131,2021-02-11 11:00:00,2021-11-02 00:00:00,LABORABLE
11,2,2021,13,597,693,1290,2021-02-11 12:00:00,2021-11-02 00:00:00,LABORABLE
11,2,2021,14,654,776,1430,2021-02-11 13:00:00,2021-11-02 00:00:00,LABORABLE
11,2,2021,15,691,764,1455,2021-02-11 14:00:00,2021-11-02 00:00:00,LABORABLE
11,2,2021,16,658,703,1361,2021-02-11 15:00:00,2021-11-02 00:00:00,LABORABLE
11,2,2021,17,617,719,1336,2021-02-11 16:00:00,2021-11-02 00:00:00,LABORABLE
11,2,2021,18,700,745,1445,2021-02-11 17:00:00,2021-11-02 00:00:00,LABORABLE
11,2,2021,19,669,804,1473,2021-02-11 18:00:00,2021-11-02 00:00:00,LABORABLE
11,2,2021,20,553,797,1350,2021-02-11 19:00:00,2021-11-02 00:00:00,LABORABLE
11,2,2021,21,557,706,1263,2021-02-11 20:00:00,2021-11-02 00:00:00,LABORABLE
11,2,2021,22,591,559,1150,2021-02-11 21:00:00,2021-11-02 00:00:00,LABORABLE
11,2,2021,23,256,337,593,2021-02-11 22:00:00,2021-11-02 00:00:00,LABORABLE
11,2,2021,24,100,187,287,2021-02-11 23:00:00,2021-11-02 00:00:00,LABORABLE
12,2,2021,1,57,87,144,2021-02-12 00:00:00,2021-12-02 00:00:00,LABORABLE
12,2,2021,2,44,51,95,2021-02-12 01:00:00,2021-12-02 00:00:00,LABORABLE
12,2,2021,3,35,46,81,2021-02-12 02:00:00,2021-12-02 00:00:00,LABORABLE
12,2,2021,4,37,51,88,2021-02-12 03:00:00,2021-12-02 00:00:00,LABORABLE
12,2,2021,5,59,50,109,2021-02-12 04:00:00,2021-12-02 00:00:00,LABORABLE
12,2,2021,6,162,105,267,2021-02-12 05:00:00,2021-12-02 00:00:00,LABORABLE
12,2,2021,7,406,284,690,2021-02-12 06:00:00,2021-12-02 00:00:00,LABORABLE
12,2,2021,8,624,571,1195,2021-02-12 07:00:00,2021-12-02 00:00:00,LABORABLE
12,2,2021,9,673,744,1417,2021-02-12 08:00:00,2021-12-02 00:00:00,LABORABLE
12,2,2021,10,662,806,1468,2021-02-12 09:00:00,2021-12-02 00:00:00,LABORABLE
12,2,2021,11,592,754,1346,2021-02-12 10:00:00,2021-12-02 00:00:00,LABORABLE
12,2,2021,12,468,662,1130,2021-02-12 11:00:00,2021-12-02 00:00:00,LABORABLE
12,2,2021,13,632,776,1408,2021-02-12 12:00:00,2021-12-02 00:00:00,LABORABLE
12,2,2021,14,658,843,1501,2021-02-12 13:00:00,2021-12-02 00:00:00,LABORABLE
12,2,2021,15,697,887,1584,2021-02-12 14:00:00,2021-12-02 00:00:00,LABORABLE
12,2,2021,16,686,666,1352,2021-02-12 15:00:00,2021-12-02 00:00:00,LABORABLE
12,2,2021,17,633,754,1387,2021-02-12 16:00:00,2021-12-02 00:00:00,LABORABLE
12,2,2021,18,692,791,1483,2021-02-12 17:00:00,2021-12-02 00:00:00,LABORABLE
12,2,2021,19,677,813,1490,2021-02-12 18:00:00,2021-12-02 00:00:00,LABORABLE
12,2,2021,20,689,788,1477,2021-02-12 19:00:00,2021-12-02 00:00:00,LABORABLE
12,2,2021,21,619,822,1441,2021-02-12 20:00:00,2021-12-02 00:00:00,LABORABLE
12,2,2021,22,694,735,1429,2021-02-12 21:00:00,2021-12-02 00:00:00,LABORABLE
12,2,2021,23,287,508,795,2021-02-12 22:00:00,2021-12-02 00:00:00,LABORABLE
12,2,2021,24,137,232,369,2021-02-12 23:00:00,2021-12-02 00:00:00,LABORABLE
13,2,2021,1,79,144,223,2021-02-13 00:00:00,2021-02-13 00:00:00,LABORABLE
13,2,2021,2,50,66,116,2021-02-13 01:00:00,2021-02-13 00:00:00,LABORABLE
13,2,2021,3,44,54,98,2021-02-13 02:00:00,2021-02-13 00:00:00,LABORABLE
13,2,2021,4,46,51,97,2021-02-13 03:00:00,2021-02-13 00:00:00,LABORABLE
13,2,2021,5,51,51,102,2021-02-13 04:00:00,2021-02-13 00:00:00,LABORABLE
13,2,2021,6,82,69,151,2021-02-13 05:00:00,2021-02-13 00:00:00,LABORABLE
13,2,2021,7,179,130,309,2021-02-13 06:00:00,2021-02-13 00:00:00,LABORABLE
13,2,2021,8,270,265,535,2021-02-13 07:00:00,2021-02-13 00:00:00,LABORABLE
13,2,2021,9,382,342,724,2021-02-13 08:00:00,2021-02-13 00:00:00,LABORABLE
13,2,2021,10,469,485,954,2021-02-13 09:00:00,2021-02-13 00:00:00,LABORABLE
13,2,2021,11,538,612,1150,2021-02-13 10:00:00,2021-02-13 00:00:00,LABORABLE
13,2,2021,12,583,815,1398,2021-02-13 11:00:00,2021-02-13 00:00:00,LABORABLE
13,2,2021,13,717,820,1537,2021-02-13 12:00:00,2021-02-13 00:00:00,LABORABLE
13,2,2021,14,665,820,1485,2021-02-13 13:00:00,2021-02-13 00:00:00,LABORABLE
13,2,2021,15,640,775,1415,2021-02-13 14:00:00,2021-02-13 00:00:00,LABORABLE
13,2,2021,16,569,737,1306,2021-02-13 15:00:00,2021-02-13 00:00:00,LABORABLE
13,2,2021,17,531,685,1216,2021-02-13 16:00:00,2021-02-13 00:00:00,LABORABLE
13,2,2021,18,570,744,1314,2021-02-13 17:00:00,2021-02-13 00:00:00,LABORABLE
13,2,2021,19,580,727,1307,2021-02-13 18:00:00,2021-02-13 00:00:00,LABORABLE
13,2,2021,20,589,795,1384,2021-02-13 19:00:00,2021-02-13 00:00:00,LABORABLE
13,2,2021,21,578,713,1291,2021-02-13 20:00:00,2021-02-13 00:00:00,LABORABLE
13,2,2021,22,667,676,1343,2021-02-13 21:00:00,2021-02-13 00:00:00,LABORABLE
13,2,2021,23,355,445,800,2021-02-13 22:00:00,2021-02-13 00:00:00,LABORABLE
13,2,2021,24,132,260,392,2021-02-13 23:00:00,2021-02-13 00:00:00,LABORABLE
14,2,2021,1,75,112,187,2021-02-14 00:00:00,2021-02-14 00:00:00,LABORABLE
14,2,2021,2,46,90,136,2021-02-14 01:00:00,2021-02-14 00:00:00,LABORABLE
14,2,2021,3,48,56,104,2021-02-14 02:00:00,2021-02-14 00:00:00,LABORABLE
14,2,2021,4,27,50,77,2021-02-14 03:00:00,2021-02-14 00:00:00,LABORABLE
14,2,2021,5,25,32,57,2021-02-14 04:00:00,2021-02-14 00:00:00,LABORABLE
14,2,2021,6,39,63,102,2021-02-14 05:00:00,2021-02-14 00:00:00,LABORABLE
14,2,2021,7,105,107,212,2021-02-14 06:00:00,2021-02-14 00:00:00,LABORABLE
14,2,2021,8,156,161,317,2021-02-14 07:00:00,2021-02-14 00:00:00,LABORABLE
14,2,2021,9,212,255,467,2021-02-14 08:00:00,2021-02-14 00:00:00,LABORABLE
14,2,2021,10,307,429,736,2021-02-14 09:00:00,2021-02-14 00:00:00,LABORABLE
14,2,2021,11,488,505,993,2021-02-14 10:00:00,2021-02-14 00:00:00,LABORABLE
14,2,2021,12,568,587,1155,2021-02-14 11:00:00,2021-02-14 00:00:00,LABORABLE
14,2,2021,13,595,736,1331,2021-02-14 12:00:00,2021-02-14 00:00:00,LABORABLE
14,2,2021,14,637,786,1423,2021-02-14 13:00:00,2021-02-14 00:00:00,LABORABLE
14,2,2021,15,594,705,1299,2021-02-14 14:00:00,2021-02-14 00:00:00,LABORABLE
14,2,2021,16,527,714,1241,2021-02-14 15:00:00,2021-02-14 00:00:00,LABORABLE
14,2,2021,17,467,648,1115,2021-02-14 16:00:00,2021-02-14 00:00:00,LABORABLE
14,2,2021,18,493,691,1184,2021-02-14 17:00:00,2021-02-14 00:00:00,LABORABLE
14,2,2021,19,543,851,1394,2021-02-14 18:00:00,2021-02-14 00:00:00,LABORABLE
14,2,2021,20,549,775,1324,2021-02-14 19:00:00,2021-02-14 00:00:00,LABORABLE
14,2,2021,21,504,722,1226,2021-02-14 20:00:00,2021-02-14 00:00:00,LABORABLE
14,2,2021,22,578,537,1115,2021-02-14 21:00:00,2021-02-14 00:00:00,LABORABLE
14,2,2021,23,274,346,620,2021-02-14 22:00:00,2021-02-14 00:00:00,LABORABLE
14,2,2021,24,126,197,323,2021-02-14 23:00:00,2021-02-14 00:00:00,LABORABLE
15,2,2021,1,68,104,172,2021-02-15 00:00:00,2021-02-15 00:00:00,LABORABLE
15,2,2021,2,26,48,74,2021-02-15 01:00:00,2021-02-15 00:00:00,LABORABLE
15,2,2021,3,40,43,83,2021-02-15 02:00:00,2021-02-15 00:00:00,LABORABLE
15,2,2021,4,44,47,91,2021-02-15 03:00:00,2021-02-15 00:00:00,LABORABLE
15,2,2021,5,58,36,94,2021-02-15 04:00:00,2021-02-15 00:00:00,LABORABLE
15,2,2021,6,157,110,267,2021-02-15 05:00:00,2021-02-15 00:00:00,LABORABLE
15,2,2021,7,396,292,688,2021-02-15 06:00:00,2021-02-15 00:00:00,LABORABLE
15,2,2021,8,678,598,1276,2021-02-15 07:00:00,2021-02-15 00:00:00,LABORABLE
15,2,2021,9,667,664,1331,2021-02-15 08:00:00,2021-02-15 00:00:00,LABORABLE
15,2,2021,10,662,679,1341,2021-02-15 09:00:00,2021-02-15 00:00:00,LABORABLE
15,2,2021,11,586,717,1303,2021-02-15 10:00:00,2021-02-15 00:00:00,LABORABLE
15,2,2021,12,594,711,1305,2021-02-15 11:00:00,2021-02-15 00:00:00,LABORABLE
15,2,2021,13,564,650,1214,2021-02-15 12:00:00,2021-02-15 00:00:00,LABORABLE
15,2,2021,14,614,771,1385,2021-02-15 13:00:00,2021-02-15 00:00:00,LABORABLE
15,2,2021,15,677,812,1489,2021-02-15 14:00:00,2021-02-15 00:00:00,LABORABLE
15,2,2021,16,615,669,1284,2021-02-15 15:00:00,2021-02-15 00:00:00,LABORABLE
15,2,2021,17,623,721,1344,2021-02-15 16:00:00,2021-02-15 00:00:00,LABORABLE
15,2,2021,18,498,724,1222,2021-02-15 17:00:00,2021-02-15 00:00:00,LABORABLE
15,2,2021,19,642,750,1392,2021-02-15 18:00:00,2021-02-15 00:00:00,LABORABLE
15,2,2021,20,612,817,1429,2021-02-15 19:00:00,2021-02-15 00:00:00,LABORABLE
15,2,2021,21,587,696,1283,2021-02-15 20:00:00,2021-02-15 00:00:00,LABORABLE
15,2,2021,22,526,548,1074,2021-02-15 21:00:00,2021-02-15 00:00:00,LABORABLE
15,2,2021,23,210,280,490,2021-02-15 22:00:00,2021-02-15 00:00:00,LABORABLE
15,2,2021,24,90,152,242,2021-02-15 23:00:00,2021-02-15 00:00:00,LABORABLE
16,2,2021,1,45,52,97,2021-02-16 00:00:00,2021-02-16 00:00:00,LABORABLE
16,2,2021,2,44,43,87,2021-02-16 01:00:00,2021-02-16 00:00:00,LABORABLE
16,2,2021,3,32,59,91,2021-02-16 02:00:00,2021-02-16 00:00:00,LABORABLE
16,2,2021,4,29,32,61,2021-02-16 03:00:00,2021-02-16 00:00:00,LABORABLE
16,2,2021,5,47,46,93,2021-02-16 04:00:00,2021-02-16 00:00:00,LABORABLE
16,2,2021,6,155,98,253,2021-02-16 05:00:00,2021-02-16 00:00:00,LABORABLE
16,2,2021,7,412,271,683,2021-02-16 06:00:00,2021-02-16 00:00:00,LABORABLE
16,2,2021,8,672,570,1242,2021-02-16 07:00:00,2021-02-16 00:00:00,LABORABLE
16,2,2021,9,697,712,1409,2021-02-16 08:00:00,2021-02-16 00:00:00,LABORABLE
16,2,2021,10,632,761,1393,2021-02-16 09:00:00,2021-02-16 00:00:00,LABORABLE
16,2,2021,11,557,705,1262,2021-02-16 10:00:00,2021-02-16 00:00:00,LABORABLE
16,2,2021,12,541,699,1240,2021-02-16 11:00:00,2021-02-16 00:00:00,LABORABLE
16,2,2021,13,603,723,1326,2021-02-16 12:00:00,2021-02-16 00:00:00,LABORABLE
16,2,2021,14,651,696,1347,2021-02-16 13:00:00,2021-02-16 00:00:00,LABORABLE
16,2,2021,15,615,747,1362,2021-02-16 14:00:00,2021-02-16 00:00:00,LABORABLE
16,2,2021,16,657,731,1388,2021-02-16 15:00:00,2021-02-16 00:00:00,LABORABLE
16,2,2021,17,593,725,1318,2021-02-16 16:00:00,2021-02-16 00:00:00,LABORABLE
16,2,2021,18,648,720,1368,2021-02-16 17:00:00,2021-02-16 00:00:00,LABORABLE
16,2,2021,19,669,752,1421,2021-02-16 18:00:00,2021-02-16 00:00:00,LABORABLE
16,2,2021,20,614,742,1356,2021-02-16 19:00:00,2021-02-16 00:00:00,LABORABLE
16,2,2021,21,589,648,1237,2021-02-16 20:00:00,2021-02-16 00:00:00,LABORABLE
16,2,2021,22,554,550,1104,2021-02-16 21:00:00,2021-02-16 00:00:00,LABORABLE
16,2,2021,23,203,270,473,2021-02-16 22:00:00,2021-02-16 00:00:00,LABORABLE
16,2,2021,24,96,130,226,2021-02-16 23:00:00,2021-02-16 00:00:00,LABORABLE
17,2,2021,1,55,67,122,2021-02-17 00:00:00,2021-02-17 00:00:00,LABORABLE
17,2,2021,2,27,33,60,2021-02-17 01:00:00,2021-02-17 00:00:00,LABORABLE
17,2,2021,3,38,42,80,2021-02-17 02:00:00,2021-02-17 00:00:00,LABORABLE
17,2,2021,4,29,27,56,2021-02-17 03:00:00,2021-02-17 00:00:00,LABORABLE
17,2,2021,5,51,47,98,2021-02-17 04:00:00,2021-02-17 00:00:00,LABORABLE
17,2,2021,6,155,98,253,2021-02-17 05:00:00,2021-02-17 00:00:00,LABORABLE
17,2,2021,7,385,281,666,2021-02-17 06:00:00,2021-02-17 00:00:00,LABORABLE
17,2,2021,8,671,563,1234,2021-02-17 07:00:00,2021-02-17 00:00:00,LABORABLE
17,2,2021,9,698,715,1413,2021-02-17 08:00:00,2021-02-17 00:00:00,LABORABLE
17,2,2021,10,671,752,1423,2021-02-17 09:00:00,2021-02-17 00:00:00,LABORABLE
17,2,2021,11,567,681,1248,2021-02-17 10:00:00,2021-02-17 00:00:00,LABORABLE
17,2,2021,12,610,725,1335,2021-02-17 11:00:00,2021-02-17 00:00:00,LABORABLE
17,2,2021,13,595,701,1296,2021-02-17 12:00:00,2021-02-17 00:00:00,LABORABLE
17,2,2021,14,647,754,1401,2021-02-17 13:00:00,2021-02-17 00:00:00,LABORABLE
17,2,2021,15,688,730,1418,2021-02-17 14:00:00,2021-02-17 00:00:00,LABORABLE
17,2,2021,16,646,716,1362,2021-02-17 15:00:00,2021-02-17 00:00:00,LABORABLE
17,2,2021,17,612,737,1349,2021-02-17 16:00:00,2021-02-17 00:00:00,LABORABLE
17,2,2021,18,647,715,1362,2021-02-17 17:00:00,2021-02-17 00:00:00,LABORABLE
17,2,2021,19,622,807,1429,2021-02-17 18:00:00,2021-02-17 00:00:00,LABORABLE
17,2,2021,20,648,715,1363,2021-02-17 19:00:00,2021-02-17 00:00:00,LABORABLE
17,2,2021,21,597,697,1294,2021-02-17 20:00:00,2021-02-17 00:00:00,LABORABLE
17,2,2021,22,571,579,1150,2021-02-17 21:00:00,2021-02-17 00:00:00,LABORABLE
17,2,2021,23,237,303,540,2021-02-17 22:00:00,2021-02-17 00:00:00,LABORABLE
17,2,2021,24,102,146,248,2021-02-17 23:00:00,2021-02-17 00:00:00,LABORABLE
18,2,2021,1,55,58,113,2021-02-18 00:00:00,2021-02-18 00:00:00,LABORABLE
18,2,2021,2,34,39,73,2021-02-18 01:00:00,2021-02-18 00:00:00,LABORABLE
18,2,2021,3,33,42,75,2021-02-18 02:00:00,2021-02-18 00:00:00,LABORABLE
18,2,2021,4,32,31,63,2021-02-18 03:00:00,2021-02-18 00:00:00,LABORABLE
18,2,2021,5,57,49,106,2021-02-18 04:00:00,2021-02-18 00:00:00,LABORABLE
18,2,2021,6,153,102,255,2021-02-18 05:00:00,2021-02-18 00:00:00,LABORABLE
18,2,2021,7,425,303,728,2021-02-18 06:00:00,2021-02-18 00:00:00,LABORABLE
18,2,2021,8,659,589,1248,2021-02-18 07:00:00,2021-02-18 00:00:00,LABORABLE
18,2,2021,9,712,683,1395,2021-02-18 08:00:00,2021-02-18 00:00:00,LABORABLE
18,2,2021,10,690,771,1461,2021-02-18 09:00:00,2021-02-18 00:00:00,LABORABLE
18,2,2021,11,480,612,1092,2021-02-18 10:00:00,2021-02-18 00:00:00,LABORABLE
18,2,2021,12,263,308,571,2021-02-18 11:00:00,2021-02-18 00:00:00,LABORABLE
18,2,2021,13,617,747,1364,2021-02-18 12:00:00,2021-02-18 00:00:00,LABORABLE
18,2,2021,14,627,768,1395,2021-02-18 13:00:00,2021-02-18 00:00:00,LABORABLE
18,2,2021,15,677,806,1483,2021-02-18 14:00:00,2021-02-18 00:00:00,LABORABLE
18,2,2021,16,637,686,1323,2021-02-18 15:00:00,2021-02-18 00:00:00,LABORABLE
18,2,2021,17,616,819,1435,2021-02-18 16:00:00,2021-02-18 00:00:00,LABORABLE
18,2,2021,18,719,796,1515,2021-02-18 17:00:00,2021-02-18 00:00:00,LABORABLE
18,2,2021,19,682,834,1516,2021-02-18 18:00:00,2021-02-18 00:00:00,LABORABLE
18,2,2021,20,530,795,1325,2021-02-18 19:00:00,2021-02-18 00:00:00,LABORABLE
18,2,2021,21,583,680,1263,2021-02-18 20:00:00,2021-02-18 00:00:00,LABORABLE
18,2,2021,22,521,568,1089,2021-02-18 21:00:00,2021-02-18 00:00:00,LABORABLE
18,2,2021,23,392,405,797,2021-02-18 22:00:00,2021-02-18 00:00:00,LABORABLE
18,2,2021,24,171,369,540,2021-02-18 23:00:00,2021-02-18 00:00:00,LABORABLE
19,2,2021,1,69,92,161,2021-02-19 00:00:00,2021-02-19 00:00:00,LABORABLE
19,2,2021,2,30,49,79,2021-02-19 01:00:00,2021-02-19 00:00:00,LABORABLE
19,2,2021,3,36,51,87,2021-02-19 02:00:00,2021-02-19 00:00:00,LABORABLE
19,2,2021,4,37,30,67,2021-02-19 03:00:00,2021-02-19 00:00:00,LABORABLE
19,2,2021,5,68,68,136,2021-02-19 04:00:00,2021-02-19 00:00:00,LABORABLE
19,2,2021,6,165,108,273,2021-02-19 05:00:00,2021-02-19 00:00:00,LABORABLE
19,2,2021,7,393,263,656,2021-02-19 06:00:00,2021-02-19 00:00:00,LABORABLE
19,2,2021,8,654,548,1202,2021-02-19 07:00:00,2021-02-19 00:00:00,LABORABLE
19,2,2021,9,604,606,1210,2021-02-19 08:00:00,2021-02-19 00:00:00,LABORABLE
19,2,2021,10,587,724,1311,2021-02-19 09:00:00,2021-02-19 00:00:00,LABORABLE
19,2,2021,11,579,704,1283,2021-02-19 10:00:00,2021-02-19 00:00:00,LABORABLE
19,2,2021,12,617,732,1349,2021-02-19 11:00:00,2021-02-19 00:00:00,LABORABLE
19,2,2021,13,646,762,1408,2021-02-19 12:00:00,2021-02-19 00:00:00,LABORABLE
19,2,2021,14,687,776,1463,2021-02-19 13:00:00,2021-02-19 00:00:00,LABORABLE
19,2,2021,15,635,861,1496,2021-02-19 14:00:00,2021-02-19 00:00:00,LABORABLE
19,2,2021,16,599,698,1297,2021-02-19 15:00:00,2021-02-19 00:00:00,LABORABLE
19,2,2021,17,639,733,1372,2021-02-19 16:00:00,2021-02-19 00:00:00,LABORABLE
19,2,2021,18,666,743,1409,2021-02-19 17:00:00,2021-02-19 00:00:00,LABORABLE
19,2,2021,19,652,777,1429,2021-02-19 18:00:00,2021-02-19 00:00:00,LABORABLE
19,2,2021,20,672,805,1477,2021-02-19 19:00:00,2021-02-19 00:00:00,LABORABLE
19,2,2021,21,606,812,1418,2021-02-19 20:00:00,2021-02-19 00:00:00,LABORABLE
19,2,2021,22,522,669,1191,2021-02-19 21:00:00,2021-02-19 00:00:00,LABORABLE
19,2,2021,23,415,504,919,2021-02-19 22:00:00,2021-02-19 00:00:00,LABORABLE
19,2,2021,24,223,311,534,2021-02-19 23:00:00,2021-02-19 00:00:00,LABORABLE
20,2,2021,1,91,165,256,2021-02-20 00:00:00,2021-02-20 00:00:00,LABORABLE
20,2,2021,2,42,73,115,2021-02-20 01:00:00,2021-02-20 00:00:00,LABORABLE
20,2,2021,3,39,63,102,2021-02-20 02:00:00,2021-02-20 00:00:00,LABORABLE
20,2,2021,4,33,46,79,2021-02-20 03:00:00,2021-02-20 00:00:00,LABORABLE
20,2,2021,5,39,52,91,2021-02-20 04:00:00,2021-02-20 00:00:00,LABORABLE
20,2,2021,6,63,83,146,2021-02-20 05:00:00,2021-02-20 00:00:00,LABORABLE
20,2,2021,7,132,135,267,2021-02-20 06:00:00,2021-02-20 00:00:00,LABORABLE
20,2,2021,8,231,283,514,2021-02-20 07:00:00,2021-02-20 00:00:00,LABORABLE
20,2,2021,9,329,376,705,2021-02-20 08:00:00,2021-02-20 00:00:00,LABORABLE
20,2,2021,10,417,524,941,2021-02-20 09:00:00,2021-02-20 00:00:00,LABORABLE
20,2,2021,11,488,587,1075,2021-02-20 10:00:00,2021-02-20 00:00:00,LABORABLE
20,2,2021,12,540,790,1330,2021-02-20 11:00:00,2021-02-20 00:00:00,LABORABLE
20,2,2021,13,594,791,1385,2021-02-20 12:00:00,2021-02-20 00:00:00,LABORABLE
20,2,2021,14,595,891,1486,2021-02-20 13:00:00,2021-02-20 00:00:00,LABORABLE
20,2,2021,15,556,756,1312,2021-02-20 14:00:00,2021-02-20 00:00:00,LABORABLE
20,2,2021,16,456,648,1104,2021-02-20 15:00:00,2021-02-20 00:00:00,LABORABLE
20,2,2021,17,438,674,1112,2021-02-20 16:00:00,2021-02-20 00:00:00,LABORABLE
20,2,2021,18,478,694,1172,2021-02-20 17:00:00,2021-02-20 00:00:00,LABORABLE
20,2,2021,19,487,721,1208,2021-02-20 18:00:00,2021-02-20 00:00:00,LABORABLE
20,2,2021,20,485,760,1245,2021-02-20 19:00:00,2021-02-20 00:00:00,LABORABLE
20,2,2021,21,471,735,1206,2021-02-20 20:00:00,2021-02-20 00:00:00,LABORABLE
20,2,2021,22,419,600,1019,2021-02-20 21:00:00,2021-02-20 00:00:00,LABORABLE
20,2,2021,23,440,543,983,2021-02-20 22:00:00,2021-02-20 00:00:00,LABORABLE
20,2,2021,24,240,378,618,2021-02-20 23:00:00,2021-02-20 00:00:00,LABORABLE
21,2,2021,1,95,115,210,2021-02-21 00:00:00,2021-02-21 00:00:00,LABORABLE
21,2,2021,2,54,94,148,2021-02-21 01:00:00,2021-02-21 00:00:00,LABORABLE
21,2,2021,3,37,54,91,2021-02-21 02:00:00,2021-02-21 00:00:00,LABORABLE
21,2,2021,4,19,48,67,2021-02-21 03:00:00,2021-02-21 00:00:00,LABORABLE
21,2,2021,5,13,38,51,2021-02-21 04:00:00,2021-02-21 00:00:00,LABORABLE
21,2,2021,6,28,64,92,2021-02-21 05:00:00,2021-02-21 00:00:00,LABORABLE
21,2,2021,7,65,106,171,2021-02-21 06:00:00,2021-02-21 00:00:00,LABORABLE
21,2,2021,8,106,152,258,2021-02-21 07:00:00,2021-02-21 00:00:00,LABORABLE
21,2,2021,9,156,246,402,2021-02-21 08:00:00,2021-02-21 00:00:00,LABORABLE
21,2,2021,10,271,415,686,2021-02-21 09:00:00,2021-02-21 00:00:00,LABORABLE
21,2,2021,11,351,494,845,2021-02-21 10:00:00,2021-02-21 00:00:00,LABORABLE
21,2,2021,12,458,563,1021,2021-02-21 11:00:00,2021-02-21 00:00:00,LABORABLE
21,2,2021,13,508,654,1162,2021-02-21 12:00:00,2021-02-21 00:00:00,LABORABLE
21,2,2021,14,509,683,1192,2021-02-21 13:00:00,2021-02-21 00:00:00,LABORABLE
21,2,2021,15,445,638,1083,2021-02-21 14:00:00,2021-02-21 00:00:00,LABORABLE
21,2,2021,16,426,618,1044,2021-02-21 15:00:00,2021-02-21 00:00:00,LABORABLE
21,2,2021,17,383,584,967,2021-02-21 16:00:00,2021-02-21 00:00:00,LABORABLE
21,2,2021,18,392,639,1031,2021-02-21 17:00:00,2021-02-21 00:00:00,LABORABLE
21,2,2021,19,438,569,1007,2021-02-21 18:00:00,2021-02-21 00:00:00,LABORABLE
21,2,2021,20,434,623,1057,2021-02-21 19:00:00,2021-02-21 00:00:00,LABORABLE
21,2,2021,21,388,538,926,2021-02-21 20:00:00,2021-02-21 00:00:00,LABORABLE
21,2,2021,22,333,516,849,2021-02-21 21:00:00,2021-02-21 00:00:00,LABORABLE
21,2,2021,23,268,406,674,2021-02-21 22:00:00,2021-02-21 00:00:00,LABORABLE
21,2,2021,24,183,256,439,2021-02-21 23:00:00,2021-02-21 00:00:00,LABORABLE
22,2,2021,1,64,111,175,2021-02-22 00:00:00,2021-02-22 00:00:00,LABORABLE
22,2,2021,2,31,46,77,2021-02-22 01:00:00,2021-02-22 00:00:00,LABORABLE
22,2,2021,3,29,44,73,2021-02-22 02:00:00,2021-02-22 00:00:00,LABORABLE
22,2,2021,4,37,34,71,2021-02-22 03:00:00,2021-02-22 00:00:00,LABORABLE
22,2,2021,5,42,43,85,2021-02-22 04:00:00,2021-02-22 00:00:00,LABORABLE
22,2,2021,6,135,107,242,2021-02-22 05:00:00,2021-02-22 00:00:00,LABORABLE
22,2,2021,7,316,299,615,2021-02-22 06:00:00,2021-02-22 00:00:00,LABORABLE
22,2,2021,8,549,565,1114,2021-02-22 07:00:00,2021-02-22 00:00:00,LABORABLE
22,2,2021,9,484,602,1086,2021-02-22 08:00:00,2021-02-22 00:00:00,LABORABLE
22,2,2021,10,423,570,993,2021-02-22 09:00:00,2021-02-22 00:00:00,LABORABLE
22,2,2021,11,461,636,1097,2021-02-22 10:00:00,2021-02-22 00:00:00,LABORABLE
22,2,2021,12,508,666,1174,2021-02-22 11:00:00,2021-02-22 00:00:00,LABORABLE
22,2,2021,13,513,721,1234,2021-02-22 12:00:00,2021-02-22 00:00:00,LABORABLE
22,2,2021,14,517,772,1289,2021-02-22 13:00:00,2021-02-22 00:00:00,LABORABLE
22,2,2021,15,507,723,1230,2021-02-22 14:00:00,2021-02-22 00:00:00,LABORABLE
22,2,2021,16,505,635,1140,2021-02-22 15:00:00,2021-02-22 00:00:00,LABORABLE
22,2,2021,17,512,705,1217,2021-02-22 16:00:00,2021-02-22 00:00:00,LABORABLE
22,2,2021,18,520,741,1261,2021-02-22 17:00:00,2021-02-22 00:00:00,LABORABLE
22,2,2021,19,578,748,1326,2021-02-22 18:00:00,2021-02-22 00:00:00,LABORABLE
22,2,2021,20,510,795,1305,2021-02-22 19:00:00,2021-02-22 00:00:00,LABORABLE
22,2,2021,21,476,663,1139,2021-02-22 20:00:00,2021-02-22 00:00:00,LABORABLE
22,2,2021,22,371,533,904,2021-02-22 21:00:00,2021-02-22 00:00:00,LABORABLE
22,2,2021,23,294,387,681,2021-02-22 22:00:00,2021-02-22 00:00:00,LABORABLE
22,2,2021,24,110,186,296,2021-02-22 23:00:00,2021-02-22 00:00:00,LABORABLE
23,2,2021,1,42,60,102,2021-02-23 00:00:00,2021-02-23 00:00:00,LABORABLE
23,2,2021,2,25,57,82,2021-02-23 01:00:00,2021-02-23 00:00:00,LABORABLE
23,2,2021,3,20,46,66,2021-02-23 02:00:00,2021-02-23 00:00:00,LABORABLE
23,2,2021,4,32,44,76,2021-02-23 03:00:00,2021-02-23 00:00:00,LABORABLE
23,2,2021,5,45,57,102,2021-02-23 04:00:00,2021-02-23 00:00:00,LABORABLE
23,2,2021,6,121,97,218,2021-02-23 05:00:00,2021-02-23 00:00:00,LABORABLE
23,2,2021,7,332,271,603,2021-02-23 06:00:00,2021-02-23 00:00:00,LABORABLE
23,2,2021,8,566,574,1140,2021-02-23 07:00:00,2021-02-23 00:00:00,LABORABLE
23,2,2021,9,531,741,1272,2021-02-23 08:00:00,2021-02-23 00:00:00,LABORABLE
23,2,2021,10,531,746,1277,2021-02-23 09:00:00,2021-02-23 00:00:00,LABORABLE
23,2,2021,11,507,628,1135,2021-02-23 10:00:00,2021-02-23 00:00:00,LABORABLE
23,2,2021,12,535,729,1264,2021-02-23 11:00:00,2021-02-23 00:00:00,LABORABLE
23,2,2021,13,534,645,1179,2021-02-23 12:00:00,2021-02-23 00:00:00,LABORABLE
23,2,2021,14,540,678,1218,2021-02-23 13:00:00,2021-02-23 00:00:00,LABORABLE
23,2,2021,15,595,772,1367,2021-02-23 14:00:00,2021-02-23 00:00:00,LABORABLE
23,2,2021,16,659,752,1411,2021-02-23 15:00:00,2021-02-23 00:00:00,LABORABLE
23,2,2021,17,610,709,1319,2021-02-23 16:00:00,2021-02-23 00:00:00,LABORABLE
23,2,2021,18,649,809,1458,2021-02-23 17:00:00,2021-02-23 00:00:00,LABORABLE
23,2,2021,19,699,764,1463,2021-02-23 18:00:00,2021-02-23 00:00:00,LABORABLE
23,2,2021,20,626,745,1371,2021-02-23 19:00:00,2021-02-23 00:00:00,LABORABLE
23,2,2021,21,562,603,1165,2021-02-23 20:00:00,2021-02-23 00:00:00,LABORABLE
23,2,2021,22,454,547,1001,2021-02-23 21:00:00,2021-02-23 00:00:00,LABORABLE
23,2,2021,23,362,353,715,2021-02-23 22:00:00,2021-02-23 00:00:00,LABORABLE
23,2,2021,24,157,182,339,2021-02-23 23:00:00,2021-02-23 00:00:00,LABORABLE
24,2,2021,1,63,92,155,2021-02-24 00:00:00,2021-02-24 00:00:00,LABORABLE
24,2,2021,2,28,167,195,2021-02-24 01:00:00,2021-02-24 00:00:00,LABORABLE
24,2,2021,3,36,49,85,2021-02-24 02:00:00,2021-02-24 00:00:00,LABORABLE
24,2,2021,4,27,17,44,2021-02-24 03:00:00,2021-02-24 00:00:00,LABORABLE
24,2,2021,5,54,52,106,2021-02-24 04:00:00,2021-02-24 00:00:00,LABORABLE
24,2,2021,6,155,100,255,2021-02-24 05:00:00,2021-02-24 00:00:00,LABORABLE
24,2,2021,7,403,303,706,2021-02-24 06:00:00,2021-02-24 00:00:00,LABORABLE
24,2,2021,8,672,592,1264,2021-02-24 07:00:00,2021-02-24 00:00:00,LABORABLE
24,2,2021,9,711,698,1409,2021-02-24 08:00:00,2021-02-24 00:00:00,LABORABLE
24,2,2021,10,643,848,1491,2021-02-24 09:00:00,2021-02-24 00:00:00,LABORABLE
24,2,2021,11,529,662,1191,2021-02-24 10:00:00,2021-02-24 00:00:00,LABORABLE
24,2,2021,12,577,655,1232,2021-02-24 11:00:00,2021-02-24 00:00:00,LABORABLE
24,2,2021,13,19,701,720,2021-02-24 12:00:00,2021-02-24 00:00:00,LABORABLE
24,2,2021,14,237,754,991,2021-02-24 13:00:00,2021-02-24 00:00:00,LABORABLE
24,2,2021,15,679,730,1409,2021-02-24 14:00:00,2021-02-24 00:00:00,LABORABLE
24,2,2021,16,669,677,1346,2021-02-24 15:00:00,2021-02-24 00:00:00,LABORABLE
24,2,2021,17,630,724,1354,2021-02-24 16:00:00,2021-02-24 00:00:00,LABORABLE
24,2,2021,18,634,726,1360,2021-02-24 17:00:00,2021-02-24 00:00:00,LABORABLE
24,2,2021,19,699,769,1468,2021-02-24 18:00:00,2021-02-24 00:00:00,LABORABLE
24,2,2021,20,645,726,1371,2021-02-24 19:00:00,2021-02-24 00:00:00,LABORABLE
24,2,2021,21,619,659,1278,2021-02-24 20:00:00,2021-02-24 00:00:00,LABORABLE
24,2,2021,22,434,519,953,2021-02-24 21:00:00,2021-02-24 00:00:00,LABORABLE
24,2,2021,23,337,364,701,2021-02-24 22:00:00,2021-02-24 00:00:00,LABORABLE
24,2,2021,24,185,212,397,2021-02-24 23:00:00,2021-02-24 00:00:00,LABORABLE
25,2,2021,1,72,83,155,2021-02-25 00:00:00,2021-02-25 00:00:00,LABORABLE
25,2,2021,2,39,54,93,2021-02-25 01:00:00,2021-02-25 00:00:00,LABORABLE
25,2,2021,3,51,38,89,2021-02-25 02:00:00,2021-02-25 00:00:00,LABORABLE
25,2,2021,4,32,39,71,2021-02-25 03:00:00,2021-02-25 00:00:00,LABORABLE
25,2,2021,5,58,144,202,2021-02-25 04:00:00,2021-02-25 00:00:00,LABORABLE
25,2,2021,6,148,101,249,2021-02-25 05:00:00,2021-02-25 00:00:00,LABORABLE
25,2,2021,7,402,306,708,2021-02-25 06:00:00,2021-02-25 00:00:00,LABORABLE
25,2,2021,8,698,567,1265,2021-02-25 07:00:00,2021-02-25 00:00:00,LABORABLE
25,2,2021,9,699,757,1456,2021-02-25 08:00:00,2021-02-25 00:00:00,LABORABLE
25,2,2021,10,683,736,1419,2021-02-25 09:00:00,2021-02-25 00:00:00,LABORABLE
25,2,2021,11,646,662,1308,2021-02-25 10:00:00,2021-02-25 00:00:00,LABORABLE
25,2,2021,12,634,733,1367,2021-02-25 11:00:00,2021-02-25 00:00:00,LABORABLE
25,2,2021,13,466,601,1067,2021-02-25 12:00:00,2021-02-25 00:00:00,LABORABLE
25,2,2021,14,673,703,1376,2021-02-25 13:00:00,2021-02-25 00:00:00,LABORABLE
25,2,2021,15,695,749,1444,2021-02-25 14:00:00,2021-02-25 00:00:00,LABORABLE
25,2,2021,16,642,743,1385,2021-02-25 15:00:00,2021-02-25 00:00:00,LABORABLE
25,2,2021,17,706,709,1415,2021-02-25 16:00:00,2021-02-25 00:00:00,LABORABLE
25,2,2021,18,684,731,1415,2021-02-25 17:00:00,2021-02-25 00:00:00,LABORABLE
25,2,2021,19,691,768,1459,2021-02-25 18:00:00,2021-02-25 00:00:00,LABORABLE
25,2,2021,20,564,789,1353,2021-02-25 19:00:00,2021-02-25 00:00:00,LABORABLE
25,2,2021,21,633,719,1352,2021-02-25 20:00:00,2021-02-25 00:00:00,LABORABLE
25,2,2021,22,468,572,1040,2021-02-25 21:00:00,2021-02-25 00:00:00,LABORABLE
25,2,2021,23,349,378,727,2021-02-25 22:00:00,2021-02-25 00:00:00,LABORABLE
25,2,2021,24,194,248,442,2021-02-25 23:00:00,2021-02-25 00:00:00,LABORABLE
26,2,2021,1,90,101,191,2021-02-26 00:00:00,2021-02-26 00:00:00,LABORABLE
26,2,2021,2,36,46,82,2021-02-26 01:00:00,2021-02-26 00:00:00,LABORABLE
26,2,2021,3,46,45,91,2021-02-26 02:00:00,2021-02-26 00:00:00,LABORABLE
26,2,2021,4,36,43,79,2021-02-26 03:00:00,2021-02-26 00:00:00,LABORABLE
26,2,2021,5,65,57,122,2021-02-26 04:00:00,2021-02-26 00:00:00,LABORABLE
26,2,2021,6,155,110,265,2021-02-26 05:00:00,2021-02-26 00:00:00,LABORABLE
26,2,2021,7,385,276,661,2021-02-26 06:00:00,2021-02-26 00:00:00,LABORABLE
26,2,2021,8,693,570,1263,2021-02-26 07:00:00,2021-02-26 00:00:00,LABORABLE
26,2,2021,9,677,716,1393,2021-02-26 08:00:00,2021-02-26 00:00:00,LABORABLE
26,2,2021,10,640,788,1428,2021-02-26 09:00:00,2021-02-26 00:00:00,LABORABLE
26,2,2021,11,572,748,1320,2021-02-26 10:00:00,2021-02-26 00:00:00,LABORABLE
26,2,2021,12,617,800,1417,2021-02-26 11:00:00,2021-02-26 00:00:00,LABORABLE
26,2,2021,13,670,804,1474,2021-02-26 12:00:00,2021-02-26 00:00:00,LABORABLE
26,2,2021,14,677,783,1460,2021-02-26 13:00:00,2021-02-26 00:00:00,LABORABLE
26,2,2021,15,715,851,1566,2021-02-26 14:00:00,2021-02-26 00:00:00,LABORABLE
26,2,2021,16,722,656,1378,2021-02-26 15:00:00,2021-02-26 00:00:00,LABORABLE
26,2,2021,17,674,727,1401,2021-02-26 16:00:00,2021-02-26 00:00:00,LABORABLE
26,2,2021,18,706,747,1453,2021-02-26 17:00:00,2021-02-26 00:00:00,LABORABLE
26,2,2021,19,698,796,1494,2021-02-26 18:00:00,2021-02-26 00:00:00,LABORABLE
26,2,2021,20,716,824,1540,2021-02-26 19:00:00,2021-02-26 00:00:00,LABORABLE
26,2,2021,21,692,818,1510,2021-02-26 20:00:00,2021-02-26 00:00:00,LABORABLE
26,2,2021,22,591,654,1245,2021-02-26 21:00:00,2021-02-26 00:00:00,LABORABLE
26,2,2021,23,523,564,1087,2021-02-26 22:00:00,2021-02-26 00:00:00,LABORABLE
26,2,2021,24,280,388,668,2021-02-26 23:00:00,2021-02-26 00:00:00,LABORABLE
27,2,2021,1,132,169,301,2021-02-27 00:00:00,2021-02-27 00:00:00,LABORABLE
27,2,2021,2,67,84,151,2021-02-27 01:00:00,2021-02-27 00:00:00,LABORABLE
27,2,2021,3,44,63,107,2021-02-27 02:00:00,2021-02-27 00:00:00,LABORABLE
27,2,2021,4,54,48,102,2021-02-27 03:00:00,2021-02-27 00:00:00,LABORABLE
27,2,2021,5,53,57,110,2021-02-27 04:00:00,2021-02-27 00:00:00,LABORABLE
27,2,2021,6,82,69,151,2021-02-27 05:00:00,2021-02-27 00:00:00,LABORABLE
27,2,2021,7,168,138,306,2021-02-27 06:00:00,2021-02-27 00:00:00,LABORABLE
27,2,2021,8,303,223,526,2021-02-27 07:00:00,2021-02-27 00:00:00,LABORABLE
27,2,2021,9,384,378,762,2021-02-27 08:00:00,2021-02-27 00:00:00,LABORABLE
27,2,2021,10,473,478,951,2021-02-27 09:00:00,2021-02-27 00:00:00,LABORABLE
27,2,2021,11,570,672,1242,2021-02-27 10:00:00,2021-02-27 00:00:00,LABORABLE
27,2,2021,12,649,799,1448,2021-02-27 11:00:00,2021-02-27 00:00:00,LABORABLE
27,2,2021,13,712,855,1567,2021-02-27 12:00:00,2021-02-27 00:00:00,LABORABLE
27,2,2021,14,664,768,1432,2021-02-27 13:00:00,2021-02-27 00:00:00,LABORABLE
27,2,2021,15,705,871,1576,2021-02-27 14:00:00,2021-02-27 00:00:00,LABORABLE
27,2,2021,16,594,732,1326,2021-02-27 15:00:00,2021-02-27 00:00:00,LABORABLE
27,2,2021,17,547,702,1249,2021-02-27 16:00:00,2021-02-27 00:00:00,LABORABLE
27,2,2021,18,611,763,1374,2021-02-27 17:00:00,2021-02-27 00:00:00,LABORABLE
27,2,2021,19,621,701,1322,2021-02-27 18:00:00,2021-02-27 00:00:00,LABORABLE
27,2,2021,20,658,762,1420,2021-02-27 19:00:00,2021-02-27 00:00:00,LABORABLE
27,2,2021,21,639,701,1340,2021-02-27 20:00:00,2021-02-27 00:00:00,LABORABLE
27,2,2021,22,553,655,1208,2021-02-27 21:00:00,2021-02-27 00:00:00,LABORABLE
27,2,2021,23,572,597,1169,2021-02-27 22:00:00,2021-02-27 00:00:00,LABORABLE
27,2,2021,24,289,386,675,2021-02-27 23:00:00,2021-02-27 00:00:00,LABORABLE
28,2,2021,1,143,112,255,2021-02-28 00:00:00,2021-02-28 00:00:00,LABORABLE
28,2,2021,2,62,90,152,2021-02-28 01:00:00,2021-02-28 00:00:00,LABORABLE
28,2,2021,3,49,56,105,2021-02-28 02:00:00,2021-02-28 00:00:00,LABORABLE
28,2,2021,4,27,50,77,2021-02-28 03:00:00,2021-02-28 00:00:00,LABORABLE
28,2,2021,5,23,32,55,2021-02-28 04:00:00,2021-02-28 00:00:00,LABORABLE
28,2,2021,6,46,63,109,2021-02-28 05:00:00,2021-02-28 00:00:00,LABORABLE
28,2,2021,7,82,107,189,2021-02-28 06:00:00,2021-02-28 00:00:00,LABORABLE
28,2,2021,8,163,161,324,2021-02-28 07:00:00,2021-02-28 00:00:00,LABORABLE
28,2,2021,9,219,255,474,2021-02-28 08:00:00,2021-02-28 00:00:00,LABORABLE
28,2,2021,10,308,429,737,2021-02-28 09:00:00,2021-02-28 00:00:00,LABORABLE
28,2,2021,11,475,505,980,2021-02-28 10:00:00,2021-02-28 00:00:00,LABORABLE
28,2,2021,12,611,587,1198,2021-02-28 11:00:00,2021-02-28 00:00:00,LABORABLE
28,2,2021,13,680,746,1426,2021-02-28 12:00:00,2021-02-28 00:00:00,LABORABLE
28,2,2021,14,660,737,1397,2021-02-28 13:00:00,2021-02-28 00:00:00,LABORABLE
28,2,2021,15,554,708,1262,2021-02-28 14:00:00,2021-02-28 00:00:00,LABORABLE
28,2,2021,16,498,716,1214,2021-02-28 15:00:00,2021-02-28 00:00:00,LABORABLE
28,2,2021,17,523,627,1150,2021-02-28 16:00:00,2021-02-28 00:00:00,LABORABLE
28,2,2021,18,556,681,1237,2021-02-28 17:00:00,2021-02-28 00:00:00,LABORABLE
28,2,2021,19,529,689,1218,2021-02-28 18:00:00,2021-02-28 00:00:00,LABORABLE
28,2,2021,20,550,736,1286,2021-02-28 19:00:00,2021-02-28 00:00:00,LABORABLE
28,2,2021,21,529,631,1160,2021-02-28 20:00:00,2021-02-28 00:00:00,LABORABLE
28,2,2021,22,464,496,960,2021-02-28 21:00:00,2021-02-28 00:00:00,LABORABLE
28,2,2021,23,341,379,720,2021-02-28 22:00:00,2021-02-28 00:00:00,LABORABLE
28,2,2021,24,216,256,472,2021-02-28 23:00:00,2021-02-28 00:00:00,LABORABLE
1,3,2021,1,74,105,179,2021-03-01 00:00:00,2021-01-03 00:00:00,LABORABLE
1,3,2021,2,48,77,125,2021-03-01 01:00:00,2021-01-03 00:00:00,LABORABLE
1,3,2021,3,47,46,93,2021-03-01 02:00:00,2021-01-03 00:00:00,LABORABLE
1,3,2021,4,37,38,75,2021-03-01 03:00:00,2021-01-03 00:00:00,LABORABLE
1,3,2021,5,64,42,106,2021-03-01 04:00:00,2021-01-03 00:00:00,LABORABLE
1,3,2021,6,150,113,263,2021-03-01 05:00:00,2021-01-03 00:00:00,LABORABLE
1,3,2021,7,392,306,698,2021-03-01 06:00:00,2021-01-03 00:00:00,LABORABLE
1,3,2021,8,696,595,1291,2021-03-01 07:00:00,2021-01-03 00:00:00,LABORABLE
1,3,2021,9,743,709,1452,2021-03-01 08:00:00,2021-01-03 00:00:00,LABORABLE
1,3,2021,10,657,731,1388,2021-03-01 09:00:00,2021-01-03 00:00:00,LABORABLE
1,3,2021,11,570,691,1261,2021-03-01 10:00:00,2021-01-03 00:00:00,LABORABLE
1,3,2021,12,613,734,1347,2021-03-01 11:00:00,2021-01-03 00:00:00,LABORABLE
1,3,2021,13,635,719,1354,2021-03-01 12:00:00,2021-01-03 00:00:00,LABORABLE
1,3,2021,14,620,784,1404,2021-03-01 13:00:00,2021-01-03 00:00:00,LABORABLE
1,3,2021,15,683,709,1392,2021-03-01 14:00:00,2021-01-03 00:00:00,LABORABLE
1,3,2021,16,716,679,1395,2021-03-01 15:00:00,2021-01-03 00:00:00,LABORABLE
1,3,2021,17,639,774,1413,2021-03-01 16:00:00,2021-01-03 00:00:00,LABORABLE
1,3,2021,18,668,811,1479,2021-03-01 17:00:00,2021-01-03 00:00:00,LABORABLE
1,3,2021,19,645,784,1429,2021-03-01 18:00:00,2021-01-03 00:00:00,LABORABLE
1,3,2021,20,601,696,1297,2021-03-01 19:00:00,2021-01-03 00:00:00,LABORABLE
1,3,2021,21,587,654,1241,2021-03-01 20:00:00,2021-01-03 00:00:00,LABORABLE
1,3,2021,22,443,474,917,2021-03-01 21:00:00,2021-01-03 00:00:00,LABORABLE
1,3,2021,23,302,315,617,2021-03-01 22:00:00,2021-01-03 00:00:00,LABORABLE
1,3,2021,24,146,188,334,2021-03-01 23:00:00,2021-01-03 00:00:00,LABORABLE
2,3,2021,1,48,71,119,2021-03-02 00:00:00,2021-02-03 00:00:00,LABORABLE
2,3,2021,2,41,45,86,2021-03-02 01:00:00,2021-02-03 00:00:00,LABORABLE
2,3,2021,3,41,56,97,2021-03-02 02:00:00,2021-02-03 00:00:00,LABORABLE
2,3,2021,4,44,32,76,2021-03-02 03:00:00,2021-02-03 00:00:00,LABORABLE
2,3,2021,5,51,50,101,2021-03-02 04:00:00,2021-02-03 00:00:00,LABORABLE
2,3,2021,6,138,92,230,2021-03-02 05:00:00,2021-02-03 00:00:00,LABORABLE
2,3,2021,7,391,311,702,2021-03-02 06:00:00,2021-02-03 00:00:00,LABORABLE
2,3,2021,8,672,573,1245,2021-03-02 07:00:00,2021-02-03 00:00:00,LABORABLE
2,3,2021,9,709,692,1401,2021-03-02 08:00:00,2021-02-03 00:00:00,LABORABLE
2,3,2021,10,624,743,1367,2021-03-02 09:00:00,2021-02-03 00:00:00,LABORABLE
2,3,2021,11,560,668,1228,2021-03-02 10:00:00,2021-02-03 00:00:00,LABORABLE
2,3,2021,12,591,740,1331,2021-03-02 11:00:00,2021-02-03 00:00:00,LABORABLE
2,3,2021,13,618,734,1352,2021-03-02 12:00:00,2021-02-03 00:00:00,LABORABLE
2,3,2021,14,607,711,1318,2021-03-02 13:00:00,2021-02-03 00:00:00,LABORABLE
2,3,2021,15,652,754,1406,2021-03-02 14:00:00,2021-02-03 00:00:00,LABORABLE
2,3,2021,16,638,643,1281,2021-03-02 15:00:00,2021-02-03 00:00:00,LABORABLE
2,3,2021,17,631,750,1381,2021-03-02 16:00:00,2021-02-03 00:00:00,LABORABLE
2,3,2021,18,656,809,1465,2021-03-02 17:00:00,2021-02-03 00:00:00,LABORABLE
2,3,2021,19,651,825,1476,2021-03-02 18:00:00,2021-02-03 00:00:00,LABORABLE
2,3,2021,20,656,846,1502,2021-03-02 19:00:00,2021-02-03 00:00:00,LABORABLE
2,3,2021,21,607,657,1264,2021-03-02 20:00:00,2021-02-03 00:00:00,LABORABLE
2,3,2021,22,477,494,971,2021-03-02 21:00:00,2021-02-03 00:00:00,LABORABLE
2,3,2021,23,336,357,693,2021-03-02 22:00:00,2021-02-03 00:00:00,LABORABLE
2,3,2021,24,164,195,359,2021-03-02 23:00:00,2021-02-03 00:00:00,LABORABLE
3,3,2021,1,77,80,157,2021-03-03 00:00:00,2021-03-03 00:00:00,LABORABLE
3,3,2021,2,33,38,71,2021-03-03 01:00:00,2021-03-03 00:00:00,LABORABLE
3,3,2021,3,40,56,96,2021-03-03 02:00:00,2021-03-03 00:00:00,LABORABLE
3,3,2021,4,48,41,89,2021-03-03 03:00:00,2021-03-03 00:00:00,LABORABLE
3,3,2021,5,65,43,108,2021-03-03 04:00:00,2021-03-03 00:00:00,LABORABLE
3,3,2021,6,156,95,251,2021-03-03 05:00:00,2021-03-03 00:00:00,LABORABLE
3,3,2021,7,390,299,689,2021-03-03 06:00:00,2021-03-03 00:00:00,LABORABLE
3,3,2021,8,649,603,1252,2021-03-03 07:00:00,2021-03-03 00:00:00,LABORABLE
3,3,2021,9,703,714,1417,2021-03-03 08:00:00,2021-03-03 00:00:00,LABORABLE
3,3,2021,10,628,764,1392,2021-03-03 09:00:00,2021-03-03 00:00:00,LABORABLE
3,3,2021,11,535,640,1175,2021-03-03 10:00:00,2021-03-03 00:00:00,LABORABLE
3,3,2021,12,632,668,1300,2021-03-03 11:00:00,2021-03-03 00:00:00,LABORABLE
3,3,2021,13,625,713,1338,2021-03-03 12:00:00,2021-03-03 00:00:00,LABORABLE
3,3,2021,14,626,729,1355,2021-03-03 13:00:00,2021-03-03 00:00:00,LABORABLE
3,3,2021,15,696,748,1444,2021-03-03 14:00:00,2021-03-03 00:00:00,LABORABLE
3,3,2021,16,626,666,1292,2021-03-03 15:00:00,2021-03-03 00:00:00,LABORABLE
3,3,2021,17,551,601,1152,2021-03-03 16:00:00,2021-03-03 00:00:00,LABORABLE
3,3,2021,18,636,680,1316,2021-03-03 17:00:00,2021-03-03 00:00:00,LABORABLE
3,3,2021,19,687,789,1476,2021-03-03 18:00:00,2021-03-03 00:00:00,LABORABLE
3,3,2021,20,637,779,1416,2021-03-03 19:00:00,2021-03-03 00:00:00,LABORABLE
3,3,2021,21,605,677,1282,2021-03-03 20:00:00,2021-03-03 00:00:00,LABORABLE
3,3,2021,22,487,495,982,2021-03-03 21:00:00,2021-03-03 00:00:00,LABORABLE
3,3,2021,23,384,328,712,2021-03-03 22:00:00,2021-03-03 00:00:00,LABORABLE
3,3,2021,24,195,216,411,2021-03-03 23:00:00,2021-03-03 00:00:00,LABORABLE
4,3,2021,1,96,87,183,2021-03-04 00:00:00,2021-04-03 00:00:00,LABORABLE
4,3,2021,2,34,46,80,2021-03-04 01:00:00,2021-04-03 00:00:00,LABORABLE
4,3,2021,3,44,45,89,2021-03-04 02:00:00,2021-04-03 00:00:00,LABORABLE
4,3,2021,4,41,34,75,2021-03-04 03:00:00,2021-04-03 00:00:00,LABORABLE
4,3,2021,5,74,63,137,2021-03-04 04:00:00,2021-04-03 00:00:00,LABORABLE
4,3,2021,6,127,102,229,2021-03-04 05:00:00,2021-04-03 00:00:00,LABORABLE
4,3,2021,7,402,335,737,2021-03-04 06:00:00,2021-04-03 00:00:00,LABORABLE
4,3,2021,8,710,624,1334,2021-03-04 07:00:00,2021-04-03 00:00:00,LABORABLE
4,3,2021,9,736,672,1408,2021-03-04 08:00:00,2021-04-03 00:00:00,LABORABLE
4,3,2021,10,677,728,1405,2021-03-04 09:00:00,2021-04-03 00:00:00,LABORABLE
4,3,2021,11,598,717,1315,2021-03-04 10:00:00,2021-04-03 00:00:00,LABORABLE
4,3,2021,12,626,759,1385,2021-03-04 11:00:00,2021-04-03 00:00:00,LABORABLE
4,3,2021,13,617,789,1406,2021-03-04 12:00:00,2021-04-03 00:00:00,LABORABLE
4,3,2021,14,659,773,1432,2021-03-04 13:00:00,2021-04-03 00:00:00,LABORABLE
4,3,2021,15,661,736,1397,2021-03-04 14:00:00,2021-04-03 00:00:00,LABORABLE
4,3,2021,16,681,678,1359,2021-03-04 15:00:00,2021-04-03 00:00:00,LABORABLE
4,3,2021,17,646,708,1354,2021-03-04 16:00:00,2021-04-03 00:00:00,LABORABLE
4,3,2021,18,677,768,1445,2021-03-04 17:00:00,2021-04-03 00:00:00,LABORABLE
4,3,2021,19,751,793,1544,2021-03-04 18:00:00,2021-04-03 00:00:00,LABORABLE
4,3,2021,20,595,782,1377,2021-03-04 19:00:00,2021-04-03 00:00:00,LABORABLE
4,3,2021,21,623,706,1329,2021-03-04 20:00:00,2021-04-03 00:00:00,LABORABLE
4,3,2021,22,546,542,1088,2021-03-04 21:00:00,2021-04-03 00:00:00,LABORABLE
4,3,2021,23,458,402,860,2021-03-04 22:00:00,2021-04-03 00:00:00,LABORABLE
4,3,2021,24,216,256,472,2021-03-04 23:00:00,2021-04-03 00:00:00,LABORABLE
5,3,2021,1,79,123,202,2021-03-05 00:00:00,2021-05-03 00:00:00,LABORABLE
5,3,2021,2,44,40,84,2021-03-05 01:00:00,2021-05-03 00:00:00,LABORABLE
5,3,2021,3,43,56,99,2021-03-05 02:00:00,2021-05-03 00:00:00,LABORABLE
5,3,2021,4,38,44,82,2021-03-05 03:00:00,2021-05-03 00:00:00,LABORABLE
5,3,2021,5,70,59,129,2021-03-05 04:00:00,2021-05-03 00:00:00,LABORABLE
5,3,2021,6,146,108,254,2021-03-05 05:00:00,2021-05-03 00:00:00,LABORABLE
5,3,2021,7,369,290,659,2021-03-05 06:00:00,2021-05-03 00:00:00,LABORABLE
5,3,2021,8,684,594,1278,2021-03-05 07:00:00,2021-05-03 00:00:00,LABORABLE
5,3,2021,9,716,699,1415,2021-03-05 08:00:00,2021-05-03 00:00:00,LABORABLE
5,3,2021,10,671,742,1413,2021-03-05 09:00:00,2021-05-03 00:00:00,LABORABLE
5,3,2021,11,593,713,1306,2021-03-05 10:00:00,2021-05-03 00:00:00,LABORABLE
5,3,2021,12,591,751,1342,2021-03-05 11:00:00,2021-05-03 00:00:00,LABORABLE
5,3,2021,13,669,838,1507,2021-03-05 12:00:00,2021-05-03 00:00:00,LABORABLE
5,3,2021,14,679,791,1470,2021-03-05 13:00:00,2021-05-03 00:00:00,LABORABLE
5,3,2021,15,708,815,1523,2021-03-05 14:00:00,2021-05-03 00:00:00,LABORABLE
5,3,2021,16,691,737,1428,2021-03-05 15:00:00,2021-05-03 00:00:00,LABORABLE
5,3,2021,17,640,768,1408,2021-03-05 16:00:00,2021-05-03 00:00:00,LABORABLE
5,3,2021,18,755,821,1576,2021-03-05 17:00:00,2021-05-03 00:00:00,LABORABLE
5,3,2021,19,651,858,1509,2021-03-05 18:00:00,2021-05-03 00:00:00,LABORABLE
5,3,2021,20,652,772,1424,2021-03-05 19:00:00,2021-05-03 00:00:00,LABORABLE
5,3,2021,21,687,794,1481,2021-03-05 20:00:00,2021-05-03 00:00:00,LABORABLE
5,3,2021,22,595,694,1289,2021-03-05 21:00:00,2021-05-03 00:00:00,LABORABLE
5,3,2021,23,546,564,1110,2021-03-05 22:00:00,2021-05-03 00:00:00,LABORABLE
5,3,2021,24,326,436,762,2021-03-05 23:00:00,2021-05-03 00:00:00,LABORABLE
6,3,2021,1,140,193,333,2021-03-06 00:00:00,2021-06-03 00:00:00,LABORABLE
6,3,2021,2,70,109,179,2021-03-06 01:00:00,2021-06-03 00:00:00,LABORABLE
6,3,2021,3,51,75,126,2021-03-06 02:00:00,2021-06-03 00:00:00,LABORABLE
6,3,2021,4,53,48,101,2021-03-06 03:00:00,2021-06-03 00:00:00,LABORABLE
6,3,2021,5,48,53,101,2021-03-06 04:00:00,2021-06-03 00:00:00,LABORABLE
6,3,2021,6,82,86,168,2021-03-06 05:00:00,2021-06-03 00:00:00,LABORABLE
6,3,2021,7,150,107,257,2021-03-06 06:00:00,2021-06-03 00:00:00,LABORABLE
6,3,2021,8,277,259,536,2021-03-06 07:00:00,2021-06-03 00:00:00,LABORABLE
6,3,2021,9,379,366,745,2021-03-06 08:00:00,2021-06-03 00:00:00,LABORABLE
6,3,2021,10,520,543,1063,2021-03-06 09:00:00,2021-06-03 00:00:00,LABORABLE
6,3,2021,11,575,636,1211,2021-03-06 10:00:00,2021-06-03 00:00:00,LABORABLE
6,3,2021,12,673,790,1463,2021-03-06 11:00:00,2021-06-03 00:00:00,LABORABLE
6,3,2021,13,735,778,1513,2021-03-06 12:00:00,2021-06-03 00:00:00,LABORABLE
6,3,2021,14,697,900,1597,2021-03-06 13:00:00,2021-06-03 00:00:00,LABORABLE
6,3,2021,15,677,843,1520,2021-03-06 14:00:00,2021-06-03 00:00:00,LABORABLE
6,3,2021,16,569,786,1355,2021-03-06 15:00:00,2021-06-03 00:00:00,LABORABLE
6,3,2021,17,582,752,1334,2021-03-06 16:00:00,2021-06-03 00:00:00,LABORABLE
6,3,2021,18,593,745,1338,2021-03-06 17:00:00,2021-06-03 00:00:00,LABORABLE
6,3,2021,19,627,833,1460,2021-03-06 18:00:00,2021-06-03 00:00:00,LABORABLE
6,3,2021,20,631,744,1375,2021-03-06 19:00:00,2021-06-03 00:00:00,LABORABLE
6,3,2021,21,555,637,1192,2021-03-06 20:00:00,2021-06-03 00:00:00,LABORABLE
6,3,2021,22,474,654,1128,2021-03-06 21:00:00,2021-06-03 00:00:00,LABORABLE
6,3,2021,23,622,661,1283,2021-03-06 22:00:00,2021-06-03 00:00:00,LABORABLE
6,3,2021,24,363,399,762,2021-03-06 23:00:00,2021-06-03 00:00:00,LABORABLE
7,3,2021,1,159,193,352,2021-03-07 00:00:00,2021-07-03 00:00:00,LABORABLE
7,3,2021,2,68,108,176,2021-03-07 01:00:00,2021-07-03 00:00:00,LABORABLE
7,3,2021,3,58,78,136,2021-03-07 02:00:00,2021-07-03 00:00:00,LABORABLE
7,3,2021,4,31,36,67,2021-03-07 03:00:00,2021-07-03 00:00:00,LABORABLE
7,3,2021,5,25,44,69,2021-03-07 04:00:00,2021-07-03 00:00:00,LABORABLE
7,3,2021,6,47,47,94,2021-03-07 05:00:00,2021-07-03 00:00:00,LABORABLE
7,3,2021,7,98,102,200,2021-03-07 06:00:00,2021-07-03 00:00:00,LABORABLE
7,3,2021,8,131,153,284,2021-03-07 07:00:00,2021-07-03 00:00:00,LABORABLE
7,3,2021,9,190,266,456,2021-03-07 08:00:00,2021-07-03 00:00:00,LABORABLE
7,3,2021,10,351,372,723,2021-03-07 09:00:00,2021-07-03 00:00:00,LABORABLE
7,3,2021,11,429,547,976,2021-03-07 10:00:00,2021-07-03 00:00:00,LABORABLE
7,3,2021,12,589,580,1169,2021-03-07 11:00:00,2021-07-03 00:00:00,LABORABLE
7,3,2021,13,634,699,1333,2021-03-07 12:00:00,2021-07-03 00:00:00,LABORABLE
7,3,2021,14,630,731,1361,2021-03-07 13:00:00,2021-07-03 00:00:00,LABORABLE
7,3,2021,15,618,767,1385,2021-03-07 14:00:00,2021-07-03 00:00:00,LABORABLE
7,3,2021,16,502,630,1132,2021-03-07 15:00:00,2021-07-03 00:00:00,LABORABLE
7,3,2021,17,494,656,1150,2021-03-07 16:00:00,2021-07-03 00:00:00,LABORABLE
7,3,2021,18,475,591,1066,2021-03-07 17:00:00,2021-07-03 00:00:00,LABORABLE
7,3,2021,19,549,698,1247,2021-03-07 18:00:00,2021-07-03 00:00:00,LABORABLE
7,3,2021,20,614,687,1301,2021-03-07 19:00:00,2021-07-03 00:00:00,LABORABLE
7,3,2021,21,545,595,1140,2021-03-07 20:00:00,2021-07-03 00:00:00,LABORABLE
7,3,2021,22,472,528,1000,2021-03-07 21:00:00,2021-07-03 00:00:00,LABORABLE
7,3,2021,23,354,381,735,2021-03-07 22:00:00,2021-07-03 00:00:00,LABORABLE
7,3,2021,24,202,294,496,2021-03-07 23:00:00,2021-07-03 00:00:00,LABORABLE
8,3,2021,1,87,126,213,2021-03-08 00:00:00,2021-08-03 00:00:00,LABORABLE
8,3,2021,2,44,55,99,2021-03-08 01:00:00,2021-08-03 00:00:00,LABORABLE
8,3,2021,3,42,54,96,2021-03-08 02:00:00,2021-08-03 00:00:00,LABORABLE
8,3,2021,4,33,33,66,2021-03-08 03:00:00,2021-08-03 00:00:00,LABORABLE
8,3,2021,5,63,43,106,2021-03-08 04:00:00,2021-08-03 00:00:00,LABORABLE
8,3,2021,6,154,83,237,2021-03-08 05:00:00,2021-08-03 00:00:00,LABORABLE
8,3,2021,7,390,286,676,2021-03-08 06:00:00,2021-08-03 00:00:00,LABORABLE
8,3,2021,8,697,525,1222,2021-03-08 07:00:00,2021-08-03 00:00:00,LABORABLE
8,3,2021,9,725,705,1430,2021-03-08 08:00:00,2021-08-03 00:00:00,LABORABLE
8,3,2021,10,633,686,1319,2021-03-08 09:00:00,2021-08-03 00:00:00,LABORABLE
8,3,2021,11,582,688,1270,2021-03-08 10:00:00,2021-08-03 00:00:00,LABORABLE
8,3,2021,12,590,685,1275,2021-03-08 11:00:00,2021-08-03 00:00:00,LABORABLE
8,3,2021,13,618,777,1395,2021-03-08 12:00:00,2021-08-03 00:00:00,LABORABLE
8,3,2021,14,588,748,1336,2021-03-08 13:00:00,2021-08-03 00:00:00,LABORABLE
8,3,2021,15,698,776,1474,2021-03-08 14:00:00,2021-08-03 00:00:00,LABORABLE
8,3,2021,16,683,688,1371,2021-03-08 15:00:00,2021-08-03 00:00:00,LABORABLE
8,3,2021,17,619,789,1408,2021-03-08 16:00:00,2021-08-03 00:00:00,LABORABLE
8,3,2021,18,640,692,1332,2021-03-08 17:00:00,2021-08-03 00:00:00,LABORABLE
8,3,2021,19,656,814,1470,2021-03-08 18:00:00,2021-08-03 00:00:00,LABORABLE
8,3,2021,20,640,694,1334,2021-03-08 19:00:00,2021-08-03 00:00:00,LABORABLE
8,3,2021,21,530,652,1182,2021-03-08 20:00:00,2021-08-03 00:00:00,LABORABLE
8,3,2021,22,383,518,901,2021-03-08 21:00:00,2021-08-03 00:00:00,LABORABLE
8,3,2021,23,360,358,718,2021-03-08 22:00:00,2021-08-03 00:00:00,LABORABLE
8,3,2021,24,135,193,328,2021-03-08 23:00:00,2021-08-03 00:00:00,LABORABLE
9,3,2021,1,52,69,121,2021-03-09 00:00:00,2021-09-03 00:00:00,LABORABLE
9,3,2021,2,35,53,88,2021-03-09 01:00:00,2021-09-03 00:00:00,LABORABLE
9,3,2021,3,35,42,77,2021-03-09 02:00:00,2021-09-03 00:00:00,LABORABLE
9,3,2021,4,38,28,66,2021-03-09 03:00:00,2021-09-03 00:00:00,LABORABLE
9,3,2021,5,65,51,116,2021-03-09 04:00:00,2021-09-03 00:00:00,LABORABLE
9,3,2021,6,160,82,242,2021-03-09 05:00:00,2021-09-03 00:00:00,LABORABLE
9,3,2021,7,384,320,704,2021-03-09 06:00:00,2021-09-03 00:00:00,LABORABLE
9,3,2021,8,694,557,1251,2021-03-09 07:00:00,2021-09-03 00:00:00,LABORABLE
9,3,2021,9,706,754,1460,2021-03-09 08:00:00,2021-09-03 00:00:00,LABORABLE
9,3,2021,10,644,781,1425,2021-03-09 09:00:00,2021-09-03 00:00:00,LABORABLE
9,3,2021,11,555,656,1211,2021-03-09 10:00:00,2021-09-03 00:00:00,LABORABLE
9,3,2021,12,598,709,1307,2021-03-09 11:00:00,2021-09-03 00:00:00,LABORABLE
9,3,2021,13,597,700,1297,2021-03-09 12:00:00,2021-09-03 00:00:00,LABORABLE
9,3,2021,14,649,714,1363,2021-03-09 13:00:00,2021-09-03 00:00:00,LABORABLE
9,3,2021,15,655,788,1443,2021-03-09 14:00:00,2021-09-03 00:00:00,LABORABLE
9,3,2021,16,635,640,1275,2021-03-09 15:00:00,2021-09-03 00:00:00,LABORABLE
9,3,2021,17,631,677,1308,2021-03-09 16:00:00,2021-09-03 00:00:00,LABORABLE
9,3,2021,18,623,751,1374,2021-03-09 17:00:00,2021-09-03 00:00:00,LABORABLE
9,3,2021,19,650,742,1392,2021-03-09 18:00:00,2021-09-03 00:00:00,LABORABLE
9,3,2021,20,658,752,1410,2021-03-09 19:00:00,2021-09-03 00:00:00,LABORABLE
9,3,2021,21,584,674,1258,2021-03-09 20:00:00,2021-09-03 00:00:00,LABORABLE
9,3,2021,22,472,531,1003,2021-03-09 21:00:00,2021-09-03 00:00:00,LABORABLE
9,3,2021,23,350,348,698,2021-03-09 22:00:00,2021-09-03 00:00:00,LABORABLE
9,3,2021,24,164,223,387,2021-03-09 23:00:00,2021-09-03 00:00:00,LABORABLE
10,3,2021,1,77,80,157,2021-03-10 00:00:00,2021-10-03 00:00:00,LABORABLE
10,3,2021,2,35,56,91,2021-03-10 01:00:00,2021-10-03 00:00:00,LABORABLE
10,3,2021,3,42,42,84,2021-03-10 02:00:00,2021-10-03 00:00:00,LABORABLE
10,3,2021,4,55,35,90,2021-03-10 03:00:00,2021-10-03 00:00:00,LABORABLE
10,3,2021,5,57,52,109,2021-03-10 04:00:00,2021-10-03 00:00:00,LABORABLE
10,3,2021,6,160,135,295,2021-03-10 05:00:00,2021-10-03 00:00:00,LABORABLE
10,3,2021,7,403,405,808,2021-03-10 06:00:00,2021-10-03 00:00:00,LABORABLE
10,3,2021,8,684,584,1268,2021-03-10 07:00:00,2021-10-03 00:00:00,LABORABLE
10,3,2021,9,717,730,1447,2021-03-10 08:00:00,2021-10-03 00:00:00,LABORABLE
10,3,2021,10,641,773,1414,2021-03-10 09:00:00,2021-10-03 00:00:00,LABORABLE
10,3,2021,11,604,697,1301,2021-03-10 10:00:00,2021-10-03 00:00:00,LABORABLE
10,3,2021,12,544,744,1288,2021-03-10 11:00:00,2021-10-03 00:00:00,LABORABLE
10,3,2021,13,588,679,1267,2021-03-10 12:00:00,2021-10-03 00:00:00,LABORABLE
10,3,2021,14,640,741,1381,2021-03-10 13:00:00,2021-10-03 00:00:00,LABORABLE
10,3,2021,15,650,713,1363,2021-03-10 14:00:00,2021-10-03 00:00:00,LABORABLE
10,3,2021,16,654,742,1396,2021-03-10 15:00:00,2021-10-03 00:00:00,LABORABLE
10,3,2021,17,641,721,1362,2021-03-10 16:00:00,2021-10-03 00:00:00,LABORABLE
10,3,2021,18,648,742,1390,2021-03-10 17:00:00,2021-10-03 00:00:00,LABORABLE
10,3,2021,19,682,776,1458,2021-03-10 18:00:00,2021-10-03 00:00:00,LABORABLE
10,3,2021,20,610,748,1358,2021-03-10 19:00:00,2021-10-03 00:00:00,LABORABLE
10,3,2021,21,594,671,1265,2021-03-10 20:00:00,2021-10-03 00:00:00,LABORABLE
10,3,2021,22,474,525,999,2021-03-10 21:00:00,2021-10-03 00:00:00,LABORABLE
10,3,2021,23,374,397,771,2021-03-10 22:00:00,2021-10-03 00:00:00,LABORABLE
10,3,2021,24,183,227,410,2021-03-10 23:00:00,2021-10-03 00:00:00,LABORABLE
11,3,2021,1,95,87,182,2021-03-11 00:00:00,2021-11-03 00:00:00,LABORABLE
11,3,2021,2,45,44,89,2021-03-11 01:00:00,2021-11-03 00:00:00,LABORABLE
11,3,2021,3,36,53,89,2021-03-11 02:00:00,2021-11-03 00:00:00,LABORABLE
11,3,2021,4,36,26,62,2021-03-11 03:00:00,2021-11-03 00:00:00,LABORABLE
11,3,2021,5,55,66,121,2021-03-11 04:00:00,2021-11-03 00:00:00,LABORABLE
11,3,2021,6,153,97,250,2021-03-11 05:00:00,2021-11-03 00:00:00,LABORABLE
11,3,2021,7,384,312,696,2021-03-11 06:00:00,2021-11-03 00:00:00,LABORABLE
11,3,2021,8,677,610,1287,2021-03-11 07:00:00,2021-11-03 00:00:00,LABORABLE
11,3,2021,9,712,736,1448,2021-03-11 08:00:00,2021-11-03 00:00:00,LABORABLE
11,3,2021,10,640,716,1356,2021-03-11 09:00:00,2021-11-03 00:00:00,LABORABLE
11,3,2021,11,667,708,1375,2021-03-11 10:00:00,2021-11-03 00:00:00,LABORABLE
11,3,2021,12,632,758,1390,2021-03-11 11:00:00,2021-11-03 00:00:00,LABORABLE
11,3,2021,13,617,776,1393,2021-03-11 12:00:00,2021-11-03 00:00:00,LABORABLE
11,3,2021,14,666,722,1388,2021-03-11 13:00:00,2021-11-03 00:00:00,LABORABLE
11,3,2021,15,690,720,1410,2021-03-11 14:00:00,2021-11-03 00:00:00,LABORABLE
11,3,2021,16,659,740,1399,2021-03-11 15:00:00,2021-11-03 00:00:00,LABORABLE
11,3,2021,17,583,725,1308,2021-03-11 16:00:00,2021-11-03 00:00:00,LABORABLE
11,3,2021,18,686,700,1386,2021-03-11 17:00:00,2021-11-03 00:00:00,LABORABLE
11,3,2021,19,691,746,1437,2021-03-11 18:00:00,2021-11-03 00:00:00,LABORABLE
11,3,2021,20,529,774,1303,2021-03-11 19:00:00,2021-11-03 00:00:00,LABORABLE
11,3,2021,21,587,698,1285,2021-03-11 20:00:00,2021-11-03 00:00:00,LABORABLE
11,3,2021,22,504,568,1072,2021-03-11 21:00:00,2021-11-03 00:00:00,LABORABLE
11,3,2021,23,429,386,815,2021-03-11 22:00:00,2021-11-03 00:00:00,LABORABLE
11,3,2021,24,195,231,426,2021-03-11 23:00:00,2021-11-03 00:00:00,LABORABLE
12,3,2021,1,97,123,220,2021-03-12 00:00:00,2021-12-03 00:00:00,LABORABLE
12,3,2021,2,43,62,105,2021-03-12 01:00:00,2021-12-03 00:00:00,LABORABLE
12,3,2021,3,50,55,105,2021-03-12 02:00:00,2021-12-03 00:00:00,LABORABLE
12,3,2021,4,37,45,82,2021-03-12 03:00:00,2021-12-03 00:00:00,LABORABLE
12,3,2021,5,58,65,123,2021-03-12 04:00:00,2021-12-03 00:00:00,LABORABLE
12,3,2021,6,139,102,241,2021-03-12 05:00:00,2021-12-03 00:00:00,LABORABLE
12,3,2021,7,374,317,691,2021-03-12 06:00:00,2021-12-03 00:00:00,LABORABLE
12,3,2021,8,663,576,1239,2021-03-12 07:00:00,2021-12-03 00:00:00,LABORABLE
12,3,2021,9,660,714,1374,2021-03-12 08:00:00,2021-12-03 00:00:00,LABORABLE
12,3,2021,10,674,799,1473,2021-03-12 09:00:00,2021-12-03 00:00:00,LABORABLE
12,3,2021,11,596,742,1338,2021-03-12 10:00:00,2021-12-03 00:00:00,LABORABLE
12,3,2021,12,578,779,1357,2021-03-12 11:00:00,2021-12-03 00:00:00,LABORABLE
12,3,2021,13,593,756,1349,2021-03-12 12:00:00,2021-12-03 00:00:00,LABORABLE
12,3,2021,14,660,756,1416,2021-03-12 13:00:00,2021-12-03 00:00:00,LABORABLE
12,3,2021,15,684,802,1486,2021-03-12 14:00:00,2021-12-03 00:00:00,LABORABLE
12,3,2021,16,730,710,1440,2021-03-12 15:00:00,2021-12-03 00:00:00,LABORABLE
12,3,2021,17,659,679,1338,2021-03-12 16:00:00,2021-12-03 00:00:00,LABORABLE
12,3,2021,18,749,771,1520,2021-03-12 17:00:00,2021-12-03 00:00:00,LABORABLE
12,3,2021,19,736,766,1502,2021-03-12 18:00:00,2021-12-03 00:00:00,LABORABLE
12,3,2021,20,676,878,1554,2021-03-12 19:00:00,2021-12-03 00:00:00,LABORABLE
12,3,2021,21,699,802,1501,2021-03-12 20:00:00,2021-12-03 00:00:00,LABORABLE
12,3,2021,22,564,691,1255,2021-03-12 21:00:00,2021-12-03 00:00:00,LABORABLE
12,3,2021,23,535,531,1066,2021-03-12 22:00:00,2021-12-03 00:00:00,LABORABLE
12,3,2021,24,330,413,743,2021-03-12 23:00:00,2021-12-03 00:00:00,LABORABLE
13,3,2021,1,130,206,336,2021-03-13 00:00:00,2021-03-13 00:00:00,LABORABLE
13,3,2021,2,73,100,173,2021-03-13 01:00:00,2021-03-13 00:00:00,LABORABLE
13,3,2021,3,58,70,128,2021-03-13 02:00:00,2021-03-13 00:00:00,LABORABLE
13,3,2021,4,41,51,92,2021-03-13 03:00:00,2021-03-13 00:00:00,LABORABLE
13,3,2021,5,57,95,152,2021-03-13 04:00:00,2021-03-13 00:00:00,LABORABLE
13,3,2021,6,84,105,189,2021-03-13 05:00:00,2021-03-13 00:00:00,LABORABLE
13,3,2021,7,147,164,311,2021-03-13 06:00:00,2021-03-13 00:00:00,LABORABLE
13,3,2021,8,300,287,587,2021-03-13 07:00:00,2021-03-13 00:00:00,LABORABLE
13,3,2021,9,376,397,773,2021-03-13 08:00:00,2021-03-13 00:00:00,LABORABLE
13,3,2021,10,531,565,1096,2021-03-13 09:00:00,2021-03-13 00:00:00,LABORABLE
13,3,2021,11,606,631,1237,2021-03-13 10:00:00,2021-03-13 00:00:00,LABORABLE
13,3,2021,12,634,715,1349,2021-03-13 11:00:00,2021-03-13 00:00:00,LABORABLE
13,3,2021,13,690,775,1465,2021-03-13 12:00:00,2021-03-13 00:00:00,LABORABLE
13,3,2021,14,686,789,1475,2021-03-13 13:00:00,2021-03-13 00:00:00,LABORABLE
13,3,2021,15,645,783,1428,2021-03-13 14:00:00,2021-03-13 00:00:00,LABORABLE
13,3,2021,16,543,677,1220,2021-03-13 15:00:00,2021-03-13 00:00:00,LABORABLE
13,3,2021,17,532,650,1182,2021-03-13 16:00:00,2021-03-13 00:00:00,LABORABLE
13,3,2021,18,524,720,1244,2021-03-13 17:00:00,2021-03-13 00:00:00,LABORABLE
13,3,2021,19,634,729,1363,2021-03-13 18:00:00,2021-03-13 00:00:00,LABORABLE
13,3,2021,20,643,775,1418,2021-03-13 19:00:00,2021-03-13 00:00:00,LABORABLE
13,3,2021,21,604,742,1346,2021-03-13 20:00:00,2021-03-13 00:00:00,LABORABLE
13,3,2021,22,558,635,1193,2021-03-13 21:00:00,2021-03-13 00:00:00,LABORABLE
13,3,2021,23,499,596,1095,2021-03-13 22:00:00,2021-03-13 00:00:00,LABORABLE
13,3,2021,24,369,459,828,2021-03-13 23:00:00,2021-03-13 00:00:00,LABORABLE
14,3,2021,1,150,180,330,2021-03-14 00:00:00,2021-03-14 00:00:00,LABORABLE
14,3,2021,2,65,104,169,2021-03-14 01:00:00,2021-03-14 00:00:00,LABORABLE
14,3,2021,3,56,80,136,2021-03-14 02:00:00,2021-03-14 00:00:00,LABORABLE
14,3,2021,4,40,60,100,2021-03-14 03:00:00,2021-03-14 00:00:00,LABORABLE
14,3,2021,5,24,79,103,2021-03-14 04:00:00,2021-03-14 00:00:00,LABORABLE
14,3,2021,6,42,101,143,2021-03-14 05:00:00,2021-03-14 00:00:00,LABORABLE
14,3,2021,7,85,97,182,2021-03-14 06:00:00,2021-03-14 00:00:00,LABORABLE
14,3,2021,8,158,161,319,2021-03-14 07:00:00,2021-03-14 00:00:00,LABORABLE
14,3,2021,9,216,267,483,2021-03-14 08:00:00,2021-03-14 00:00:00,LABORABLE
14,3,2021,10,331,390,721,2021-03-14 09:00:00,2021-03-14 00:00:00,LABORABLE
14,3,2021,11,486,524,1010,2021-03-14 10:00:00,2021-03-14 00:00:00,LABORABLE
14,3,2021,12,579,608,1187,2021-03-14 11:00:00,2021-03-14 00:00:00,LABORABLE
14,3,2021,13,638,608,1246,2021-03-14 12:00:00,2021-03-14 00:00:00,LABORABLE
14,3,2021,14,596,685,1281,2021-03-14 13:00:00,2021-03-14 00:00:00,LABORABLE
14,3,2021,15,597,708,1305,2021-03-14 14:00:00,2021-03-14 00:00:00,LABORABLE
14,3,2021,16,456,619,1075,2021-03-14 15:00:00,2021-03-14 00:00:00,LABORABLE
14,3,2021,17,481,617,1098,2021-03-14 16:00:00,2021-03-14 00:00:00,LABORABLE
14,3,2021,18,496,637,1133,2021-03-14 17:00:00,2021-03-14 00:00:00,LABORABLE
14,3,2021,19,536,666,1202,2021-03-14 18:00:00,2021-03-14 00:00:00,LABORABLE
14,3,2021,20,561,637,1198,2021-03-14 19:00:00,2021-03-14 00:00:00,LABORABLE
14,3,2021,21,557,660,1217,2021-03-14 20:00:00,2021-03-14 00:00:00,LABORABLE
14,3,2021,22,410,483,893,2021-03-14 21:00:00,2021-03-14 00:00:00,LABORABLE
14,3,2021,23,393,375,768,2021-03-14 22:00:00,2021-03-14 00:00:00,LABORABLE
14,3,2021,24,235,303,538,2021-03-14 23:00:00,2021-03-14 00:00:00,LABORABLE
15,3,2021,1,75,137,212,2021-03-15 00:00:00,2021-03-15 00:00:00,LABORABLE
15,3,2021,2,48,67,115,2021-03-15 01:00:00,2021-03-15 00:00:00,LABORABLE
15,3,2021,3,47,45,92,2021-03-15 02:00:00,2021-03-15 00:00:00,LABORABLE
15,3,2021,4,36,43,79,2021-03-15 03:00:00,2021-03-15 00:00:00,LABORABLE
15,3,2021,5,54,48,102,2021-03-15 04:00:00,2021-03-15 00:00:00,LABORABLE
15,3,2021,6,157,103,260,2021-03-15 05:00:00,2021-03-15 00:00:00,LABORABLE
15,3,2021,7,384,321,705,2021-03-15 06:00:00,2021-03-15 00:00:00,LABORABLE
15,3,2021,8,706,609,1315,2021-03-15 07:00:00,2021-03-15 00:00:00,LABORABLE
15,3,2021,9,676,773,1449,2021-03-15 08:00:00,2021-03-15 00:00:00,LABORABLE
15,3,2021,10,672,722,1394,2021-03-15 09:00:00,2021-03-15 00:00:00,LABORABLE
15,3,2021,11,584,681,1265,2021-03-15 10:00:00,2021-03-15 00:00:00,LABORABLE
15,3,2021,12,594,740,1334,2021-03-15 11:00:00,2021-03-15 00:00:00,LABORABLE
15,3,2021,13,590,791,1381,2021-03-15 12:00:00,2021-03-15 00:00:00,LABORABLE
15,3,2021,14,602,771,1373,2021-03-15 13:00:00,2021-03-15 00:00:00,LABORABLE
15,3,2021,15,604,678,1282,2021-03-15 14:00:00,2021-03-15 00:00:00,LABORABLE
15,3,2021,16,649,672,1321,2021-03-15 15:00:00,2021-03-15 00:00:00,LABORABLE
15,3,2021,17,652,726,1378,2021-03-15 16:00:00,2021-03-15 00:00:00,LABORABLE
15,3,2021,18,650,716,1366,2021-03-15 17:00:00,2021-03-15 00:00:00,LABORABLE
15,3,2021,19,662,781,1443,2021-03-15 18:00:00,2021-03-15 00:00:00,LABORABLE
15,3,2021,20,653,746,1399,2021-03-15 19:00:00,2021-03-15 00:00:00,LABORABLE
15,3,2021,21,577,715,1292,2021-03-15 20:00:00,2021-03-15 00:00:00,LABORABLE
15,3,2021,22,477,514,991,2021-03-15 21:00:00,2021-03-15 00:00:00,LABORABLE
15,3,2021,23,353,363,716,2021-03-15 22:00:00,2021-03-15 00:00:00,LABORABLE
15,3,2021,24,147,207,354,2021-03-15 23:00:00,2021-03-15 00:00:00,LABORABLE
16,3,2021,1,75,92,167,2021-03-16 00:00:00,2021-03-16 00:00:00,LABORABLE
16,3,2021,2,50,58,108,2021-03-16 01:00:00,2021-03-16 00:00:00,LABORABLE
16,3,2021,3,41,49,90,2021-03-16 02:00:00,2021-03-16 00:00:00,LABORABLE
16,3,2021,4,42,42,84,2021-03-16 03:00:00,2021-03-16 00:00:00,LABORABLE
16,3,2021,5,62,54,116,2021-03-16 04:00:00,2021-03-16 00:00:00,LABORABLE
16,3,2021,6,141,102,243,2021-03-16 05:00:00,2021-03-16 00:00:00,LABORABLE
16,3,2021,7,409,308,717,2021-03-16 06:00:00,2021-03-16 00:00:00,LABORABLE
16,3,2021,8,688,577,1265,2021-03-16 07:00:00,2021-03-16 00:00:00,LABORABLE
16,3,2021,9,677,676,1353,2021-03-16 08:00:00,2021-03-16 00:00:00,LABORABLE
16,3,2021,10,655,716,1371,2021-03-16 09:00:00,2021-03-16 00:00:00,LABORABLE
16,3,2021,11,556,659,1215,2021-03-16 10:00:00,2021-03-16 00:00:00,LABORABLE
16,3,2021,12,585,661,1246,2021-03-16 11:00:00,2021-03-16 00:00:00,LABORABLE
16,3,2021,13,575,783,1358,2021-03-16 12:00:00,2021-03-16 00:00:00,LABORABLE
16,3,2021,14,595,755,1350,2021-03-16 13:00:00,2021-03-16 00:00:00,LABORABLE
16,3,2021,15,653,777,1430,2021-03-16 14:00:00,2021-03-16 00:00:00,LABORABLE
16,3,2021,16,625,668,1293,2021-03-16 15:00:00,2021-03-16 00:00:00,LABORABLE
16,3,2021,17,658,686,1344,2021-03-16 16:00:00,2021-03-16 00:00:00,LABORABLE
16,3,2021,18,646,683,1329,2021-03-16 17:00:00,2021-03-16 00:00:00,LABORABLE
16,3,2021,19,622,741,1363,2021-03-16 18:00:00,2021-03-16 00:00:00,LABORABLE
16,3,2021,20,596,766,1362,2021-03-16 19:00:00,2021-03-16 00:00:00,LABORABLE
16,3,2021,21,646,720,1366,2021-03-16 20:00:00,2021-03-16 00:00:00,LABORABLE
16,3,2021,22,477,477,954,2021-03-16 21:00:00,2021-03-16 00:00:00,LABORABLE
16,3,2021,23,373,370,743,2021-03-16 22:00:00,2021-03-16 00:00:00,LABORABLE
16,3,2021,24,164,211,375,2021-03-16 23:00:00,2021-03-16 00:00:00,LABORABLE
17,3,2021,1,63,108,171,2021-03-17 00:00:00,2021-03-17 00:00:00,LABORABLE
17,3,2021,2,43,41,84,2021-03-17 01:00:00,2021-03-17 00:00:00,LABORABLE
17,3,2021,3,44,45,89,2021-03-17 02:00:00,2021-03-17 00:00:00,LABORABLE
17,3,2021,4,50,33,83,2021-03-17 03:00:00,2021-03-17 00:00:00,LABORABLE
17,3,2021,5,57,54,111,2021-03-17 04:00:00,2021-03-17 00:00:00,LABORABLE
17,3,2021,6,147,83,230,2021-03-17 05:00:00,2021-03-17 00:00:00,LABORABLE
17,3,2021,7,422,289,711,2021-03-17 06:00:00,2021-03-17 00:00:00,LABORABLE
17,3,2021,8,686,592,1278,2021-03-17 07:00:00,2021-03-17 00:00:00,LABORABLE
17,3,2021,9,713,721,1434,2021-03-17 08:00:00,2021-03-17 00:00:00,LABORABLE
17,3,2021,10,646,658,1304,2021-03-17 09:00:00,2021-03-17 00:00:00,LABORABLE
17,3,2021,11,561,738,1299,2021-03-17 10:00:00,2021-03-17 00:00:00,LABORABLE
17,3,2021,12,559,730,1289,2021-03-17 11:00:00,2021-03-17 00:00:00,LABORABLE
17,3,2021,13,600,803,1403,2021-03-17 12:00:00,2021-03-17 00:00:00,LABORABLE
17,3,2021,14,613,744,1357,2021-03-17 13:00:00,2021-03-17 00:00:00,LABORABLE
17,3,2021,15,716,691,1407,2021-03-17 14:00:00,2021-03-17 00:00:00,LABORABLE
17,3,2021,16,626,698,1324,2021-03-17 15:00:00,2021-03-17 00:00:00,LABORABLE
17,3,2021,17,604,731,1335,2021-03-17 16:00:00,2021-03-17 00:00:00,LABORABLE
17,3,2021,18,664,740,1404,2021-03-17 17:00:00,2021-03-17 00:00:00,LABORABLE
17,3,2021,19,674,710,1384,2021-03-17 18:00:00,2021-03-17 00:00:00,LABORABLE
17,3,2021,20,679,797,1476,2021-03-17 19:00:00,2021-03-17 00:00:00,LABORABLE
17,3,2021,21,618,729,1347,2021-03-17 20:00:00,2021-03-17 00:00:00,LABORABLE
17,3,2021,22,463,568,1031,2021-03-17 21:00:00,2021-03-17 00:00:00,LABORABLE
17,3,2021,23,379,379,758,2021-03-17 22:00:00,2021-03-17 00:00:00,LABORABLE
17,3,2021,24,194,224,418,2021-03-17 23:00:00,2021-03-17 00:00:00,LABORABLE
18,3,2021,1,81,91,172,2021-03-18 00:00:00,2021-03-18 00:00:00,LABORABLE
18,3,2021,2,52,51,103,2021-03-18 01:00:00,2021-03-18 00:00:00,LABORABLE
18,3,2021,3,44,51,95,2021-03-18 02:00:00,2021-03-18 00:00:00,LABORABLE
18,3,2021,4,41,34,75,2021-03-18 03:00:00,2021-03-18 00:00:00,LABORABLE
18,3,2021,5,76,76,152,2021-03-18 04:00:00,2021-03-18 00:00:00,LABORABLE
18,3,2021,6,163,119,282,2021-03-18 05:00:00,2021-03-18 00:00:00,LABORABLE
18,3,2021,7,395,283,678,2021-03-18 06:00:00,2021-03-18 00:00:00,LABORABLE
18,3,2021,8,752,561,1313,2021-03-18 07:00:00,2021-03-18 00:00:00,LABORABLE
18,3,2021,9,700,723,1423,2021-03-18 08:00:00,2021-03-18 00:00:00,LABORABLE
18,3,2021,10,665,730,1395,2021-03-18 09:00:00,2021-03-18 00:00:00,LABORABLE
18,3,2021,11,580,693,1273,2021-03-18 10:00:00,2021-03-18 00:00:00,LABORABLE
18,3,2021,12,615,747,1362,2021-03-18 11:00:00,2021-03-18 00:00:00,LABORABLE
18,3,2021,13,633,807,1440,2021-03-18 12:00:00,2021-03-18 00:00:00,LABORABLE
18,3,2021,14,680,794,1474,2021-03-18 13:00:00,2021-03-18 00:00:00,LABORABLE
18,3,2021,15,711,761,1472,2021-03-18 14:00:00,2021-03-18 00:00:00,LABORABLE
18,3,2021,16,644,699,1343,2021-03-18 15:00:00,2021-03-18 00:00:00,LABORABLE
18,3,2021,17,656,686,1342,2021-03-18 16:00:00,2021-03-18 00:00:00,LABORABLE
18,3,2021,18,710,722,1432,2021-03-18 17:00:00,2021-03-18 00:00:00,LABORABLE
18,3,2021,19,711,831,1542,2021-03-18 18:00:00,2021-03-18 00:00:00,LABORABLE
18,3,2021,20,522,869,1391,2021-03-18 19:00:00,2021-03-18 00:00:00,LABORABLE
18,3,2021,21,692,728,1420,2021-03-18 20:00:00,2021-03-18 00:00:00,LABORABLE
18,3,2021,22,566,663,1229,2021-03-18 21:00:00,2021-03-18 00:00:00,LABORABLE
18,3,2021,23,487,500,987,2021-03-18 22:00:00,2021-03-18 00:00:00,LABORABLE
18,3,2021,24,280,304,584,2021-03-18 23:00:00,2021-03-18 00:00:00,LABORABLE
19,3,2021,1,102,172,274,2021-03-19 00:00:00,2021-03-19 00:00:00,FESTIVO
19,3,2021,2,71,68,139,2021-03-19 01:00:00,2021-03-19 00:00:00,FESTIVO
19,3,2021,3,42,75,117,2021-03-19 02:00:00,2021-03-19 00:00:00,FESTIVO
19,3,2021,4,34,49,83,2021-03-19 03:00:00,2021-03-19 00:00:00,FESTIVO
19,3,2021,5,34,41,75,2021-03-19 04:00:00,2021-03-19 00:00:00,FESTIVO
19,3,2021,6,78,50,128,2021-03-19 05:00:00,2021-03-19 00:00:00,FESTIVO
19,3,2021,7,124,88,212,2021-03-19 06:00:00,2021-03-19 00:00:00,FESTIVO
19,3,2021,8,268,227,495,2021-03-19 07:00:00,2021-03-19 00:00:00,FESTIVO
19,3,2021,9,294,344,638,2021-03-19 08:00:00,2021-03-19 00:00:00,FESTIVO
19,3,2021,10,373,460,833,2021-03-19 09:00:00,2021-03-19 00:00:00,FESTIVO
19,3,2021,11,467,594,1061,2021-03-19 10:00:00,2021-03-19 00:00:00,FESTIVO
19,3,2021,12,519,611,1130,2021-03-19 11:00:00,2021-03-19 00:00:00,FESTIVO
19,3,2021,13,607,807,1414,2021-03-19 12:00:00,2021-03-19 00:00:00,FESTIVO
19,3,2021,14,659,773,1432,2021-03-19 13:00:00,2021-03-19 00:00:00,FESTIVO
19,3,2021,15,532,718,1250,2021-03-19 14:00:00,2021-03-19 00:00:00,FESTIVO
19,3,2021,16,517,633,1150,2021-03-19 15:00:00,2021-03-19 00:00:00,FESTIVO
19,3,2021,17,485,642,1127,2021-03-19 16:00:00,2021-03-19 00:00:00,FESTIVO
19,3,2021,18,560,660,1220,2021-03-19 17:00:00,2021-03-19 00:00:00,FESTIVO
19,3,2021,19,532,710,1242,2021-03-19 18:00:00,2021-03-19 00:00:00,FESTIVO
19,3,2021,20,571,697,1268,2021-03-19 19:00:00,2021-03-19 00:00:00,FESTIVO
19,3,2021,21,514,650,1164,2021-03-19 20:00:00,2021-03-19 00:00:00,FESTIVO
19,3,2021,22,479,557,1036,2021-03-19 21:00:00,2021-03-19 00:00:00,FESTIVO
19,3,2021,23,499,549,1048,2021-03-19 22:00:00,2021-03-19 00:00:00,FESTIVO
19,3,2021,24,305,388,693,2021-03-19 23:00:00,2021-03-19 00:00:00,FESTIVO
20,3,2021,1,145,137,282,2021-03-20 00:00:00,2021-03-20 00:00:00,LABORABLE
20,3,2021,2,71,87,158,2021-03-20 01:00:00,2021-03-20 00:00:00,LABORABLE
20,3,2021,3,54,59,113,2021-03-20 02:00:00,2021-03-20 00:00:00,LABORABLE
20,3,2021,4,57,43,100,2021-03-20 03:00:00,2021-03-20 00:00:00,LABORABLE
20,3,2021,5,62,57,119,2021-03-20 04:00:00,2021-03-20 00:00:00,LABORABLE
20,3,2021,6,85,74,159,2021-03-20 05:00:00,2021-03-20 00:00:00,LABORABLE
20,3,2021,7,136,131,267,2021-03-20 06:00:00,2021-03-20 00:00:00,LABORABLE
20,3,2021,8,266,241,507,2021-03-20 07:00:00,2021-03-20 00:00:00,LABORABLE
20,3,2021,9,320,318,638,2021-03-20 08:00:00,2021-03-20 00:00:00,LABORABLE
20,3,2021,10,441,491,932,2021-03-20 09:00:00,2021-03-20 00:00:00,LABORABLE
20,3,2021,11,543,615,1158,2021-03-20 10:00:00,2021-03-20 00:00:00,LABORABLE
20,3,2021,12,626,722,1348,2021-03-20 11:00:00,2021-03-20 00:00:00,LABORABLE
20,3,2021,13,672,761,1433,2021-03-20 12:00:00,2021-03-20 00:00:00,LABORABLE
20,3,2021,14,621,770,1391,2021-03-20 13:00:00,2021-03-20 00:00:00,LABORABLE
20,3,2021,15,709,745,1454,2021-03-20 14:00:00,2021-03-20 00:00:00,LABORABLE
20,3,2021,16,511,685,1196,2021-03-20 15:00:00,2021-03-20 00:00:00,LABORABLE
20,3,2021,17,497,699,1196,2021-03-20 16:00:00,2021-03-20 00:00:00,LABORABLE
20,3,2021,18,552,669,1221,2021-03-20 17:00:00,2021-03-20 00:00:00,LABORABLE
20,3,2021,19,595,770,1365,2021-03-20 18:00:00,2021-03-20 00:00:00,LABORABLE
20,3,2021,20,532,717,1249,2021-03-20 19:00:00,2021-03-20 00:00:00,LABORABLE
20,3,2021,21,575,718,1293,2021-03-20 20:00:00,2021-03-20 00:00:00,LABORABLE
20,3,2021,22,446,627,1073,2021-03-20 21:00:00,2021-03-20 00:00:00,LABORABLE
20,3,2021,23,517,602,1119,2021-03-20 22:00:00,2021-03-20 00:00:00,LABORABLE
20,3,2021,24,333,414,747,2021-03-20 23:00:00,2021-03-20 00:00:00,LABORABLE
21,3,2021,1,135,192,327,2021-03-21 00:00:00,2021-03-21 00:00:00,LABORABLE
21,3,2021,2,69,78,147,2021-03-21 01:00:00,2021-03-21 00:00:00,LABORABLE
21,3,2021,3,52,54,106,2021-03-21 02:00:00,2021-03-21 00:00:00,LABORABLE
21,3,2021,4,27,36,63,2021-03-21 03:00:00,2021-03-21 00:00:00,LABORABLE
21,3,2021,5,35,94,129,2021-03-21 04:00:00,2021-03-21 00:00:00,LABORABLE
21,3,2021,6,44,149,193,2021-03-21 05:00:00,2021-03-21 00:00:00,LABORABLE
21,3,2021,7,85,201,286,2021-03-21 06:00:00,2021-03-21 00:00:00,LABORABLE
21,3,2021,8,132,154,286,2021-03-21 07:00:00,2021-03-21 00:00:00,LABORABLE
21,3,2021,9,197,217,414,2021-03-21 08:00:00,2021-03-21 00:00:00,LABORABLE
21,3,2021,10,312,356,668,2021-03-21 09:00:00,2021-03-21 00:00:00,LABORABLE
21,3,2021,11,416,452,868,2021-03-21 10:00:00,2021-03-21 00:00:00,LABORABLE
21,3,2021,12,527,602,1129,2021-03-21 11:00:00,2021-03-21 00:00:00,LABORABLE
21,3,2021,13,574,554,1128,2021-03-21 12:00:00,2021-03-21 00:00:00,LABORABLE
21,3,2021,14,610,621,1231,2021-03-21 13:00:00,2021-03-21 00:00:00,LABORABLE
21,3,2021,15,527,639,1166,2021-03-21 14:00:00,2021-03-21 00:00:00,LABORABLE
21,3,2021,16,435,556,991,2021-03-21 15:00:00,2021-03-21 00:00:00,LABORABLE
21,3,2021,17,454,575,1029,2021-03-21 16:00:00,2021-03-21 00:00:00,LABORABLE
21,3,2021,18,471,660,1131,2021-03-21 17:00:00,2021-03-21 00:00:00,LABORABLE
21,3,2021,19,496,658,1154,2021-03-21 18:00:00,2021-03-21 00:00:00,LABORABLE
21,3,2021,20,527,614,1141,2021-03-21 19:00:00,2021-03-21 00:00:00,LABORABLE
21,3,2021,21,521,583,1104,2021-03-21 20:00:00,2021-03-21 00:00:00,LABORABLE
21,3,2021,22,436,496,932,2021-03-21 21:00:00,2021-03-21 00:00:00,LABORABLE
21,3,2021,23,387,407,794,2021-03-21 22:00:00,2021-03-21 00:00:00,LABORABLE
21,3,2021,24,217,246,463,2021-03-21 23:00:00,2021-03-21 00:00:00,LABORABLE
22,3,2021,1,79,117,196,2021-03-22 00:00:00,2021-03-22 00:00:00,LABORABLE
22,3,2021,2,53,69,122,2021-03-22 01:00:00,2021-03-22 00:00:00,LABORABLE
22,3,2021,3,35,40,75,2021-03-22 02:00:00,2021-03-22 00:00:00,LABORABLE
22,3,2021,4,38,30,68,2021-03-22 03:00:00,2021-03-22 00:00:00,LABORABLE
22,3,2021,5,59,47,106,2021-03-22 04:00:00,2021-03-22 00:00:00,LABORABLE
22,3,2021,6,135,101,236,2021-03-22 05:00:00,2021-03-22 00:00:00,LABORABLE
22,3,2021,7,397,289,686,2021-03-22 06:00:00,2021-03-22 00:00:00,LABORABLE
22,3,2021,8,744,622,1366,2021-03-22 07:00:00,2021-03-22 00:00:00,LABORABLE
22,3,2021,9,697,713,1410,2021-03-22 08:00:00,2021-03-22 00:00:00,LABORABLE
22,3,2021,10,656,708,1364,2021-03-22 09:00:00,2021-03-22 00:00:00,LABORABLE
22,3,2021,11,583,625,1208,2021-03-22 10:00:00,2021-03-22 00:00:00,LABORABLE
22,3,2021,12,603,717,1320,2021-03-22 11:00:00,2021-03-22 00:00:00,LABORABLE
22,3,2021,13,591,705,1296,2021-03-22 12:00:00,2021-03-22 00:00:00,LABORABLE
22,3,2021,14,655,790,1445,2021-03-22 13:00:00,2021-03-22 00:00:00,LABORABLE
22,3,2021,15,677,733,1410,2021-03-22 14:00:00,2021-03-22 00:00:00,LABORABLE
22,3,2021,16,643,700,1343,2021-03-22 15:00:00,2021-03-22 00:00:00,LABORABLE
22,3,2021,17,511,586,1097,2021-03-22 16:00:00,2021-03-22 00:00:00,LABORABLE
22,3,2021,18,663,762,1425,2021-03-22 17:00:00,2021-03-22 00:00:00,LABORABLE
22,3,2021,19,620,776,1396,2021-03-22 18:00:00,2021-03-22 00:00:00,LABORABLE
22,3,2021,20,649,803,1452,2021-03-22 19:00:00,2021-03-22 00:00:00,LABORABLE
22,3,2021,21,555,754,1309,2021-03-22 20:00:00,2021-03-22 00:00:00,LABORABLE
22,3,2021,22,381,488,869,2021-03-22 21:00:00,2021-03-22 00:00:00,LABORABLE
22,3,2021,23,316,309,625,2021-03-22 22:00:00,2021-03-22 00:00:00,LABORABLE
22,3,2021,24,146,193,339,2021-03-22 23:00:00,2021-03-22 00:00:00,LABORABLE
23,3,2021,1,69,84,153,2021-03-23 00:00:00,2021-03-23 00:00:00,LABORABLE
23,3,2021,2,40,36,76,2021-03-23 01:00:00,2021-03-23 00:00:00,LABORABLE
23,3,2021,3,33,46,79,2021-03-23 02:00:00,2021-03-23 00:00:00,LABORABLE
23,3,2021,4,37,32,69,2021-03-23 03:00:00,2021-03-23 00:00:00,LABORABLE
23,3,2021,5,84,64,148,2021-03-23 04:00:00,2021-03-23 00:00:00,LABORABLE
23,3,2021,6,143,98,241,2021-03-23 05:00:00,2021-03-23 00:00:00,LABORABLE
23,3,2021,7,387,288,675,2021-03-23 06:00:00,2021-03-23 00:00:00,LABORABLE
23,3,2021,8,717,605,1322,2021-03-23 07:00:00,2021-03-23 00:00:00,LABORABLE
23,3,2021,9,684,727,1411,2021-03-23 08:00:00,2021-03-23 00:00:00,LABORABLE
23,3,2021,10,550,749,1299,2021-03-23 09:00:00,2021-03-23 00:00:00,LABORABLE
23,3,2021,11,576,698,1274,2021-03-23 10:00:00,2021-03-23 00:00:00,LABORABLE
23,3,2021,12,611,663,1274,2021-03-23 11:00:00,2021-03-23 00:00:00,LABORABLE
23,3,2021,13,573,680,1253,2021-03-23 12:00:00,2021-03-23 00:00:00,LABORABLE
23,3,2021,14,611,734,1345,2021-03-23 13:00:00,2021-03-23 00:00:00,LABORABLE
23,3,2021,15,662,721,1383,2021-03-23 14:00:00,2021-03-23 00:00:00,LABORABLE
23,3,2021,16,648,631,1279,2021-03-23 15:00:00,2021-03-23 00:00:00,LABORABLE
23,3,2021,17,577,753,1330,2021-03-23 16:00:00,2021-03-23 00:00:00,LABORABLE
23,3,2021,18,641,693,1334,2021-03-23 17:00:00,2021-03-23 00:00:00,LABORABLE
23,3,2021,19,653,749,1402,2021-03-23 18:00:00,2021-03-23 00:00:00,LABORABLE
23,3,2021,20,631,740,1371,2021-03-23 19:00:00,2021-03-23 00:00:00,LABORABLE
23,3,2021,21,606,696,1302,2021-03-23 20:00:00,2021-03-23 00:00:00,LABORABLE
23,3,2021,22,498,550,1048,2021-03-23 21:00:00,2021-03-23 00:00:00,LABORABLE
23,3,2021,23,367,416,783,2021-03-23 22:00:00,2021-03-23 00:00:00,LABORABLE
23,3,2021,24,145,216,361,2021-03-23 23:00:00,2021-03-23 00:00:00,LABORABLE
24,3,2021,1,75,116,191,2021-03-24 00:00:00,2021-03-24 00:00:00,LABORABLE
24,3,2021,2,52,42,94,2021-03-24 01:00:00,2021-03-24 00:00:00,LABORABLE
24,3,2021,3,31,40,71,2021-03-24 02:00:00,2021-03-24 00:00:00,LABORABLE
24,3,2021,4,45,28,73,2021-03-24 03:00:00,2021-03-24 00:00:00,LABORABLE
24,3,2021,5,57,53,110,2021-03-24 04:00:00,2021-03-24 00:00:00,LABORABLE
24,3,2021,6,153,124,277,2021-03-24 05:00:00,2021-03-24 00:00:00,LABORABLE
24,3,2021,7,406,305,711,2021-03-24 06:00:00,2021-03-24 00:00:00,LABORABLE
24,3,2021,8,677,589,1266,2021-03-24 07:00:00,2021-03-24 00:00:00,LABORABLE
24,3,2021,9,732,725,1457,2021-03-24 08:00:00,2021-03-24 00:00:00,LABORABLE
24,3,2021,10,676,710,1386,2021-03-24 09:00:00,2021-03-24 00:00:00,LABORABLE
24,3,2021,11,542,705,1247,2021-03-24 10:00:00,2021-03-24 00:00:00,LABORABLE
24,3,2021,12,624,726,1350,2021-03-24 11:00:00,2021-03-24 00:00:00,LABORABLE
24,3,2021,13,632,697,1329,2021-03-24 12:00:00,2021-03-24 00:00:00,LABORABLE
24,3,2021,14,684,742,1426,2021-03-24 13:00:00,2021-03-24 00:00:00,LABORABLE
24,3,2021,15,730,761,1491,2021-03-24 14:00:00,2021-03-24 00:00:00,LABORABLE
24,3,2021,16,664,677,1341,2021-03-24 15:00:00,2021-03-24 00:00:00,LABORABLE
24,3,2021,17,646,725,1371,2021-03-24 16:00:00,2021-03-24 00:00:00,LABORABLE
24,3,2021,18,693,714,1407,2021-03-24 17:00:00,2021-03-24 00:00:00,LABORABLE
24,3,2021,19,681,854,1535,2021-03-24 18:00:00,2021-03-24 00:00:00,LABORABLE
24,3,2021,20,684,833,1517,2021-03-24 19:00:00,2021-03-24 00:00:00,LABORABLE
24,3,2021,21,608,671,1279,2021-03-24 20:00:00,2021-03-24 00:00:00,LABORABLE
24,3,2021,22,528,556,1084,2021-03-24 21:00:00,2021-03-24 00:00:00,LABORABLE
24,3,2021,23,419,381,800,2021-03-24 22:00:00,2021-03-24 00:00:00,LABORABLE
24,3,2021,24,191,247,438,2021-03-24 23:00:00,2021-03-24 00:00:00,LABORABLE
25,3,2021,1,68,69,137,2021-03-25 00:00:00,2021-03-25 00:00:00,LABORABLE
25,3,2021,2,51,59,110,2021-03-25 01:00:00,2021-03-25 00:00:00,LABORABLE
25,3,2021,3,52,49,101,2021-03-25 02:00:00,2021-03-25 00:00:00,LABORABLE
25,3,2021,4,42,43,85,2021-03-25 03:00:00,2021-03-25 00:00:00,LABORABLE
25,3,2021,5,71,48,119,2021-03-25 04:00:00,2021-03-25 00:00:00,LABORABLE
25,3,2021,6,169,438,607,2021-03-25 05:00:00,2021-03-25 00:00:00,LABORABLE
25,3,2021,7,406,373,779,2021-03-25 06:00:00,2021-03-25 00:00:00,LABORABLE
25,3,2021,8,725,786,1511,2021-03-25 07:00:00,2021-03-25 00:00:00,LABORABLE
25,3,2021,9,744,1039,1783,2021-03-25 08:00:00,2021-03-25 00:00:00,LABORABLE
25,3,2021,10,682,851,1533,2021-03-25 09:00:00,2021-03-25 00:00:00,LABORABLE
25,3,2021,11,651,787,1438,2021-03-25 10:00:00,2021-03-25 00:00:00,LABORABLE
25,3,2021,12,654,739,1393,2021-03-25 11:00:00,2021-03-25 00:00:00,LABORABLE
25,3,2021,13,654,750,1404,2021-03-25 12:00:00,2021-03-25 00:00:00,LABORABLE
25,3,2021,14,709,795,1504,2021-03-25 13:00:00,2021-03-25 00:00:00,LABORABLE
25,3,2021,15,682,729,1411,2021-03-25 14:00:00,2021-03-25 00:00:00,LABORABLE
25,3,2021,16,692,700,1392,2021-03-25 15:00:00,2021-03-25 00:00:00,LABORABLE
25,3,2021,17,678,676,1354,2021-03-25 16:00:00,2021-03-25 00:00:00,LABORABLE
25,3,2021,18,662,752,1414,2021-03-25 17:00:00,2021-03-25 00:00:00,LABORABLE
25,3,2021,19,658,754,1412,2021-03-25 18:00:00,2021-03-25 00:00:00,LABORABLE
25,3,2021,20,540,796,1336,2021-03-25 19:00:00,2021-03-25 00:00:00,LABORABLE
25,3,2021,21,631,711,1342,2021-03-25 20:00:00,2021-03-25 00:00:00,LABORABLE
25,3,2021,22,528,593,1121,2021-03-25 21:00:00,2021-03-25 00:00:00,LABORABLE
25,3,2021,23,479,434,913,2021-03-25 22:00:00,2021-03-25 00:00:00,LABORABLE
25,3,2021,24,243,258,501,2021-03-25 23:00:00,2021-03-25 00:00:00,LABORABLE
26,3,2021,1,97,116,213,2021-03-26 00:00:00,2021-03-26 00:00:00,LABORABLE
26,3,2021,2,48,50,98,2021-03-26 01:00:00,2021-03-26 00:00:00,LABORABLE
26,3,2021,3,57,50,107,2021-03-26 02:00:00,2021-03-26 00:00:00,LABORABLE
26,3,2021,4,43,44,87,2021-03-26 03:00:00,2021-03-26 00:00:00,LABORABLE
26,3,2021,5,82,46,128,2021-03-26 04:00:00,2021-03-26 00:00:00,LABORABLE
26,3,2021,6,163,110,273,2021-03-26 05:00:00,2021-03-26 00:00:00,LABORABLE
26,3,2021,7,410,300,710,2021-03-26 06:00:00,2021-03-26 00:00:00,LABORABLE
26,3,2021,8,723,576,1299,2021-03-26 07:00:00,2021-03-26 00:00:00,LABORABLE
26,3,2021,9,591,655,1246,2021-03-26 08:00:00,2021-03-26 00:00:00,LABORABLE
26,3,2021,10,595,657,1252,2021-03-26 09:00:00,2021-03-26 00:00:00,LABORABLE
26,3,2021,11,574,651,1225,2021-03-26 10:00:00,2021-03-26 00:00:00,LABORABLE
26,3,2021,12,629,755,1384,2021-03-26 11:00:00,2021-03-26 00:00:00,LABORABLE
26,3,2021,13,676,743,1419,2021-03-26 12:00:00,2021-03-26 00:00:00,LABORABLE
26,3,2021,14,664,780,1444,2021-03-26 13:00:00,2021-03-26 00:00:00,LABORABLE
26,3,2021,15,656,751,1407,2021-03-26 14:00:00,2021-03-26 00:00:00,LABORABLE
26,3,2021,16,662,743,1405,2021-03-26 15:00:00,2021-03-26 00:00:00,LABORABLE
26,3,2021,17,630,701,1331,2021-03-26 16:00:00,2021-03-26 00:00:00,LABORABLE
26,3,2021,18,695,817,1512,2021-03-26 17:00:00,2021-03-26 00:00:00,LABORABLE
26,3,2021,19,714,754,1468,2021-03-26 18:00:00,2021-03-26 00:00:00,LABORABLE
26,3,2021,20,669,810,1479,2021-03-26 19:00:00,2021-03-26 00:00:00,LABORABLE
26,3,2021,21,627,766,1393,2021-03-26 20:00:00,2021-03-26 00:00:00,LABORABLE
26,3,2021,22,521,675,1196,2021-03-26 21:00:00,2021-03-26 00:00:00,LABORABLE
26,3,2021,23,534,584,1118,2021-03-26 22:00:00,2021-03-26 00:00:00,LABORABLE
26,3,2021,24,347,383,730,2021-03-26 23:00:00,2021-03-26 00:00:00,LABORABLE
27,3,2021,1,126,174,300,2021-03-27 00:00:00,2021-03-27 00:00:00,LABORABLE
27,3,2021,2,65,92,157,2021-03-27 01:00:00,2021-03-27 00:00:00,LABORABLE
27,3,2021,3,49,73,122,2021-03-27 02:00:00,2021-03-27 00:00:00,LABORABLE
27,3,2021,4,48,57,105,2021-03-27 03:00:00,2021-03-27 00:00:00,LABORABLE
27,3,2021,5,49,75,124,2021-03-27 04:00:00,2021-03-27 00:00:00,LABORABLE
27,3,2021,6,95,86,181,2021-03-27 05:00:00,2021-03-27 00:00:00,LABORABLE
27,3,2021,7,165,135,300,2021-03-27 06:00:00,2021-03-27 00:00:00,LABORABLE
27,3,2021,8,291,280,571,2021-03-27 07:00:00,2021-03-27 00:00:00,LABORABLE
27,3,2021,9,337,368,705,2021-03-27 08:00:00,2021-03-27 00:00:00,LABORABLE
27,3,2021,10,489,488,977,2021-03-27 09:00:00,2021-03-27 00:00:00,LABORABLE
27,3,2021,11,595,649,1244,2021-03-27 10:00:00,2021-03-27 00:00:00,LABORABLE
27,3,2021,12,613,737,1350,2021-03-27 11:00:00,2021-03-27 00:00:00,LABORABLE
27,3,2021,13,627,778,1405,2021-03-27 12:00:00,2021-03-27 00:00:00,LABORABLE
27,3,2021,14,720,788,1508,2021-03-27 13:00:00,2021-03-27 00:00:00,LABORABLE
27,3,2021,15,642,718,1360,2021-03-27 14:00:00,2021-03-27 00:00:00,LABORABLE
27,3,2021,16,487,649,1136,2021-03-27 15:00:00,2021-03-27 00:00:00,LABORABLE
27,3,2021,17,485,679,1164,2021-03-27 16:00:00,2021-03-27 00:00:00,LABORABLE
27,3,2021,18,567,744,1311,2021-03-27 17:00:00,2021-03-27 00:00:00,LABORABLE
27,3,2021,19,597,711,1308,2021-03-27 18:00:00,2021-03-27 00:00:00,LABORABLE
27,3,2021,20,614,709,1323,2021-03-27 19:00:00,2021-03-27 00:00:00,LABORABLE
27,3,2021,21,596,653,1249,2021-03-27 20:00:00,2021-03-27 00:00:00,LABORABLE
27,3,2021,22,491,640,1131,2021-03-27 21:00:00,2021-03-27 00:00:00,LABORABLE
27,3,2021,23,555,620,1175,2021-03-27 22:00:00,2021-03-27 00:00:00,LABORABLE
27,3,2021,24,345,398,743,2021-03-27 23:00:00,2021-03-27 00:00:00,LABORABLE
28,3,2021,1,151,206,357,2021-03-28 00:00:00,2021-03-28 00:00:00,LABORABLE
28,3,2021,2,74,113,187,2021-03-28 01:00:00,2021-03-28 00:00:00,LABORABLE
28,3,2021,3,0,0,0,2021-03-28 02:00:00,2021-03-28 00:00:00,LABORABLE
28,3,2021,4,30,62,92,2021-03-28 03:00:00,2021-03-28 00:00:00,LABORABLE
28,3,2021,5,44,49,93,2021-03-28 04:00:00,2021-03-28 00:00:00,LABORABLE
28,3,2021,6,61,52,113,2021-03-28 05:00:00,2021-03-28 00:00:00,LABORABLE
28,3,2021,7,86,98,184,2021-03-28 06:00:00,2021-03-28 00:00:00,LABORABLE
28,3,2021,8,162,155,317,2021-03-28 07:00:00,2021-03-28 00:00:00,LABORABLE
28,3,2021,9,199,231,430,2021-03-28 08:00:00,2021-03-28 00:00:00,LABORABLE
28,3,2021,10,319,355,674,2021-03-28 09:00:00,2021-03-28 00:00:00,LABORABLE
28,3,2021,11,402,447,849,2021-03-28 10:00:00,2021-03-28 00:00:00,LABORABLE
28,3,2021,12,523,587,1110,2021-03-28 11:00:00,2021-03-28 00:00:00,LABORABLE
28,3,2021,13,605,634,1239,2021-03-28 12:00:00,2021-03-28 00:00:00,LABORABLE
28,3,2021,14,612,727,1339,2021-03-28 13:00:00,2021-03-28 00:00:00,LABORABLE
28,3,2021,15,595,634,1229,2021-03-28 14:00:00,2021-03-28 00:00:00,LABORABLE
28,3,2021,16,411,602,1013,2021-03-28 15:00:00,2021-03-28 00:00:00,LABORABLE
28,3,2021,17,454,623,1077,2021-03-28 16:00:00,2021-03-28 00:00:00,LABORABLE
28,3,2021,18,512,622,1134,2021-03-28 17:00:00,2021-03-28 00:00:00,LABORABLE
28,3,2021,19,512,640,1152,2021-03-28 18:00:00,2021-03-28 00:00:00,LABORABLE
28,3,2021,20,482,703,1185,2021-03-28 19:00:00,2021-03-28 00:00:00,LABORABLE
28,3,2021,21,506,633,1139,2021-03-28 20:00:00,2021-03-28 00:00:00,LABORABLE
28,3,2021,22,474,599,1073,2021-03-28 21:00:00,2021-03-28 00:00:00,LABORABLE
28,3,2021,23,453,539,992,2021-03-28 22:00:00,2021-03-28 00:00:00,LABORABLE
28,3,2021,24,274,323,597,2021-03-28 23:00:00,2021-03-28 00:00:00,LABORABLE
29,3,2021,1,110,154,264,2021-03-29 00:00:00,2021-03-29 00:00:00,LABORABLE
29,3,2021,2,54,70,124,2021-03-29 01:00:00,2021-03-29 00:00:00,LABORABLE
29,3,2021,3,47,52,99,2021-03-29 02:00:00,2021-03-29 00:00:00,LABORABLE
29,3,2021,4,41,35,76,2021-03-29 03:00:00,2021-03-29 00:00:00,LABORABLE
29,3,2021,5,55,49,104,2021-03-29 04:00:00,2021-03-29 00:00:00,LABORABLE
29,3,2021,6,140,84,224,2021-03-29 05:00:00,2021-03-29 00:00:00,LABORABLE
29,3,2021,7,380,296,676,2021-03-29 06:00:00,2021-03-29 00:00:00,LABORABLE
29,3,2021,8,686,498,1184,2021-03-29 07:00:00,2021-03-29 00:00:00,LABORABLE
29,3,2021,9,491,498,989,2021-03-29 08:00:00,2021-03-29 00:00:00,LABORABLE
29,3,2021,10,583,621,1204,2021-03-29 09:00:00,2021-03-29 00:00:00,LABORABLE
29,3,2021,11,543,667,1210,2021-03-29 10:00:00,2021-03-29 00:00:00,LABORABLE
29,3,2021,12,593,693,1286,2021-03-29 11:00:00,2021-03-29 00:00:00,LABORABLE
29,3,2021,13,560,746,1306,2021-03-29 12:00:00,2021-03-29 00:00:00,LABORABLE
29,3,2021,14,643,781,1424,2021-03-29 13:00:00,2021-03-29 00:00:00,LABORABLE
29,3,2021,15,657,710,1367,2021-03-29 14:00:00,2021-03-29 00:00:00,LABORABLE
29,3,2021,16,564,631,1195,2021-03-29 15:00:00,2021-03-29 00:00:00,LABORABLE
29,3,2021,17,526,635,1161,2021-03-29 16:00:00,2021-03-29 00:00:00,LABORABLE
29,3,2021,18,615,727,1342,2021-03-29 17:00:00,2021-03-29 00:00:00,LABORABLE
29,3,2021,19,692,813,1505,2021-03-29 18:00:00,2021-03-29 00:00:00,LABORABLE
29,3,2021,20,607,787,1394,2021-03-29 19:00:00,2021-03-29 00:00:00,LABORABLE
29,3,2021,21,576,702,1278,2021-03-29 20:00:00,2021-03-29 00:00:00,LABORABLE
29,3,2021,22,446,573,1019,2021-03-29 21:00:00,2021-03-29 00:00:00,LABORABLE
29,3,2021,23,414,450,864,2021-03-29 22:00:00,2021-03-29 00:00:00,LABORABLE
29,3,2021,24,176,240,416,2021-03-29 23:00:00,2021-03-29 00:00:00,LABORABLE
30,3,2021,1,75,114,189,2021-03-30 00:00:00,2021-03-30 00:00:00,LABORABLE
30,3,2021,2,38,49,87,2021-03-30 01:00:00,2021-03-30 00:00:00,LABORABLE
30,3,2021,3,53,56,109,2021-03-30 02:00:00,2021-03-30 00:00:00,LABORABLE
30,3,2021,4,44,45,89,2021-03-30 03:00:00,2021-03-30 00:00:00,LABORABLE
30,3,2021,5,61,57,118,2021-03-30 04:00:00,2021-03-30 00:00:00,LABORABLE
30,3,2021,6,158,84,242,2021-03-30 05:00:00,2021-03-30 00:00:00,LABORABLE
30,3,2021,7,357,282,639,2021-03-30 06:00:00,2021-03-30 00:00:00,LABORABLE
30,3,2021,8,581,459,1040,2021-03-30 07:00:00,2021-03-30 00:00:00,LABORABLE
30,3,2021,9,591,611,1202,2021-03-30 08:00:00,2021-03-30 00:00:00,LABORABLE
30,3,2021,10,571,619,1190,2021-03-30 09:00:00,2021-03-30 00:00:00,LABORABLE
30,3,2021,11,531,612,1143,2021-03-30 10:00:00,2021-03-30 00:00:00,LABORABLE
30,3,2021,12,466,569,1035,2021-03-30 11:00:00,2021-03-30 00:00:00,LABORABLE
30,3,2021,13,599,759,1358,2021-03-30 12:00:00,2021-03-30 00:00:00,LABORABLE
30,3,2021,14,650,773,1423,2021-03-30 13:00:00,2021-03-30 00:00:00,LABORABLE
30,3,2021,15,616,728,1344,2021-03-30 14:00:00,2021-03-30 00:00:00,LABORABLE
30,3,2021,16,542,706,1248,2021-03-30 15:00:00,2021-03-30 00:00:00,LABORABLE
30,3,2021,17,621,709,1330,2021-03-30 16:00:00,2021-03-30 00:00:00,LABORABLE
30,3,2021,18,644,737,1381,2021-03-30 17:00:00,2021-03-30 00:00:00,LABORABLE
30,3,2021,19,631,802,1433,2021-03-30 18:00:00,2021-03-30 00:00:00,LABORABLE
30,3,2021,20,656,811,1467,2021-03-30 19:00:00,2021-03-30 00:00:00,LABORABLE
30,3,2021,21,627,734,1361,2021-03-30 20:00:00,2021-03-30 00:00:00,LABORABLE
30,3,2021,22,526,548,1074,2021-03-30 21:00:00,2021-03-30 00:00:00,LABORABLE
30,3,2021,23,409,465,874,2021-03-30 22:00:00,2021-03-30 00:00:00,LABORABLE
30,3,2021,24,227,278,505,2021-03-30 23:00:00,2021-03-30 00:00:00,LABORABLE
31,3,2021,1,63,121,184,2021-03-31 00:00:00,2021-03-31 00:00:00,LABORABLE
31,3,2021,2,51,54,105,2021-03-31 01:00:00,2021-03-31 00:00:00,LABORABLE
31,3,2021,3,48,47,95,2021-03-31 02:00:00,2021-03-31 00:00:00,LABORABLE
31,3,2021,4,47,37,84,2021-03-31 03:00:00,2021-03-31 00:00:00,LABORABLE
31,3,2021,5,66,65,131,2021-03-31 04:00:00,2021-03-31 00:00:00,LABORABLE
31,3,2021,6,159,87,246,2021-03-31 05:00:00,2021-03-31 00:00:00,LABORABLE
31,3,2021,7,351,289,640,2021-03-31 06:00:00,2021-03-31 00:00:00,LABORABLE
31,3,2021,8,613,507,1120,2021-03-31 07:00:00,2021-03-31 00:00:00,LABORABLE
31,3,2021,9,585,560,1145,2021-03-31 08:00:00,2021-03-31 00:00:00,LABORABLE
31,3,2021,10,569,700,1269,2021-03-31 09:00:00,2021-03-31 00:00:00,LABORABLE
31,3,2021,11,557,733,1290,2021-03-31 10:00:00,2021-03-31 00:00:00,LABORABLE
31,3,2021,12,641,696,1337,2021-03-31 11:00:00,2021-03-31 00:00:00,LABORABLE
31,3,2021,13,620,795,1415,2021-03-31 12:00:00,2021-03-31 00:00:00,LABORABLE
31,3,2021,14,692,760,1452,2021-03-31 13:00:00,2021-03-31 00:00:00,LABORABLE
31,3,2021,15,682,710,1392,2021-03-31 14:00:00,2021-03-31 00:00:00,LABORABLE
31,3,2021,16,586,727,1313,2021-03-31 15:00:00,2021-03-31 00:00:00,LABORABLE
31,3,2021,17,580,704,1284,2021-03-31 16:00:00,2021-03-31 00:00:00,LABORABLE
31,3,2021,18,658,768,1426,2021-03-31 17:00:00,2021-03-31 00:00:00,LABORABLE
31,3,2021,19,710,768,1478,2021-03-31 18:00:00,2021-03-31 00:00:00,LABORABLE
31,3,2021,20,691,778,1469,2021-03-31 19:00:00,2021-03-31 00:00:00,LABORABLE
31,3,2021,21,688,822,1510,2021-03-31 20:00:00,2021-03-31 00:00:00,LABORABLE
31,3,2021,22,631,740,1371,2021-03-31 21:00:00,2021-03-31 00:00:00,LABORABLE
31,3,2021,23,544,564,1108,2021-03-31 22:00:00,2021-03-31 00:00:00,LABORABLE
31,3,2021,24,304,388,692,2021-03-31 23:00:00,2021-03-31 00:00:00,LABORABLE
1,4,2021,1,139,151,290,2021-04-01 00:00:00,2021-01-04 00:00:00,FESTIVO
1,4,2021,2,44,53,97,2021-04-01 01:00:00,2021-01-04 00:00:00,FESTIVO
1,4,2021,3,52,52,104,2021-04-01 02:00:00,2021-01-04 00:00:00,FESTIVO
1,4,2021,4,40,54,94,2021-04-01 03:00:00,2021-01-04 00:00:00,FESTIVO
1,4,2021,5,32,53,85,2021-04-01 04:00:00,2021-01-04 00:00:00,FESTIVO
1,4,2021,6,62,60,122,2021-04-01 05:00:00,2021-01-04 00:00:00,FESTIVO
1,4,2021,7,121,113,234,2021-04-01 06:00:00,2021-01-04 00:00:00,FESTIVO
1,4,2021,8,205,195,400,2021-04-01 07:00:00,2021-01-04 00:00:00,FESTIVO
1,4,2021,9,318,298,616,2021-04-01 08:00:00,2021-01-04 00:00:00,FESTIVO
1,4,2021,10,374,465,839,2021-04-01 09:00:00,2021-01-04 00:00:00,FESTIVO
1,4,2021,11,453,502,955,2021-04-01 10:00:00,2021-01-04 00:00:00,FESTIVO
1,4,2021,12,571,649,1220,2021-04-01 11:00:00,2021-01-04 00:00:00,FESTIVO
1,4,2021,13,582,632,1214,2021-04-01 12:00:00,2021-01-04 00:00:00,FESTIVO
1,4,2021,14,576,670,1246,2021-04-01 13:00:00,2021-01-04 00:00:00,FESTIVO
1,4,2021,15,496,635,1131,2021-04-01 14:00:00,2021-01-04 00:00:00,FESTIVO
1,4,2021,16,420,592,1012,2021-04-01 15:00:00,2021-01-04 00:00:00,FESTIVO
1,4,2021,17,431,600,1031,2021-04-01 16:00:00,2021-01-04 00:00:00,FESTIVO
1,4,2021,18,528,606,1134,2021-04-01 17:00:00,2021-01-04 00:00:00,FESTIVO
1,4,2021,19,516,680,1196,2021-04-01 18:00:00,2021-01-04 00:00:00,FESTIVO
1,4,2021,20,491,664,1155,2021-04-01 19:00:00,2021-01-04 00:00:00,FESTIVO
1,4,2021,21,516,692,1208,2021-04-01 20:00:00,2021-01-04 00:00:00,FESTIVO
1,4,2021,22,510,616,1126,2021-04-01 21:00:00,2021-01-04 00:00:00,FESTIVO
1,4,2021,23,517,536,1053,2021-04-01 22:00:00,2021-01-04 00:00:00,FESTIVO
1,4,2021,24,354,399,753,2021-04-01 23:00:00,2021-01-04 00:00:00,FESTIVO
2,4,2021,1,162,186,348,2021-04-02 00:00:00,2021-02-04 00:00:00,FESTIVO
2,4,2021,2,57,93,150,2021-04-02 01:00:00,2021-02-04 00:00:00,FESTIVO
2,4,2021,3,45,73,118,2021-04-02 02:00:00,2021-02-04 00:00:00,FESTIVO
2,4,2021,4,33,45,78,2021-04-02 03:00:00,2021-02-04 00:00:00,FESTIVO
2,4,2021,5,25,36,61,2021-04-02 04:00:00,2021-02-04 00:00:00,FESTIVO
2,4,2021,6,44,58,102,2021-04-02 05:00:00,2021-02-04 00:00:00,FESTIVO
2,4,2021,7,97,94,191,2021-04-02 06:00:00,2021-02-04 00:00:00,FESTIVO
2,4,2021,8,153,161,314,2021-04-02 07:00:00,2021-02-04 00:00:00,FESTIVO
2,4,2021,9,194,223,417,2021-04-02 08:00:00,2021-02-04 00:00:00,FESTIVO
2,4,2021,10,258,359,617,2021-04-02 09:00:00,2021-02-04 00:00:00,FESTIVO
2,4,2021,11,336,423,759,2021-04-02 10:00:00,2021-02-04 00:00:00,FESTIVO
2,4,2021,12,445,584,1029,2021-04-02 11:00:00,2021-02-04 00:00:00,FESTIVO
2,4,2021,13,543,643,1186,2021-04-02 12:00:00,2021-02-04 00:00:00,FESTIVO
2,4,2021,14,552,670,1222,2021-04-02 13:00:00,2021-02-04 00:00:00,FESTIVO
2,4,2021,15,514,605,1119,2021-04-02 14:00:00,2021-02-04 00:00:00,FESTIVO
2,4,2021,16,346,534,880,2021-04-02 15:00:00,2021-02-04 00:00:00,FESTIVO
2,4,2021,17,402,531,933,2021-04-02 16:00:00,2021-02-04 00:00:00,FESTIVO
2,4,2021,18,482,601,1083,2021-04-02 17:00:00,2021-02-04 00:00:00,FESTIVO
2,4,2021,19,530,625,1155,2021-04-02 18:00:00,2021-02-04 00:00:00,FESTIVO
2,4,2021,20,457,635,1092,2021-04-02 19:00:00,2021-02-04 00:00:00,FESTIVO
2,4,2021,21,477,591,1068,2021-04-02 20:00:00,2021-02-04 00:00:00,FESTIVO
2,4,2021,22,499,593,1092,2021-04-02 21:00:00,2021-02-04 00:00:00,FESTIVO
2,4,2021,23,491,490,981,2021-04-02 22:00:00,2021-02-04 00:00:00,FESTIVO
2,4,2021,24,320,377,697,2021-04-02 23:00:00,2021-02-04 00:00:00,FESTIVO
3,4,2021,1,147,174,321,2021-04-03 00:00:00,2021-03-04 00:00:00,LABORABLE
3,4,2021,2,66,78,144,2021-04-03 01:00:00,2021-03-04 00:00:00,LABORABLE
3,4,2021,3,53,64,117,2021-04-03 02:00:00,2021-03-04 00:00:00,LABORABLE
3,4,2021,4,49,53,102,2021-04-03 03:00:00,2021-03-04 00:00:00,LABORABLE
3,4,2021,5,47,54,101,2021-04-03 04:00:00,2021-03-04 00:00:00,LABORABLE
3,4,2021,6,82,75,157,2021-04-03 05:00:00,2021-03-04 00:00:00,LABORABLE
3,4,2021,7,126,127,253,2021-04-03 06:00:00,2021-03-04 00:00:00,LABORABLE
3,4,2021,8,224,191,415,2021-04-03 07:00:00,2021-03-04 00:00:00,LABORABLE
3,4,2021,9,278,320,598,2021-04-03 08:00:00,2021-03-04 00:00:00,LABORABLE
3,4,2021,10,383,428,811,2021-04-03 09:00:00,2021-03-04 00:00:00,LABORABLE
3,4,2021,11,497,570,1067,2021-04-03 10:00:00,2021-03-04 00:00:00,LABORABLE
3,4,2021,12,656,692,1348,2021-04-03 11:00:00,2021-03-04 00:00:00,LABORABLE
3,4,2021,13,652,746,1398,2021-04-03 12:00:00,2021-03-04 00:00:00,LABORABLE
3,4,2021,14,636,767,1403,2021-04-03 13:00:00,2021-03-04 00:00:00,LABORABLE
3,4,2021,15,599,736,1335,2021-04-03 14:00:00,2021-03-04 00:00:00,LABORABLE
3,4,2021,16,486,693,1179,2021-04-03 15:00:00,2021-03-04 00:00:00,LABORABLE
3,4,2021,17,481,664,1145,2021-04-03 16:00:00,2021-03-04 00:00:00,LABORABLE
3,4,2021,18,592,675,1267,2021-04-03 17:00:00,2021-03-04 00:00:00,LABORABLE
3,4,2021,19,615,686,1301,2021-04-03 18:00:00,2021-03-04 00:00:00,LABORABLE
3,4,2021,20,561,736,1297,2021-04-03 19:00:00,2021-03-04 00:00:00,LABORABLE
3,4,2021,21,512,710,1222,2021-04-03 20:00:00,2021-03-04 00:00:00,LABORABLE
3,4,2021,22,522,654,1176,2021-04-03 21:00:00,2021-03-04 00:00:00,LABORABLE
3,4,2021,23,537,571,1108,2021-04-03 22:00:00,2021-03-04 00:00:00,LABORABLE
3,4,2021,24,351,419,770,2021-04-03 23:00:00,2021-03-04 00:00:00,LABORABLE
4,4,2021,1,175,193,368,2021-04-04 00:00:00,2021-04-04 00:00:00,LABORABLE
4,4,2021,2,71,109,180,2021-04-04 01:00:00,2021-04-04 00:00:00,LABORABLE
4,4,2021,3,50,64,114,2021-04-04 02:00:00,2021-04-04 00:00:00,LABORABLE
4,4,2021,4,32,47,79,2021-04-04 03:00:00,2021-04-04 00:00:00,LABORABLE
4,4,2021,5,32,42,74,2021-04-04 04:00:00,2021-04-04 00:00:00,LABORABLE
4,4,2021,6,60,67,127,2021-04-04 05:00:00,2021-04-04 00:00:00,LABORABLE
4,4,2021,7,83,117,200,2021-04-04 06:00:00,2021-04-04 00:00:00,LABORABLE
4,4,2021,8,127,125,252,2021-04-04 07:00:00,2021-04-04 00:00:00,LABORABLE
4,4,2021,9,184,207,391,2021-04-04 08:00:00,2021-04-04 00:00:00,LABORABLE
4,4,2021,10,303,350,653,2021-04-04 09:00:00,2021-04-04 00:00:00,LABORABLE
4,4,2021,11,412,477,889,2021-04-04 10:00:00,2021-04-04 00:00:00,LABORABLE
4,4,2021,12,563,614,1177,2021-04-04 11:00:00,2021-04-04 00:00:00,LABORABLE
4,4,2021,13,558,662,1220,2021-04-04 12:00:00,2021-04-04 00:00:00,LABORABLE
4,4,2021,14,634,716,1350,2021-04-04 13:00:00,2021-04-04 00:00:00,LABORABLE
4,4,2021,15,567,654,1221,2021-04-04 14:00:00,2021-04-04 00:00:00,LABORABLE
4,4,2021,16,405,587,992,2021-04-04 15:00:00,2021-04-04 00:00:00,LABORABLE
4,4,2021,17,423,652,1075,2021-04-04 16:00:00,2021-04-04 00:00:00,LABORABLE
4,4,2021,18,481,629,1110,2021-04-04 17:00:00,2021-04-04 00:00:00,LABORABLE
4,4,2021,19,520,690,1210,2021-04-04 18:00:00,2021-04-04 00:00:00,LABORABLE
4,4,2021,20,512,675,1187,2021-04-04 19:00:00,2021-04-04 00:00:00,LABORABLE
4,4,2021,21,509,654,1163,2021-04-04 20:00:00,2021-04-04 00:00:00,LABORABLE
4,4,2021,22,509,620,1129,2021-04-04 21:00:00,2021-04-04 00:00:00,LABORABLE
4,4,2021,23,471,530,1001,2021-04-04 22:00:00,2021-04-04 00:00:00,LABORABLE
4,4,2021,24,284,352,636,2021-04-04 23:00:00,2021-04-04 00:00:00,LABORABLE
5,4,2021,1,97,153,250,2021-04-05 00:00:00,2021-05-04 00:00:00,LABORABLE
5,4,2021,2,68,81,149,2021-04-05 01:00:00,2021-05-04 00:00:00,LABORABLE
5,4,2021,3,33,51,84,2021-04-05 02:00:00,2021-05-04 00:00:00,LABORABLE
5,4,2021,4,36,36,72,2021-04-05 03:00:00,2021-05-04 00:00:00,LABORABLE
5,4,2021,5,54,45,99,2021-04-05 04:00:00,2021-05-04 00:00:00,LABORABLE
5,4,2021,6,157,83,240,2021-04-05 05:00:00,2021-05-04 00:00:00,LABORABLE
5,4,2021,7,372,322,694,2021-04-05 06:00:00,2021-05-04 00:00:00,LABORABLE
5,4,2021,8,615,506,1121,2021-04-05 07:00:00,2021-05-04 00:00:00,LABORABLE
5,4,2021,9,540,662,1202,2021-04-05 08:00:00,2021-05-04 00:00:00,LABORABLE
5,4,2021,10,574,675,1249,2021-04-05 09:00:00,2021-05-04 00:00:00,LABORABLE
5,4,2021,11,557,663,1220,2021-04-05 10:00:00,2021-05-04 00:00:00,LABORABLE
5,4,2021,12,617,693,1310,2021-04-05 11:00:00,2021-05-04 00:00:00,LABORABLE
5,4,2021,13,463,624,1087,2021-04-05 12:00:00,2021-05-04 00:00:00,LABORABLE
5,4,2021,14,649,808,1457,2021-04-05 13:00:00,2021-05-04 00:00:00,LABORABLE
5,4,2021,15,661,709,1370,2021-04-05 14:00:00,2021-05-04 00:00:00,LABORABLE
5,4,2021,16,610,661,1271,2021-04-05 15:00:00,2021-05-04 00:00:00,LABORABLE
5,4,2021,17,624,714,1338,2021-04-05 16:00:00,2021-05-04 00:00:00,LABORABLE
5,4,2021,18,643,729,1372,2021-04-05 17:00:00,2021-05-04 00:00:00,LABORABLE
5,4,2021,19,695,772,1467,2021-04-05 18:00:00,2021-05-04 00:00:00,LABORABLE
5,4,2021,20,649,761,1410,2021-04-05 19:00:00,2021-05-04 00:00:00,LABORABLE
5,4,2021,21,599,694,1293,2021-04-05 20:00:00,2021-05-04 00:00:00,LABORABLE
5,4,2021,22,509,613,1122,2021-04-05 21:00:00,2021-05-04 00:00:00,LABORABLE
5,4,2021,23,422,443,865,2021-04-05 22:00:00,2021-05-04 00:00:00,LABORABLE
5,4,2021,24,188,255,443,2021-04-05 23:00:00,2021-05-04 00:00:00,LABORABLE
6,4,2021,1,75,106,181,2021-04-06 00:00:00,2021-06-04 00:00:00,LABORABLE
6,4,2021,2,50,56,106,2021-04-06 01:00:00,2021-06-04 00:00:00,LABORABLE
6,4,2021,3,42,36,78,2021-04-06 02:00:00,2021-06-04 00:00:00,LABORABLE
6,4,2021,4,40,40,80,2021-04-06 03:00:00,2021-06-04 00:00:00,LABORABLE
6,4,2021,5,67,58,125,2021-04-06 04:00:00,2021-06-04 00:00:00,LABORABLE
6,4,2021,6,144,97,241,2021-04-06 05:00:00,2021-06-04 00:00:00,LABORABLE
6,4,2021,7,414,307,721,2021-04-06 06:00:00,2021-06-04 00:00:00,LABORABLE
6,4,2021,8,691,549,1240,2021-04-06 07:00:00,2021-06-04 00:00:00,LABORABLE
6,4,2021,9,701,713,1414,2021-04-06 08:00:00,2021-06-04 00:00:00,LABORABLE
6,4,2021,10,629,713,1342,2021-04-06 09:00:00,2021-06-04 00:00:00,LABORABLE
6,4,2021,11,533,651,1184,2021-04-06 10:00:00,2021-06-04 00:00:00,LABORABLE
6,4,2021,12,627,657,1284,2021-04-06 11:00:00,2021-06-04 00:00:00,LABORABLE
6,4,2021,13,602,757,1359,2021-04-06 12:00:00,2021-06-04 00:00:00,LABORABLE
6,4,2021,14,635,729,1364,2021-04-06 13:00:00,2021-06-04 00:00:00,LABORABLE
6,4,2021,15,675,729,1404,2021-04-06 14:00:00,2021-06-04 00:00:00,LABORABLE
6,4,2021,16,638,692,1330,2021-04-06 15:00:00,2021-06-04 00:00:00,LABORABLE
6,4,2021,17,626,757,1383,2021-04-06 16:00:00,2021-06-04 00:00:00,LABORABLE
6,4,2021,18,693,725,1418,2021-04-06 17:00:00,2021-06-04 00:00:00,LABORABLE
6,4,2021,19,700,805,1505,2021-04-06 18:00:00,2021-06-04 00:00:00,LABORABLE
6,4,2021,20,626,789,1415,2021-04-06 19:00:00,2021-06-04 00:00:00,LABORABLE
6,4,2021,21,653,730,1383,2021-04-06 20:00:00,2021-06-04 00:00:00,LABORABLE
6,4,2021,22,505,589,1094,2021-04-06 21:00:00,2021-06-04 00:00:00,LABORABLE
6,4,2021,23,410,386,796,2021-04-06 22:00:00,2021-06-04 00:00:00,LABORABLE
6,4,2021,24,215,261,476,2021-04-06 23:00:00,2021-06-04 00:00:00,LABORABLE
7,4,2021,1,84,88,172,2021-04-07 00:00:00,2021-07-04 00:00:00,LABORABLE
7,4,2021,2,45,53,98,2021-04-07 01:00:00,2021-07-04 00:00:00,LABORABLE
7,4,2021,3,39,49,88,2021-04-07 02:00:00,2021-07-04 00:00:00,LABORABLE
7,4,2021,4,43,35,78,2021-04-07 03:00:00,2021-07-04 00:00:00,LABORABLE
7,4,2021,5,65,46,111,2021-04-07 04:00:00,2021-07-04 00:00:00,LABORABLE
7,4,2021,6,157,97,254,2021-04-07 05:00:00,2021-07-04 00:00:00,LABORABLE
7,4,2021,7,422,314,736,2021-04-07 06:00:00,2021-07-04 00:00:00,LABORABLE
7,4,2021,8,701,588,1289,2021-04-07 07:00:00,2021-07-04 00:00:00,LABORABLE
7,4,2021,9,703,730,1433,2021-04-07 08:00:00,2021-07-04 00:00:00,LABORABLE
7,4,2021,10,670,756,1426,2021-04-07 09:00:00,2021-07-04 00:00:00,LABORABLE
7,4,2021,11,566,640,1206,2021-04-07 10:00:00,2021-07-04 00:00:00,LABORABLE
7,4,2021,12,640,761,1401,2021-04-07 11:00:00,2021-07-04 00:00:00,LABORABLE
7,4,2021,13,472,591,1063,2021-04-07 12:00:00,2021-07-04 00:00:00,LABORABLE
7,4,2021,14,631,740,1371,2021-04-07 13:00:00,2021-07-04 00:00:00,LABORABLE
7,4,2021,15,666,708,1374,2021-04-07 14:00:00,2021-07-04 00:00:00,LABORABLE
7,4,2021,16,660,718,1378,2021-04-07 15:00:00,2021-07-04 00:00:00,LABORABLE
7,4,2021,17,653,695,1348,2021-04-07 16:00:00,2021-07-04 00:00:00,LABORABLE
7,4,2021,18,643,684,1327,2021-04-07 17:00:00,2021-07-04 00:00:00,LABORABLE
7,4,2021,19,683,735,1418,2021-04-07 18:00:00,2021-07-04 00:00:00,LABORABLE
7,4,2021,20,639,722,1361,2021-04-07 19:00:00,2021-07-04 00:00:00,LABORABLE
7,4,2021,21,637,782,1419,2021-04-07 20:00:00,2021-07-04 00:00:00,LABORABLE
7,4,2021,22,497,629,1126,2021-04-07 21:00:00,2021-07-04 00:00:00,LABORABLE
7,4,2021,23,432,444,876,2021-04-07 22:00:00,2021-07-04 00:00:00,LABORABLE
7,4,2021,24,218,236,454,2021-04-07 23:00:00,2021-07-04 00:00:00,LABORABLE
8,4,2021,1,87,119,206,2021-04-08 00:00:00,2021-08-04 00:00:00,LABORABLE
8,4,2021,2,62,53,115,2021-04-08 01:00:00,2021-08-04 00:00:00,LABORABLE
8,4,2021,3,39,48,87,2021-04-08 02:00:00,2021-08-04 00:00:00,LABORABLE
8,4,2021,4,49,42,91,2021-04-08 03:00:00,2021-08-04 00:00:00,LABORABLE
8,4,2021,5,61,52,113,2021-04-08 04:00:00,2021-08-04 00:00:00,LABORABLE
8,4,2021,6,160,105,265,2021-04-08 05:00:00,2021-08-04 00:00:00,LABORABLE
8,4,2021,7,436,299,735,2021-04-08 06:00:00,2021-08-04 00:00:00,LABORABLE
8,4,2021,8,678,585,1263,2021-04-08 07:00:00,2021-08-04 00:00:00,LABORABLE
8,4,2021,9,505,520,1025,2021-04-08 08:00:00,2021-08-04 00:00:00,LABORABLE
8,4,2021,10,630,530,1160,2021-04-08 09:00:00,2021-08-04 00:00:00,LABORABLE
8,4,2021,11,514,632,1146,2021-04-08 10:00:00,2021-08-04 00:00:00,LABORABLE
8,4,2021,12,650,682,1332,2021-04-08 11:00:00,2021-08-04 00:00:00,LABORABLE
8,4,2021,13,643,729,1372,2021-04-08 12:00:00,2021-08-04 00:00:00,LABORABLE
8,4,2021,14,643,736,1379,2021-04-08 13:00:00,2021-08-04 00:00:00,LABORABLE
8,4,2021,15,696,724,1420,2021-04-08 14:00:00,2021-08-04 00:00:00,LABORABLE
8,4,2021,16,666,677,1343,2021-04-08 15:00:00,2021-08-04 00:00:00,LABORABLE
8,4,2021,17,661,754,1415,2021-04-08 16:00:00,2021-08-04 00:00:00,LABORABLE
8,4,2021,18,673,712,1385,2021-04-08 17:00:00,2021-08-04 00:00:00,LABORABLE
8,4,2021,19,686,756,1442,2021-04-08 18:00:00,2021-08-04 00:00:00,LABORABLE
8,4,2021,20,475,730,1205,2021-04-08 19:00:00,2021-08-04 00:00:00,LABORABLE
8,4,2021,21,652,787,1439,2021-04-08 20:00:00,2021-08-04 00:00:00,LABORABLE
8,4,2021,22,515,646,1161,2021-04-08 21:00:00,2021-08-04 00:00:00,LABORABLE
8,4,2021,23,458,497,955,2021-04-08 22:00:00,2021-08-04 00:00:00,LABORABLE
8,4,2021,24,244,289,533,2021-04-08 23:00:00,2021-08-04 00:00:00,LABORABLE
9,4,2021,1,114,152,266,2021-04-09 00:00:00,2021-09-04 00:00:00,LABORABLE
9,4,2021,2,41,66,107,2021-04-09 01:00:00,2021-09-04 00:00:00,LABORABLE
9,4,2021,3,44,71,115,2021-04-09 02:00:00,2021-09-04 00:00:00,LABORABLE
9,4,2021,4,51,38,89,2021-04-09 03:00:00,2021-09-04 00:00:00,LABORABLE
9,4,2021,5,71,66,137,2021-04-09 04:00:00,2021-09-04 00:00:00,LABORABLE
9,4,2021,6,178,103,281,2021-04-09 05:00:00,2021-09-04 00:00:00,LABORABLE
9,4,2021,7,428,303,731,2021-04-09 06:00:00,2021-09-04 00:00:00,LABORABLE
9,4,2021,8,720,598,1318,2021-04-09 07:00:00,2021-09-04 00:00:00,LABORABLE
9,4,2021,9,695,731,1426,2021-04-09 08:00:00,2021-09-04 00:00:00,LABORABLE
9,4,2021,10,631,707,1338,2021-04-09 09:00:00,2021-09-04 00:00:00,LABORABLE
9,4,2021,11,561,667,1228,2021-04-09 10:00:00,2021-09-04 00:00:00,LABORABLE
9,4,2021,12,468,633,1101,2021-04-09 11:00:00,2021-09-04 00:00:00,LABORABLE
9,4,2021,13,617,741,1358,2021-04-09 12:00:00,2021-09-04 00:00:00,LABORABLE
9,4,2021,14,671,781,1452,2021-04-09 13:00:00,2021-09-04 00:00:00,LABORABLE
9,4,2021,15,691,777,1468,2021-04-09 14:00:00,2021-09-04 00:00:00,LABORABLE
9,4,2021,16,664,711,1375,2021-04-09 15:00:00,2021-09-04 00:00:00,LABORABLE
9,4,2021,17,685,732,1417,2021-04-09 16:00:00,2021-09-04 00:00:00,LABORABLE
9,4,2021,18,670,804,1474,2021-04-09 17:00:00,2021-09-04 00:00:00,LABORABLE
9,4,2021,19,703,749,1452,2021-04-09 18:00:00,2021-09-04 00:00:00,LABORABLE
9,4,2021,20,680,829,1509,2021-04-09 19:00:00,2021-09-04 00:00:00,LABORABLE
9,4,2021,21,693,797,1490,2021-04-09 20:00:00,2021-09-04 00:00:00,LABORABLE
9,4,2021,22,559,691,1250,2021-04-09 21:00:00,2021-09-04 00:00:00,LABORABLE
9,4,2021,23,552,547,1099,2021-04-09 22:00:00,2021-09-04 00:00:00,LABORABLE
9,4,2021,24,356,391,747,2021-04-09 23:00:00,2021-09-04 00:00:00,LABORABLE
10,4,2021,1,143,217,360,2021-04-10 00:00:00,2021-10-04 00:00:00,LABORABLE
10,4,2021,2,84,99,183,2021-04-10 01:00:00,2021-10-04 00:00:00,LABORABLE
10,4,2021,3,58,78,136,2021-04-10 02:00:00,2021-10-04 00:00:00,LABORABLE
10,4,2021,4,48,58,106,2021-04-10 03:00:00,2021-10-04 00:00:00,LABORABLE
10,4,2021,5,51,69,120,2021-04-10 04:00:00,2021-10-04 00:00:00,LABORABLE
10,4,2021,6,82,77,159,2021-04-10 05:00:00,2021-10-04 00:00:00,LABORABLE
10,4,2021,7,167,144,311,2021-04-10 06:00:00,2021-10-04 00:00:00,LABORABLE
10,4,2021,8,259,251,510,2021-04-10 07:00:00,2021-10-04 00:00:00,LABORABLE
10,4,2021,9,375,356,731,2021-04-10 08:00:00,2021-10-04 00:00:00,LABORABLE
10,4,2021,10,408,488,896,2021-04-10 09:00:00,2021-10-04 00:00:00,LABORABLE
10,4,2021,11,564,560,1124,2021-04-10 10:00:00,2021-10-04 00:00:00,LABORABLE
10,4,2021,12,631,722,1353,2021-04-10 11:00:00,2021-10-04 00:00:00,LABORABLE
10,4,2021,13,695,812,1507,2021-04-10 12:00:00,2021-10-04 00:00:00,LABORABLE
10,4,2021,14,702,793,1495,2021-04-10 13:00:00,2021-10-04 00:00:00,LABORABLE
10,4,2021,15,661,744,1405,2021-04-10 14:00:00,2021-10-04 00:00:00,LABORABLE
10,4,2021,16,543,745,1288,2021-04-10 15:00:00,2021-10-04 00:00:00,LABORABLE
10,4,2021,17,538,704,1242,2021-04-10 16:00:00,2021-10-04 00:00:00,LABORABLE
10,4,2021,18,553,738,1291,2021-04-10 17:00:00,2021-10-04 00:00:00,LABORABLE
10,4,2021,19,651,763,1414,2021-04-10 18:00:00,2021-10-04 00:00:00,LABORABLE
10,4,2021,20,628,728,1356,2021-04-10 19:00:00,2021-10-04 00:00:00,LABORABLE
10,4,2021,21,600,682,1282,2021-04-10 20:00:00,2021-10-04 00:00:00,LABORABLE
10,4,2021,22,553,599,1152,2021-04-10 21:00:00,2021-10-04 00:00:00,LABORABLE
10,4,2021,23,514,552,1066,2021-04-10 22:00:00,2021-10-04 00:00:00,LABORABLE
10,4,2021,24,481,521,1002,2021-04-10 23:00:00,2021-10-04 00:00:00,LABORABLE
11,4,2021,1,166,233,399,2021-04-11 00:00:00,2021-11-04 00:00:00,LABORABLE
11,4,2021,2,77,102,179,2021-04-11 01:00:00,2021-11-04 00:00:00,LABORABLE
11,4,2021,3,64,77,141,2021-04-11 02:00:00,2021-11-04 00:00:00,LABORABLE
11,4,2021,4,41,44,85,2021-04-11 03:00:00,2021-11-04 00:00:00,LABORABLE
11,4,2021,5,24,50,74,2021-04-11 04:00:00,2021-11-04 00:00:00,LABORABLE
11,4,2021,6,49,73,122,2021-04-11 05:00:00,2021-11-04 00:00:00,LABORABLE
11,4,2021,7,80,81,161,2021-04-11 06:00:00,2021-11-04 00:00:00,LABORABLE
11,4,2021,8,146,146,292,2021-04-11 07:00:00,2021-11-04 00:00:00,LABORABLE
11,4,2021,9,181,211,392,2021-04-11 08:00:00,2021-11-04 00:00:00,LABORABLE
11,4,2021,10,303,343,646,2021-04-11 09:00:00,2021-11-04 00:00:00,LABORABLE
11,4,2021,11,453,435,888,2021-04-11 10:00:00,2021-11-04 00:00:00,LABORABLE
11,4,2021,12,525,603,1128,2021-04-11 11:00:00,2021-11-04 00:00:00,LABORABLE
11,4,2021,13,580,670,1250,2021-04-11 12:00:00,2021-11-04 00:00:00,LABORABLE
11,4,2021,14,632,772,1404,2021-04-11 13:00:00,2021-11-04 00:00:00,LABORABLE
11,4,2021,15,609,715,1324,2021-04-11 14:00:00,2021-11-04 00:00:00,LABORABLE
11,4,2021,16,476,600,1076,2021-04-11 15:00:00,2021-11-04 00:00:00,LABORABLE
11,4,2021,17,470,635,1105,2021-04-11 16:00:00,2021-11-04 00:00:00,LABORABLE
11,4,2021,18,505,687,1192,2021-04-11 17:00:00,2021-11-04 00:00:00,LABORABLE
11,4,2021,19,565,626,1191,2021-04-11 18:00:00,2021-11-04 00:00:00,LABORABLE
11,4,2021,20,513,673,1186,2021-04-11 19:00:00,2021-11-04 00:00:00,LABORABLE
11,4,2021,21,548,677,1225,2021-04-11 20:00:00,2021-11-04 00:00:00,LABORABLE
11,4,2021,22,473,514,987,2021-04-11 21:00:00,2021-11-04 00:00:00,LABORABLE
11,4,2021,23,428,430,858,2021-04-11 22:00:00,2021-11-04 00:00:00,LABORABLE
11,4,2021,24,269,338,607,2021-04-11 23:00:00,2021-11-04 00:00:00,LABORABLE
12,4,2021,1,97,119,216,2021-04-12 00:00:00,2021-12-04 00:00:00,LABORABLE
12,4,2021,2,54,65,119,2021-04-12 01:00:00,2021-12-04 00:00:00,LABORABLE
12,4,2021,3,40,46,86,2021-04-12 02:00:00,2021-12-04 00:00:00,LABORABLE
12,4,2021,4,47,49,96,2021-04-12 03:00:00,2021-12-04 00:00:00,LABORABLE
12,4,2021,5,55,57,112,2021-04-12 04:00:00,2021-12-04 00:00:00,LABORABLE
12,4,2021,6,164,90,254,2021-04-12 05:00:00,2021-12-04 00:00:00,LABORABLE
12,4,2021,7,408,305,713,2021-04-12 06:00:00,2021-12-04 00:00:00,LABORABLE
12,4,2021,8,739,588,1327,2021-04-12 07:00:00,2021-12-04 00:00:00,LABORABLE
12,4,2021,9,687,716,1403,2021-04-12 08:00:00,2021-12-04 00:00:00,LABORABLE
12,4,2021,10,667,728,1395,2021-04-12 09:00:00,2021-12-04 00:00:00,LABORABLE
12,4,2021,11,579,625,1204,2021-04-12 10:00:00,2021-12-04 00:00:00,LABORABLE
12,4,2021,12,581,654,1235,2021-04-12 11:00:00,2021-12-04 00:00:00,LABORABLE
12,4,2021,13,470,552,1022,2021-04-12 12:00:00,2021-12-04 00:00:00,LABORABLE
12,4,2021,14,707,733,1440,2021-04-12 13:00:00,2021-12-04 00:00:00,LABORABLE
12,4,2021,15,683,721,1404,2021-04-12 14:00:00,2021-12-04 00:00:00,LABORABLE
12,4,2021,16,673,655,1328,2021-04-12 15:00:00,2021-12-04 00:00:00,LABORABLE
12,4,2021,17,639,740,1379,2021-04-12 16:00:00,2021-12-04 00:00:00,LABORABLE
12,4,2021,18,651,740,1391,2021-04-12 17:00:00,2021-12-04 00:00:00,LABORABLE
12,4,2021,19,650,823,1473,2021-04-12 18:00:00,2021-12-04 00:00:00,LABORABLE
12,4,2021,20,695,732,1427,2021-04-12 19:00:00,2021-12-04 00:00:00,LABORABLE
12,4,2021,21,565,726,1291,2021-04-12 20:00:00,2021-12-04 00:00:00,LABORABLE
12,4,2021,22,488,571,1059,2021-04-12 21:00:00,2021-12-04 00:00:00,LABORABLE
12,4,2021,23,406,393,799,2021-04-12 22:00:00,2021-12-04 00:00:00,LABORABLE
12,4,2021,24,179,245,424,2021-04-12 23:00:00,2021-12-04 00:00:00,LABORABLE
13,4,2021,1,76,105,181,2021-04-13 00:00:00,2021-04-13 00:00:00,LABORABLE
13,4,2021,2,44,58,102,2021-04-13 01:00:00,2021-04-13 00:00:00,LABORABLE
13,4,2021,3,38,44,82,2021-04-13 02:00:00,2021-04-13 00:00:00,LABORABLE
13,4,2021,4,46,35,81,2021-04-13 03:00:00,2021-04-13 00:00:00,LABORABLE
13,4,2021,5,57,58,115,2021-04-13 04:00:00,2021-04-13 00:00:00,LABORABLE
13,4,2021,6,156,111,267,2021-04-13 05:00:00,2021-04-13 00:00:00,LABORABLE
13,4,2021,7,424,312,736,2021-04-13 06:00:00,2021-04-13 00:00:00,LABORABLE
13,4,2021,8,706,602,1308,2021-04-13 07:00:00,2021-04-13 00:00:00,LABORABLE
13,4,2021,9,697,726,1423,2021-04-13 08:00:00,2021-04-13 00:00:00,LABORABLE
13,4,2021,10,628,730,1358,2021-04-13 09:00:00,2021-04-13 00:00:00,LABORABLE
13,4,2021,11,551,647,1198,2021-04-13 10:00:00,2021-04-13 00:00:00,LABORABLE
13,4,2021,12,562,679,1241,2021-04-13 11:00:00,2021-04-13 00:00:00,LABORABLE
13,4,2021,13,629,747,1376,2021-04-13 12:00:00,2021-04-13 00:00:00,LABORABLE
13,4,2021,14,608,727,1335,2021-04-13 13:00:00,2021-04-13 00:00:00,LABORABLE
13,4,2021,15,654,723,1377,2021-04-13 14:00:00,2021-04-13 00:00:00,LABORABLE
13,4,2021,16,648,706,1354,2021-04-13 15:00:00,2021-04-13 00:00:00,LABORABLE
13,4,2021,17,630,736,1366,2021-04-13 16:00:00,2021-04-13 00:00:00,LABORABLE
13,4,2021,18,647,697,1344,2021-04-13 17:00:00,2021-04-13 00:00:00,LABORABLE
13,4,2021,19,703,766,1469,2021-04-13 18:00:00,2021-04-13 00:00:00,LABORABLE
13,4,2021,20,656,718,1374,2021-04-13 19:00:00,2021-04-13 00:00:00,LABORABLE
13,4,2021,21,634,675,1309,2021-04-13 20:00:00,2021-04-13 00:00:00,LABORABLE
13,4,2021,22,487,497,984,2021-04-13 21:00:00,2021-04-13 00:00:00,LABORABLE
13,4,2021,23,364,386,750,2021-04-13 22:00:00,2021-04-13 00:00:00,LABORABLE
13,4,2021,24,190,217,407,2021-04-13 23:00:00,2021-04-13 00:00:00,LABORABLE
14,4,2021,1,83,94,177,2021-04-14 00:00:00,2021-04-14 00:00:00,LABORABLE
14,4,2021,2,37,55,92,2021-04-14 01:00:00,2021-04-14 00:00:00,LABORABLE
14,4,2021,3,39,44,83,2021-04-14 02:00:00,2021-04-14 00:00:00,LABORABLE
14,4,2021,4,42,42,84,2021-04-14 03:00:00,2021-04-14 00:00:00,LABORABLE
14,4,2021,5,57,44,101,2021-04-14 04:00:00,2021-04-14 00:00:00,LABORABLE
14,4,2021,6,166,102,268,2021-04-14 05:00:00,2021-04-14 00:00:00,LABORABLE
14,4,2021,7,404,322,726,2021-04-14 06:00:00,2021-04-14 00:00:00,LABORABLE
14,4,2021,8,703,575,1278,2021-04-14 07:00:00,2021-04-14 00:00:00,LABORABLE
14,4,2021,9,697,708,1405,2021-04-14 08:00:00,2021-04-14 00:00:00,LABORABLE
14,4,2021,10,660,707,1367,2021-04-14 09:00:00,2021-04-14 00:00:00,LABORABLE
14,4,2021,11,572,623,1195,2021-04-14 10:00:00,2021-04-14 00:00:00,LABORABLE
14,4,2021,12,569,693,1262,2021-04-14 11:00:00,2021-04-14 00:00:00,LABORABLE
14,4,2021,13,552,687,1239,2021-04-14 12:00:00,2021-04-14 00:00:00,LABORABLE
14,4,2021,14,613,732,1345,2021-04-14 13:00:00,2021-04-14 00:00:00,LABORABLE
14,4,2021,15,683,739,1422,2021-04-14 14:00:00,2021-04-14 00:00:00,LABORABLE
14,4,2021,16,648,615,1263,2021-04-14 15:00:00,2021-04-14 00:00:00,LABORABLE
14,4,2021,17,590,684,1274,2021-04-14 16:00:00,2021-04-14 00:00:00,LABORABLE
14,4,2021,18,659,783,1442,2021-04-14 17:00:00,2021-04-14 00:00:00,LABORABLE
14,4,2021,19,651,736,1387,2021-04-14 18:00:00,2021-04-14 00:00:00,LABORABLE
14,4,2021,20,651,765,1416,2021-04-14 19:00:00,2021-04-14 00:00:00,LABORABLE
14,4,2021,21,654,667,1321,2021-04-14 20:00:00,2021-04-14 00:00:00,LABORABLE
14,4,2021,22,442,570,1012,2021-04-14 21:00:00,2021-04-14 00:00:00,LABORABLE
14,4,2021,23,384,350,734,2021-04-14 22:00:00,2021-04-14 00:00:00,LABORABLE
14,4,2021,24,246,296,542,2021-04-14 23:00:00,2021-04-14 00:00:00,LABORABLE
15,4,2021,1,85,134,219,2021-04-15 00:00:00,2021-04-15 00:00:00,LABORABLE
15,4,2021,2,58,58,116,2021-04-15 01:00:00,2021-04-15 00:00:00,LABORABLE
15,4,2021,3,51,51,102,2021-04-15 02:00:00,2021-04-15 00:00:00,LABORABLE
15,4,2021,4,35,43,78,2021-04-15 03:00:00,2021-04-15 00:00:00,LABORABLE
15,4,2021,5,73,59,132,2021-04-15 04:00:00,2021-04-15 00:00:00,LABORABLE
15,4,2021,6,155,108,263,2021-04-15 05:00:00,2021-04-15 00:00:00,LABORABLE
15,4,2021,7,399,340,739,2021-04-15 06:00:00,2021-04-15 00:00:00,LABORABLE
15,4,2021,8,576,438,1014,2021-04-15 07:00:00,2021-04-15 00:00:00,LABORABLE
15,4,2021,9,218,222,440,2021-04-15 08:00:00,2021-04-15 00:00:00,LABORABLE
15,4,2021,10,659,712,1371,2021-04-15 09:00:00,2021-04-15 00:00:00,LABORABLE
15,4,2021,11,588,634,1222,2021-04-15 10:00:00,2021-04-15 00:00:00,LABORABLE
15,4,2021,12,618,686,1304,2021-04-15 11:00:00,2021-04-15 00:00:00,LABORABLE
15,4,2021,13,574,753,1327,2021-04-15 12:00:00,2021-04-15 00:00:00,LABORABLE
15,4,2021,14,656,765,1421,2021-04-15 13:00:00,2021-04-15 00:00:00,LABORABLE
15,4,2021,15,696,741,1437,2021-04-15 14:00:00,2021-04-15 00:00:00,LABORABLE
15,4,2021,16,623,685,1308,2021-04-15 15:00:00,2021-04-15 00:00:00,LABORABLE
15,4,2021,17,632,744,1376,2021-04-15 16:00:00,2021-04-15 00:00:00,LABORABLE
15,4,2021,18,685,724,1409,2021-04-15 17:00:00,2021-04-15 00:00:00,LABORABLE
15,4,2021,19,721,742,1463,2021-04-15 18:00:00,2021-04-15 00:00:00,LABORABLE
15,4,2021,20,541,770,1311,2021-04-15 19:00:00,2021-04-15 00:00:00,LABORABLE
15,4,2021,21,639,700,1339,2021-04-15 20:00:00,2021-04-15 00:00:00,LABORABLE
15,4,2021,22,509,562,1071,2021-04-15 21:00:00,2021-04-15 00:00:00,LABORABLE
15,4,2021,23,460,446,906,2021-04-15 22:00:00,2021-04-15 00:00:00,LABORABLE
15,4,2021,24,232,262,494,2021-04-15 23:00:00,2021-04-15 00:00:00,LABORABLE
16,4,2021,1,102,142,244,2021-04-16 00:00:00,2021-04-16 00:00:00,LABORABLE
16,4,2021,2,40,63,103,2021-04-16 01:00:00,2021-04-16 00:00:00,LABORABLE
16,4,2021,3,45,41,86,2021-04-16 02:00:00,2021-04-16 00:00:00,LABORABLE
16,4,2021,4,50,47,97,2021-04-16 03:00:00,2021-04-16 00:00:00,LABORABLE
16,4,2021,5,71,50,121,2021-04-16 04:00:00,2021-04-16 00:00:00,LABORABLE
16,4,2021,6,155,113,268,2021-04-16 05:00:00,2021-04-16 00:00:00,LABORABLE
16,4,2021,7,402,339,741,2021-04-16 06:00:00,2021-04-16 00:00:00,LABORABLE
16,4,2021,8,674,566,1240,2021-04-16 07:00:00,2021-04-16 00:00:00,LABORABLE
16,4,2021,9,689,681,1370,2021-04-16 08:00:00,2021-04-16 00:00:00,LABORABLE
16,4,2021,10,679,751,1430,2021-04-16 09:00:00,2021-04-16 00:00:00,LABORABLE
16,4,2021,11,584,685,1269,2021-04-16 10:00:00,2021-04-16 00:00:00,LABORABLE
16,4,2021,12,579,751,1330,2021-04-16 11:00:00,2021-04-16 00:00:00,LABORABLE
16,4,2021,13,642,700,1342,2021-04-16 12:00:00,2021-04-16 00:00:00,LABORABLE
16,4,2021,14,632,757,1389,2021-04-16 13:00:00,2021-04-16 00:00:00,LABORABLE
16,4,2021,15,665,739,1404,2021-04-16 14:00:00,2021-04-16 00:00:00,LABORABLE
16,4,2021,16,662,667,1329,2021-04-16 15:00:00,2021-04-16 00:00:00,LABORABLE
16,4,2021,17,641,765,1406,2021-04-16 16:00:00,2021-04-16 00:00:00,LABORABLE
16,4,2021,18,687,867,1554,2021-04-16 17:00:00,2021-04-16 00:00:00,LABORABLE
16,4,2021,19,673,790,1463,2021-04-16 18:00:00,2021-04-16 00:00:00,LABORABLE
16,4,2021,20,708,800,1508,2021-04-16 19:00:00,2021-04-16 00:00:00,LABORABLE
16,4,2021,21,599,778,1377,2021-04-16 20:00:00,2021-04-16 00:00:00,LABORABLE
16,4,2021,22,586,753,1339,2021-04-16 21:00:00,2021-04-16 00:00:00,LABORABLE
16,4,2021,23,579,591,1170,2021-04-16 22:00:00,2021-04-16 00:00:00,LABORABLE
16,4,2021,24,356,471,827,2021-04-16 23:00:00,2021-04-16 00:00:00,LABORABLE
17,4,2021,1,130,213,343,2021-04-17 00:00:00,2021-04-17 00:00:00,LABORABLE
17,4,2021,2,69,107,176,2021-04-17 01:00:00,2021-04-17 00:00:00,LABORABLE
17,4,2021,3,47,54,101,2021-04-17 02:00:00,2021-04-17 00:00:00,LABORABLE
17,4,2021,4,45,50,95,2021-04-17 03:00:00,2021-04-17 00:00:00,LABORABLE
17,4,2021,5,50,65,115,2021-04-17 04:00:00,2021-04-17 00:00:00,LABORABLE
17,4,2021,6,73,90,163,2021-04-17 05:00:00,2021-04-17 00:00:00,LABORABLE
17,4,2021,7,171,145,316,2021-04-17 06:00:00,2021-04-17 00:00:00,LABORABLE
17,4,2021,8,276,239,515,2021-04-17 07:00:00,2021-04-17 00:00:00,LABORABLE
17,4,2021,9,375,346,721,2021-04-17 08:00:00,2021-04-17 00:00:00,LABORABLE
17,4,2021,10,466,530,996,2021-04-17 09:00:00,2021-04-17 00:00:00,LABORABLE
17,4,2021,11,596,600,1196,2021-04-17 10:00:00,2021-04-17 00:00:00,LABORABLE
17,4,2021,12,628,750,1378,2021-04-17 11:00:00,2021-04-17 00:00:00,LABORABLE
17,4,2021,13,584,738,1322,2021-04-17 12:00:00,2021-04-17 00:00:00,LABORABLE
17,4,2021,14,683,754,1437,2021-04-17 13:00:00,2021-04-17 00:00:00,LABORABLE
17,4,2021,15,687,781,1468,2021-04-17 14:00:00,2021-04-17 00:00:00,LABORABLE
17,4,2021,16,545,683,1228,2021-04-17 15:00:00,2021-04-17 00:00:00,LABORABLE
17,4,2021,17,485,693,1178,2021-04-17 16:00:00,2021-04-17 00:00:00,LABORABLE
17,4,2021,18,554,744,1298,2021-04-17 17:00:00,2021-04-17 00:00:00,LABORABLE
17,4,2021,19,644,736,1380,2021-04-17 18:00:00,2021-04-17 00:00:00,LABORABLE
17,4,2021,20,585,739,1324,2021-04-17 19:00:00,2021-04-17 00:00:00,LABORABLE
17,4,2021,21,528,729,1257,2021-04-17 20:00:00,2021-04-17 00:00:00,LABORABLE
17,4,2021,22,522,581,1103,2021-04-17 21:00:00,2021-04-17 00:00:00,LABORABLE
17,4,2021,23,567,668,1235,2021-04-17 22:00:00,2021-04-17 00:00:00,LABORABLE
17,4,2021,24,407,487,894,2021-04-17 23:00:00,2021-04-17 00:00:00,LABORABLE
18,4,2021,1,188,219,407,2021-04-18 00:00:00,2021-04-18 00:00:00,LABORABLE
18,4,2021,2,83,114,197,2021-04-18 01:00:00,2021-04-18 00:00:00,LABORABLE
18,4,2021,3,53,76,129,2021-04-18 02:00:00,2021-04-18 00:00:00,LABORABLE
18,4,2021,4,39,60,99,2021-04-18 03:00:00,2021-04-18 00:00:00,LABORABLE
18,4,2021,5,36,49,85,2021-04-18 04:00:00,2021-04-18 00:00:00,LABORABLE
18,4,2021,6,50,72,122,2021-04-18 05:00:00,2021-04-18 00:00:00,LABORABLE
18,4,2021,7,91,97,188,2021-04-18 06:00:00,2021-04-18 00:00:00,LABORABLE
18,4,2021,8,141,142,283,2021-04-18 07:00:00,2021-04-18 00:00:00,LABORABLE
18,4,2021,9,215,248,463,2021-04-18 08:00:00,2021-04-18 00:00:00,LABORABLE
18,4,2021,10,323,362,685,2021-04-18 09:00:00,2021-04-18 00:00:00,LABORABLE
18,4,2021,11,439,500,939,2021-04-18 10:00:00,2021-04-18 00:00:00,LABORABLE
18,4,2021,12,563,649,1212,2021-04-18 11:00:00,2021-04-18 00:00:00,LABORABLE
18,4,2021,13,622,636,1258,2021-04-18 12:00:00,2021-04-18 00:00:00,LABORABLE
18,4,2021,14,590,695,1285,2021-04-18 13:00:00,2021-04-18 00:00:00,LABORABLE
18,4,2021,15,641,678,1319,2021-04-18 14:00:00,2021-04-18 00:00:00,LABORABLE
18,4,2021,16,472,604,1076,2021-04-18 15:00:00,2021-04-18 00:00:00,LABORABLE
18,4,2021,17,435,566,1001,2021-04-18 16:00:00,2021-04-18 00:00:00,LABORABLE
18,4,2021,18,487,639,1126,2021-04-18 17:00:00,2021-04-18 00:00:00,LABORABLE
18,4,2021,19,559,649,1208,2021-04-18 18:00:00,2021-04-18 00:00:00,LABORABLE
18,4,2021,20,529,691,1220,2021-04-18 19:00:00,2021-04-18 00:00:00,LABORABLE
18,4,2021,21,536,625,1161,2021-04-18 20:00:00,2021-04-18 00:00:00,LABORABLE
18,4,2021,22,502,567,1069,2021-04-18 21:00:00,2021-04-18 00:00:00,LABORABLE
18,4,2021,23,443,421,864,2021-04-18 22:00:00,2021-04-18 00:00:00,LABORABLE
18,4,2021,24,277,349,626,2021-04-18 23:00:00,2021-04-18 00:00:00,LABORABLE
19,4,2021,1,107,149,256,2021-04-19 00:00:00,2021-04-19 00:00:00,LABORABLE
19,4,2021,2,54,86,140,2021-04-19 01:00:00,2021-04-19 00:00:00,LABORABLE
19,4,2021,3,49,55,104,2021-04-19 02:00:00,2021-04-19 00:00:00,LABORABLE
19,4,2021,4,43,29,72,2021-04-19 03:00:00,2021-04-19 00:00:00,LABORABLE
19,4,2021,5,62,46,108,2021-04-19 04:00:00,2021-04-19 00:00:00,LABORABLE
19,4,2021,6,153,108,261,2021-04-19 05:00:00,2021-04-19 00:00:00,LABORABLE
19,4,2021,7,439,320,759,2021-04-19 06:00:00,2021-04-19 00:00:00,LABORABLE
19,4,2021,8,702,586,1288,2021-04-19 07:00:00,2021-04-19 00:00:00,LABORABLE
19,4,2021,9,679,689,1368,2021-04-19 08:00:00,2021-04-19 00:00:00,LABORABLE
19,4,2021,10,620,708,1328,2021-04-19 09:00:00,2021-04-19 00:00:00,LABORABLE
19,4,2021,11,444,491,935,2021-04-19 10:00:00,2021-04-19 00:00:00,LABORABLE
19,4,2021,12,574,735,1309,2021-04-19 11:00:00,2021-04-19 00:00:00,LABORABLE
19,4,2021,13,568,692,1260,2021-04-19 12:00:00,2021-04-19 00:00:00,LABORABLE
19,4,2021,14,674,721,1395,2021-04-19 13:00:00,2021-04-19 00:00:00,LABORABLE
19,4,2021,15,655,744,1399,2021-04-19 14:00:00,2021-04-19 00:00:00,LABORABLE
19,4,2021,16,674,676,1350,2021-04-19 15:00:00,2021-04-19 00:00:00,LABORABLE
19,4,2021,17,629,752,1381,2021-04-19 16:00:00,2021-04-19 00:00:00,LABORABLE
19,4,2021,18,680,708,1388,2021-04-19 17:00:00,2021-04-19 00:00:00,LABORABLE
19,4,2021,19,669,759,1428,2021-04-19 18:00:00,2021-04-19 00:00:00,LABORABLE
19,4,2021,20,635,781,1416,2021-04-19 19:00:00,2021-04-19 00:00:00,LABORABLE
19,4,2021,21,540,634,1174,2021-04-19 20:00:00,2021-04-19 00:00:00,LABORABLE
19,4,2021,22,455,535,990,2021-04-19 21:00:00,2021-04-19 00:00:00,LABORABLE
19,4,2021,23,351,397,748,2021-04-19 22:00:00,2021-04-19 00:00:00,LABORABLE
19,4,2021,24,177,244,421,2021-04-19 23:00:00,2021-04-19 00:00:00,LABORABLE
20,4,2021,1,72,113,185,2021-04-20 00:00:00,2021-04-20 00:00:00,LABORABLE
20,4,2021,2,38,59,97,2021-04-20 01:00:00,2021-04-20 00:00:00,LABORABLE
20,4,2021,3,42,49,91,2021-04-20 02:00:00,2021-04-20 00:00:00,LABORABLE
20,4,2021,4,47,40,87,2021-04-20 03:00:00,2021-04-20 00:00:00,LABORABLE
20,4,2021,5,65,63,128,2021-04-20 04:00:00,2021-04-20 00:00:00,LABORABLE
20,4,2021,6,166,93,259,2021-04-20 05:00:00,2021-04-20 00:00:00,LABORABLE
20,4,2021,7,402,332,734,2021-04-20 06:00:00,2021-04-20 00:00:00,LABORABLE
20,4,2021,8,722,575,1297,2021-04-20 07:00:00,2021-04-20 00:00:00,LABORABLE
20,4,2021,9,667,695,1362,2021-04-20 08:00:00,2021-04-20 00:00:00,LABORABLE
20,4,2021,10,608,682,1290,2021-04-20 09:00:00,2021-04-20 00:00:00,LABORABLE
20,4,2021,11,564,657,1221,2021-04-20 10:00:00,2021-04-20 00:00:00,LABORABLE
20,4,2021,12,515,658,1173,2021-04-20 11:00:00,2021-04-20 00:00:00,LABORABLE
20,4,2021,13,606,723,1329,2021-04-20 12:00:00,2021-04-20 00:00:00,LABORABLE
20,4,2021,14,669,734,1403,2021-04-20 13:00:00,2021-04-20 00:00:00,LABORABLE
20,4,2021,15,650,702,1352,2021-04-20 14:00:00,2021-04-20 00:00:00,LABORABLE
20,4,2021,16,659,670,1329,2021-04-20 15:00:00,2021-04-20 00:00:00,LABORABLE
20,4,2021,17,604,693,1297,2021-04-20 16:00:00,2021-04-20 00:00:00,LABORABLE
20,4,2021,18,613,726,1339,2021-04-20 17:00:00,2021-04-20 00:00:00,LABORABLE
20,4,2021,19,654,730,1384,2021-04-20 18:00:00,2021-04-20 00:00:00,LABORABLE
20,4,2021,20,590,782,1372,2021-04-20 19:00:00,2021-04-20 00:00:00,LABORABLE
20,4,2021,21,615,674,1289,2021-04-20 20:00:00,2021-04-20 00:00:00,LABORABLE
20,4,2021,22,436,571,1007,2021-04-20 21:00:00,2021-04-20 00:00:00,LABORABLE
20,4,2021,23,391,439,830,2021-04-20 22:00:00,2021-04-20 00:00:00,LABORABLE
20,4,2021,24,182,235,417,2021-04-20 23:00:00,2021-04-20 00:00:00,LABORABLE
21,4,2021,1,57,100,157,2021-04-21 00:00:00,2021-04-21 00:00:00,LABORABLE
21,4,2021,2,46,47,93,2021-04-21 01:00:00,2021-04-21 00:00:00,LABORABLE
21,4,2021,3,47,52,99,2021-04-21 02:00:00,2021-04-21 00:00:00,LABORABLE
21,4,2021,4,37,38,75,2021-04-21 03:00:00,2021-04-21 00:00:00,LABORABLE
21,4,2021,5,59,63,122,2021-04-21 04:00:00,2021-04-21 00:00:00,LABORABLE
21,4,2021,6,168,108,276,2021-04-21 05:00:00,2021-04-21 00:00:00,LABORABLE
21,4,2021,7,424,326,750,2021-04-21 06:00:00,2021-04-21 00:00:00,LABORABLE
21,4,2021,8,695,604,1299,2021-04-21 07:00:00,2021-04-21 00:00:00,LABORABLE
21,4,2021,9,680,670,1350,2021-04-21 08:00:00,2021-04-21 00:00:00,LABORABLE
21,4,2021,10,611,714,1325,2021-04-21 09:00:00,2021-04-21 00:00:00,LABORABLE
21,4,2021,11,561,673,1234,2021-04-21 10:00:00,2021-04-21 00:00:00,LABORABLE
21,4,2021,12,564,720,1284,2021-04-21 11:00:00,2021-04-21 00:00:00,LABORABLE
21,4,2021,13,602,729,1331,2021-04-21 12:00:00,2021-04-21 00:00:00,LABORABLE
21,4,2021,14,582,730,1312,2021-04-21 13:00:00,2021-04-21 00:00:00,LABORABLE
21,4,2021,15,662,730,1392,2021-04-21 14:00:00,2021-04-21 00:00:00,LABORABLE
21,4,2021,16,618,679,1297,2021-04-21 15:00:00,2021-04-21 00:00:00,LABORABLE
21,4,2021,17,665,716,1381,2021-04-21 16:00:00,2021-04-21 00:00:00,LABORABLE
21,4,2021,18,639,686,1325,2021-04-21 17:00:00,2021-04-21 00:00:00,LABORABLE
21,4,2021,19,693,746,1439,2021-04-21 18:00:00,2021-04-21 00:00:00,LABORABLE
21,4,2021,20,578,751,1329,2021-04-21 19:00:00,2021-04-21 00:00:00,LABORABLE
21,4,2021,21,618,693,1311,2021-04-21 20:00:00,2021-04-21 00:00:00,LABORABLE
21,4,2021,22,544,563,1107,2021-04-21 21:00:00,2021-04-21 00:00:00,LABORABLE
21,4,2021,23,303,394,697,2021-04-21 22:00:00,2021-04-21 00:00:00,LABORABLE
21,4,2021,24,182,244,426,2021-04-21 23:00:00,2021-04-21 00:00:00,LABORABLE
22,4,2021,1,88,111,199,2021-04-22 00:00:00,2021-04-22 00:00:00,LABORABLE
22,4,2021,2,40,42,82,2021-04-22 01:00:00,2021-04-22 00:00:00,LABORABLE
22,4,2021,3,43,61,104,2021-04-22 02:00:00,2021-04-22 00:00:00,LABORABLE
22,4,2021,4,39,33,72,2021-04-22 03:00:00,2021-04-22 00:00:00,LABORABLE
22,4,2021,5,56,62,118,2021-04-22 04:00:00,2021-04-22 00:00:00,LABORABLE
22,4,2021,6,154,113,267,2021-04-22 05:00:00,2021-04-22 00:00:00,LABORABLE
22,4,2021,7,411,325,736,2021-04-22 06:00:00,2021-04-22 00:00:00,LABORABLE
22,4,2021,8,695,562,1257,2021-04-22 07:00:00,2021-04-22 00:00:00,LABORABLE
22,4,2021,9,708,706,1414,2021-04-22 08:00:00,2021-04-22 00:00:00,LABORABLE
22,4,2021,10,657,733,1390,2021-04-22 09:00:00,2021-04-22 00:00:00,LABORABLE
22,4,2021,11,544,622,1166,2021-04-22 10:00:00,2021-04-22 00:00:00,LABORABLE
22,4,2021,12,571,719,1290,2021-04-22 11:00:00,2021-04-22 00:00:00,LABORABLE
22,4,2021,13,642,706,1348,2021-04-22 12:00:00,2021-04-22 00:00:00,LABORABLE
22,4,2021,14,639,753,1392,2021-04-22 13:00:00,2021-04-22 00:00:00,LABORABLE
22,4,2021,15,682,734,1416,2021-04-22 14:00:00,2021-04-22 00:00:00,LABORABLE
22,4,2021,16,611,694,1305,2021-04-22 15:00:00,2021-04-22 00:00:00,LABORABLE
22,4,2021,17,664,707,1371,2021-04-22 16:00:00,2021-04-22 00:00:00,LABORABLE
22,4,2021,18,656,708,1364,2021-04-22 17:00:00,2021-04-22 00:00:00,LABORABLE
22,4,2021,19,711,746,1457,2021-04-22 18:00:00,2021-04-22 00:00:00,LABORABLE
22,4,2021,20,515,719,1234,2021-04-22 19:00:00,2021-04-22 00:00:00,LABORABLE
22,4,2021,21,583,706,1289,2021-04-22 20:00:00,2021-04-22 00:00:00,LABORABLE
22,4,2021,22,501,535,1036,2021-04-22 21:00:00,2021-04-22 00:00:00,LABORABLE
22,4,2021,23,444,447,891,2021-04-22 22:00:00,2021-04-22 00:00:00,LABORABLE
22,4,2021,24,221,287,508,2021-04-22 23:00:00,2021-04-22 00:00:00,LABORABLE
23,4,2021,1,94,139,233,2021-04-23 00:00:00,2021-04-23 00:00:00,LABORABLE
23,4,2021,2,49,70,119,2021-04-23 01:00:00,2021-04-23 00:00:00,LABORABLE
23,4,2021,3,53,53,106,2021-04-23 02:00:00,2021-04-23 00:00:00,LABORABLE
23,4,2021,4,48,41,89,2021-04-23 03:00:00,2021-04-23 00:00:00,LABORABLE
23,4,2021,5,66,68,134,2021-04-23 04:00:00,2021-04-23 00:00:00,LABORABLE
23,4,2021,6,171,113,284,2021-04-23 05:00:00,2021-04-23 00:00:00,LABORABLE
23,4,2021,7,418,323,741,2021-04-23 06:00:00,2021-04-23 00:00:00,LABORABLE
23,4,2021,8,714,599,1313,2021-04-23 07:00:00,2021-04-23 00:00:00,LABORABLE
23,4,2021,9,655,685,1340,2021-04-23 08:00:00,2021-04-23 00:00:00,LABORABLE
23,4,2021,10,662,717,1379,2021-04-23 09:00:00,2021-04-23 00:00:00,LABORABLE
23,4,2021,11,568,648,1216,2021-04-23 10:00:00,2021-04-23 00:00:00,LABORABLE
23,4,2021,12,561,739,1300,2021-04-23 11:00:00,2021-04-23 00:00:00,LABORABLE
23,4,2021,13,601,756,1357,2021-04-23 12:00:00,2021-04-23 00:00:00,LABORABLE
23,4,2021,14,656,741,1397,2021-04-23 13:00:00,2021-04-23 00:00:00,LABORABLE
23,4,2021,15,694,786,1480,2021-04-23 14:00:00,2021-04-23 00:00:00,LABORABLE
23,4,2021,16,711,748,1459,2021-04-23 15:00:00,2021-04-23 00:00:00,LABORABLE
23,4,2021,17,612,761,1373,2021-04-23 16:00:00,2021-04-23 00:00:00,LABORABLE
23,4,2021,18,714,759,1473,2021-04-23 17:00:00,2021-04-23 00:00:00,LABORABLE
23,4,2021,19,666,793,1459,2021-04-23 18:00:00,2021-04-23 00:00:00,LABORABLE
23,4,2021,20,653,830,1483,2021-04-23 19:00:00,2021-04-23 00:00:00,LABORABLE
23,4,2021,21,664,821,1485,2021-04-23 20:00:00,2021-04-23 00:00:00,LABORABLE
23,4,2021,22,534,672,1206,2021-04-23 21:00:00,2021-04-23 00:00:00,LABORABLE
23,4,2021,23,578,608,1186,2021-04-23 22:00:00,2021-04-23 00:00:00,LABORABLE
23,4,2021,24,327,452,779,2021-04-23 23:00:00,2021-04-23 00:00:00,LABORABLE
24,4,2021,1,160,181,341,2021-04-24 00:00:00,2021-04-24 00:00:00,LABORABLE
24,4,2021,2,81,113,194,2021-04-24 01:00:00,2021-04-24 00:00:00,LABORABLE
24,4,2021,3,53,75,128,2021-04-24 02:00:00,2021-04-24 00:00:00,LABORABLE
24,4,2021,4,60,56,116,2021-04-24 03:00:00,2021-04-24 00:00:00,LABORABLE
24,4,2021,5,50,47,97,2021-04-24 04:00:00,2021-04-24 00:00:00,LABORABLE
24,4,2021,6,92,92,184,2021-04-24 05:00:00,2021-04-24 00:00:00,LABORABLE
24,4,2021,7,169,135,304,2021-04-24 06:00:00,2021-04-24 00:00:00,LABORABLE
24,4,2021,8,288,268,556,2021-04-24 07:00:00,2021-04-24 00:00:00,LABORABLE
24,4,2021,9,359,387,746,2021-04-24 08:00:00,2021-04-24 00:00:00,LABORABLE
24,4,2021,10,494,521,1015,2021-04-24 09:00:00,2021-04-24 00:00:00,LABORABLE
24,4,2021,11,539,609,1148,2021-04-24 10:00:00,2021-04-24 00:00:00,LABORABLE
24,4,2021,12,621,697,1318,2021-04-24 11:00:00,2021-04-24 00:00:00,LABORABLE
24,4,2021,13,645,754,1399,2021-04-24 12:00:00,2021-04-24 00:00:00,LABORABLE
24,4,2021,14,650,808,1458,2021-04-24 13:00:00,2021-04-24 00:00:00,LABORABLE
24,4,2021,15,627,769,1396,2021-04-24 14:00:00,2021-04-24 00:00:00,LABORABLE
24,4,2021,16,523,688,1211,2021-04-24 15:00:00,2021-04-24 00:00:00,LABORABLE
24,4,2021,17,534,672,1206,2021-04-24 16:00:00,2021-04-24 00:00:00,LABORABLE
24,4,2021,18,617,756,1373,2021-04-24 17:00:00,2021-04-24 00:00:00,LABORABLE
24,4,2021,19,596,752,1348,2021-04-24 18:00:00,2021-04-24 00:00:00,LABORABLE
24,4,2021,20,577,702,1279,2021-04-24 19:00:00,2021-04-24 00:00:00,LABORABLE
24,4,2021,21,530,714,1244,2021-04-24 20:00:00,2021-04-24 00:00:00,LABORABLE
24,4,2021,22,466,572,1038,2021-04-24 21:00:00,2021-04-24 00:00:00,LABORABLE
24,4,2021,23,522,639,1161,2021-04-24 22:00:00,2021-04-24 00:00:00,LABORABLE
24,4,2021,24,393,468,861,2021-04-24 23:00:00,2021-04-24 00:00:00,LABORABLE
25,4,2021,1,175,207,382,2021-04-25 00:00:00,2021-04-25 00:00:00,LABORABLE
25,4,2021,2,81,106,187,2021-04-25 01:00:00,2021-04-25 00:00:00,LABORABLE
25,4,2021,3,53,86,139,2021-04-25 02:00:00,2021-04-25 00:00:00,LABORABLE
25,4,2021,4,34,52,86,2021-04-25 03:00:00,2021-04-25 00:00:00,LABORABLE
25,4,2021,5,43,51,94,2021-04-25 04:00:00,2021-04-25 00:00:00,LABORABLE
25,4,2021,6,45,56,101,2021-04-25 05:00:00,2021-04-25 00:00:00,LABORABLE
25,4,2021,7,92,107,199,2021-04-25 06:00:00,2021-04-25 00:00:00,LABORABLE
25,4,2021,8,151,146,297,2021-04-25 07:00:00,2021-04-25 00:00:00,LABORABLE
25,4,2021,9,238,254,492,2021-04-25 08:00:00,2021-04-25 00:00:00,LABORABLE
25,4,2021,10,325,387,712,2021-04-25 09:00:00,2021-04-25 00:00:00,LABORABLE
25,4,2021,11,464,454,918,2021-04-25 10:00:00,2021-04-25 00:00:00,LABORABLE
25,4,2021,12,524,610,1134,2021-04-25 11:00:00,2021-04-25 00:00:00,LABORABLE
25,4,2021,13,528,663,1191,2021-04-25 12:00:00,2021-04-25 00:00:00,LABORABLE
25,4,2021,14,565,680,1245,2021-04-25 13:00:00,2021-04-25 00:00:00,LABORABLE
25,4,2021,15,501,718,1219,2021-04-25 14:00:00,2021-04-25 00:00:00,LABORABLE
25,4,2021,16,468,594,1062,2021-04-25 15:00:00,2021-04-25 00:00:00,LABORABLE
25,4,2021,17,424,562,986,2021-04-25 16:00:00,2021-04-25 00:00:00,LABORABLE
25,4,2021,18,481,610,1091,2021-04-25 17:00:00,2021-04-25 00:00:00,LABORABLE
25,4,2021,19,481,627,1108,2021-04-25 18:00:00,2021-04-25 00:00:00,LABORABLE
25,4,2021,20,463,585,1048,2021-04-25 19:00:00,2021-04-25 00:00:00,LABORABLE
25,4,2021,21,495,591,1086,2021-04-25 20:00:00,2021-04-25 00:00:00,LABORABLE
25,4,2021,22,408,478,886,2021-04-25 21:00:00,2021-04-25 00:00:00,LABORABLE
25,4,2021,23,385,400,785,2021-04-25 22:00:00,2021-04-25 00:00:00,LABORABLE
25,4,2021,24,242,318,560,2021-04-25 23:00:00,2021-04-25 00:00:00,LABORABLE
26,4,2021,1,106,137,243,2021-04-26 00:00:00,2021-04-26 00:00:00,LABORABLE
26,4,2021,2,36,76,112,2021-04-26 01:00:00,2021-04-26 00:00:00,LABORABLE
26,4,2021,3,51,36,87,2021-04-26 02:00:00,2021-04-26 00:00:00,LABORABLE
26,4,2021,4,48,45,93,2021-04-26 03:00:00,2021-04-26 00:00:00,LABORABLE
26,4,2021,5,56,44,100,2021-04-26 04:00:00,2021-04-26 00:00:00,LABORABLE
26,4,2021,6,143,88,231,2021-04-26 05:00:00,2021-04-26 00:00:00,LABORABLE
26,4,2021,7,391,333,724,2021-04-26 06:00:00,2021-04-26 00:00:00,LABORABLE
26,4,2021,8,740,555,1295,2021-04-26 07:00:00,2021-04-26 00:00:00,LABORABLE
26,4,2021,9,700,751,1451,2021-04-26 08:00:00,2021-04-26 00:00:00,LABORABLE
26,4,2021,10,658,739,1397,2021-04-26 09:00:00,2021-04-26 00:00:00,LABORABLE
26,4,2021,11,562,660,1222,2021-04-26 10:00:00,2021-04-26 00:00:00,LABORABLE
26,4,2021,12,546,721,1267,2021-04-26 11:00:00,2021-04-26 00:00:00,LABORABLE
26,4,2021,13,496,664,1160,2021-04-26 12:00:00,2021-04-26 00:00:00,LABORABLE
26,4,2021,14,492,706,1198,2021-04-26 13:00:00,2021-04-26 00:00:00,LABORABLE
26,4,2021,15,679,695,1374,2021-04-26 14:00:00,2021-04-26 00:00:00,LABORABLE
26,4,2021,16,632,639,1271,2021-04-26 15:00:00,2021-04-26 00:00:00,LABORABLE
26,4,2021,17,637,696,1333,2021-04-26 16:00:00,2021-04-26 00:00:00,LABORABLE
26,4,2021,18,661,745,1406,2021-04-26 17:00:00,2021-04-26 00:00:00,LABORABLE
26,4,2021,19,640,756,1396,2021-04-26 18:00:00,2021-04-26 00:00:00,LABORABLE
26,4,2021,20,636,740,1376,2021-04-26 19:00:00,2021-04-26 00:00:00,LABORABLE
26,4,2021,21,589,733,1322,2021-04-26 20:00:00,2021-04-26 00:00:00,LABORABLE
26,4,2021,22,463,575,1038,2021-04-26 21:00:00,2021-04-26 00:00:00,LABORABLE
26,4,2021,23,381,404,785,2021-04-26 22:00:00,2021-04-26 00:00:00,LABORABLE
26,4,2021,24,170,241,411,2021-04-26 23:00:00,2021-04-26 00:00:00,LABORABLE
27,4,2021,1,85,106,191,2021-04-27 00:00:00,2021-04-27 00:00:00,LABORABLE
27,4,2021,2,38,78,116,2021-04-27 01:00:00,2021-04-27 00:00:00,LABORABLE
27,4,2021,3,48,46,94,2021-04-27 02:00:00,2021-04-27 00:00:00,LABORABLE
27,4,2021,4,46,47,93,2021-04-27 03:00:00,2021-04-27 00:00:00,LABORABLE
27,4,2021,5,56,62,118,2021-04-27 04:00:00,2021-04-27 00:00:00,LABORABLE
27,4,2021,6,160,100,260,2021-04-27 05:00:00,2021-04-27 00:00:00,LABORABLE
27,4,2021,7,405,299,704,2021-04-27 06:00:00,2021-04-27 00:00:00,LABORABLE
27,4,2021,8,704,580,1284,2021-04-27 07:00:00,2021-04-27 00:00:00,LABORABLE
27,4,2021,9,683,702,1385,2021-04-27 08:00:00,2021-04-27 00:00:00,LABORABLE
27,4,2021,10,636,717,1353,2021-04-27 09:00:00,2021-04-27 00:00:00,LABORABLE
27,4,2021,11,547,632,1179,2021-04-27 10:00:00,2021-04-27 00:00:00,LABORABLE
27,4,2021,12,583,681,1264,2021-04-27 11:00:00,2021-04-27 00:00:00,LABORABLE
27,4,2021,13,581,717,1298,2021-04-27 12:00:00,2021-04-27 00:00:00,LABORABLE
27,4,2021,14,631,741,1372,2021-04-27 13:00:00,2021-04-27 00:00:00,LABORABLE
27,4,2021,15,658,714,1372,2021-04-27 14:00:00,2021-04-27 00:00:00,LABORABLE
27,4,2021,16,620,708,1328,2021-04-27 15:00:00,2021-04-27 00:00:00,LABORABLE
27,4,2021,17,629,705,1334,2021-04-27 16:00:00,2021-04-27 00:00:00,LABORABLE
27,4,2021,18,667,710,1377,2021-04-27 17:00:00,2021-04-27 00:00:00,LABORABLE
27,4,2021,19,658,708,1366,2021-04-27 18:00:00,2021-04-27 00:00:00,LABORABLE
27,4,2021,20,643,684,1327,2021-04-27 19:00:00,2021-04-27 00:00:00,LABORABLE
27,4,2021,21,576,694,1270,2021-04-27 20:00:00,2021-04-27 00:00:00,LABORABLE
27,4,2021,22,432,465,897,2021-04-27 21:00:00,2021-04-27 00:00:00,LABORABLE
27,4,2021,23,386,373,759,2021-04-27 22:00:00,2021-04-27 00:00:00,LABORABLE
27,4,2021,24,230,253,483,2021-04-27 23:00:00,2021-04-27 00:00:00,LABORABLE
28,4,2021,1,99,88,187,2021-04-28 00:00:00,2021-04-28 00:00:00,LABORABLE
28,4,2021,2,41,63,104,2021-04-28 01:00:00,2021-04-28 00:00:00,LABORABLE
28,4,2021,3,40,48,88,2021-04-28 02:00:00,2021-04-28 00:00:00,LABORABLE
28,4,2021,4,38,41,79,2021-04-28 03:00:00,2021-04-28 00:00:00,LABORABLE
28,4,2021,5,62,48,110,2021-04-28 04:00:00,2021-04-28 00:00:00,LABORABLE
28,4,2021,6,163,113,276,2021-04-28 05:00:00,2021-04-28 00:00:00,LABORABLE
28,4,2021,7,430,323,753,2021-04-28 06:00:00,2021-04-28 00:00:00,LABORABLE
28,4,2021,8,651,605,1256,2021-04-28 07:00:00,2021-04-28 00:00:00,LABORABLE
28,4,2021,9,674,664,1338,2021-04-28 08:00:00,2021-04-28 00:00:00,LABORABLE
28,4,2021,10,619,731,1350,2021-04-28 09:00:00,2021-04-28 00:00:00,LABORABLE
28,4,2021,11,569,648,1217,2021-04-28 10:00:00,2021-04-28 00:00:00,LABORABLE
28,4,2021,12,596,610,1206,2021-04-28 11:00:00,2021-04-28 00:00:00,LABORABLE
28,4,2021,13,531,714,1245,2021-04-28 12:00:00,2021-04-28 00:00:00,LABORABLE
28,4,2021,14,649,739,1388,2021-04-28 13:00:00,2021-04-28 00:00:00,LABORABLE
28,4,2021,15,663,701,1364,2021-04-28 14:00:00,2021-04-28 00:00:00,LABORABLE
28,4,2021,16,650,676,1326,2021-04-28 15:00:00,2021-04-28 00:00:00,LABORABLE
28,4,2021,17,647,709,1356,2021-04-28 16:00:00,2021-04-28 00:00:00,LABORABLE
28,4,2021,18,676,722,1398,2021-04-28 17:00:00,2021-04-28 00:00:00,LABORABLE
28,4,2021,19,709,762,1471,2021-04-28 18:00:00,2021-04-28 00:00:00,LABORABLE
28,4,2021,20,635,766,1401,2021-04-28 19:00:00,2021-04-28 00:00:00,LABORABLE
28,4,2021,21,614,723,1337,2021-04-28 20:00:00,2021-04-28 00:00:00,LABORABLE
28,4,2021,22,493,542,1035,2021-04-28 21:00:00,2021-04-28 00:00:00,LABORABLE
28,4,2021,23,438,384,822,2021-04-28 22:00:00,2021-04-28 00:00:00,LABORABLE
28,4,2021,24,223,279,502,2021-04-28 23:00:00,2021-04-28 00:00:00,LABORABLE
29,4,2021,1,112,119,231,2021-04-29 00:00:00,2021-04-29 00:00:00,LABORABLE
29,4,2021,2,46,62,108,2021-04-29 01:00:00,2021-04-29 00:00:00,LABORABLE
29,4,2021,3,38,61,99,2021-04-29 02:00:00,2021-04-29 00:00:00,LABORABLE
29,4,2021,4,40,46,86,2021-04-29 03:00:00,2021-04-29 00:00:00,LABORABLE
29,4,2021,5,58,62,120,2021-04-29 04:00:00,2021-04-29 00:00:00,LABORABLE
29,4,2021,6,146,114,260,2021-04-29 05:00:00,2021-04-29 00:00:00,LABORABLE
29,4,2021,7,441,310,751,2021-04-29 06:00:00,2021-04-29 00:00:00,LABORABLE
29,4,2021,8,706,630,1336,2021-04-29 07:00:00,2021-04-29 00:00:00,LABORABLE
29,4,2021,9,709,720,1429,2021-04-29 08:00:00,2021-04-29 00:00:00,LABORABLE
29,4,2021,10,654,713,1367,2021-04-29 09:00:00,2021-04-29 00:00:00,LABORABLE
29,4,2021,11,614,700,1314,2021-04-29 10:00:00,2021-04-29 00:00:00,LABORABLE
29,4,2021,12,630,735,1365,2021-04-29 11:00:00,2021-04-29 00:00:00,LABORABLE
29,4,2021,13,582,740,1322,2021-04-29 12:00:00,2021-04-29 00:00:00,LABORABLE
29,4,2021,14,666,733,1399,2021-04-29 13:00:00,2021-04-29 00:00:00,LABORABLE
29,4,2021,15,636,703,1339,2021-04-29 14:00:00,2021-04-29 00:00:00,LABORABLE
29,4,2021,16,669,666,1335,2021-04-29 15:00:00,2021-04-29 00:00:00,LABORABLE
29,4,2021,17,656,751,1407,2021-04-29 16:00:00,2021-04-29 00:00:00,LABORABLE
29,4,2021,18,653,765,1418,2021-04-29 17:00:00,2021-04-29 00:00:00,LABORABLE
29,4,2021,19,735,741,1476,2021-04-29 18:00:00,2021-04-29 00:00:00,LABORABLE
29,4,2021,20,574,839,1413,2021-04-29 19:00:00,2021-04-29 00:00:00,LABORABLE
29,4,2021,21,678,777,1455,2021-04-29 20:00:00,2021-04-29 00:00:00,LABORABLE
29,4,2021,22,517,584,1101,2021-04-29 21:00:00,2021-04-29 00:00:00,LABORABLE
29,4,2021,23,497,508,1005,2021-04-29 22:00:00,2021-04-29 00:00:00,LABORABLE
29,4,2021,24,269,300,569,2021-04-29 23:00:00,2021-04-29 00:00:00,LABORABLE
30,4,2021,1,128,161,289,2021-04-30 00:00:00,2021-04-30 00:00:00,LABORABLE
30,4,2021,2,45,69,114,2021-04-30 01:00:00,2021-04-30 00:00:00,LABORABLE
30,4,2021,3,54,71,125,2021-04-30 02:00:00,2021-04-30 00:00:00,LABORABLE
30,4,2021,4,43,37,80,2021-04-30 03:00:00,2021-04-30 00:00:00,LABORABLE
30,4,2021,5,76,65,141,2021-04-30 04:00:00,2021-04-30 00:00:00,LABORABLE
30,4,2021,6,168,122,290,2021-04-30 05:00:00,2021-04-30 00:00:00,LABORABLE
30,4,2021,7,403,333,736,2021-04-30 06:00:00,2021-04-30 00:00:00,LABORABLE
30,4,2021,8,684,584,1268,2021-04-30 07:00:00,2021-04-30 00:00:00,LABORABLE
30,4,2021,9,744,702,1446,2021-04-30 08:00:00,2021-04-30 00:00:00,LABORABLE
30,4,2021,10,641,692,1333,2021-04-30 09:00:00,2021-04-30 00:00:00,LABORABLE
30,4,2021,11,571,720,1291,2021-04-30 10:00:00,2021-04-30 00:00:00,LABORABLE
30,4,2021,12,588,687,1275,2021-04-30 11:00:00,2021-04-30 00:00:00,LABORABLE
30,4,2021,13,633,793,1426,2021-04-30 12:00:00,2021-04-30 00:00:00,LABORABLE
30,4,2021,14,677,739,1416,2021-04-30 13:00:00,2021-04-30 00:00:00,LABORABLE
30,4,2021,15,702,745,1447,2021-04-30 14:00:00,2021-04-30 00:00:00,LABORABLE
30,4,2021,16,693,780,1473,2021-04-30 15:00:00,2021-04-30 00:00:00,LABORABLE
30,4,2021,17,661,769,1430,2021-04-30 16:00:00,2021-04-30 00:00:00,LABORABLE
30,4,2021,18,710,845,1555,2021-04-30 17:00:00,2021-04-30 00:00:00,LABORABLE
30,4,2021,19,677,824,1501,2021-04-30 18:00:00,2021-04-30 00:00:00,LABORABLE
30,4,2021,20,687,826,1513,2021-04-30 19:00:00,2021-04-30 00:00:00,LABORABLE
30,4,2021,21,694,845,1539,2021-04-30 20:00:00,2021-04-30 00:00:00,LABORABLE
30,4,2021,22,603,771,1374,2021-04-30 21:00:00,2021-04-30 00:00:00,LABORABLE
30,4,2021,23,572,706,1278,2021-04-30 22:00:00,2021-04-30 00:00:00,LABORABLE
30,4,2021,24,424,526,950,2021-04-30 23:00:00,2021-04-30 00:00:00,LABORABLE
1,5,2021,1,173,216,389,2021-05-01 00:00:00,2021-01-05 00:00:00,FESTIVO
1,5,2021,2,85,101,186,2021-05-01 01:00:00,2021-01-05 00:00:00,FESTIVO
1,5,2021,3,44,10,54,2021-05-01 02:00:00,2021-01-05 00:00:00,FESTIVO
1,5,2021,4,48,69,117,2021-05-01 03:00:00,2021-01-05 00:00:00,FESTIVO
1,5,2021,5,41,49,90,2021-05-01 04:00:00,2021-01-05 00:00:00,FESTIVO
1,5,2021,6,54,64,118,2021-05-01 05:00:00,2021-01-05 00:00:00,FESTIVO
1,5,2021,7,133,110,243,2021-05-01 06:00:00,2021-01-05 00:00:00,FESTIVO
1,5,2021,8,221,201,422,2021-05-01 07:00:00,2021-01-05 00:00:00,FESTIVO
1,5,2021,9,289,361,650,2021-05-01 08:00:00,2021-01-05 00:00:00,FESTIVO
1,5,2021,10,65,70,135,2021-05-01 09:00:00,2021-01-05 00:00:00,FESTIVO
1,5,2021,11,528,595,1123,2021-05-01 10:00:00,2021-01-05 00:00:00,FESTIVO
1,5,2021,12,620,748,1368,2021-05-01 11:00:00,2021-01-05 00:00:00,FESTIVO
1,5,2021,13,648,797,1445,2021-05-01 12:00:00,2021-01-05 00:00:00,FESTIVO
1,5,2021,14,657,834,1491,2021-05-01 13:00:00,2021-01-05 00:00:00,FESTIVO
1,5,2021,15,593,786,1379,2021-05-01 14:00:00,2021-01-05 00:00:00,FESTIVO
1,5,2021,16,505,743,1248,2021-05-01 15:00:00,2021-01-05 00:00:00,FESTIVO
1,5,2021,17,504,666,1170,2021-05-01 16:00:00,2021-01-05 00:00:00,FESTIVO
1,5,2021,18,590,727,1317,2021-05-01 17:00:00,2021-01-05 00:00:00,FESTIVO
1,5,2021,19,564,790,1354,2021-05-01 18:00:00,2021-01-05 00:00:00,FESTIVO
1,5,2021,20,565,754,1319,2021-05-01 19:00:00,2021-01-05 00:00:00,FESTIVO
1,5,2021,21,536,669,1205,2021-05-01 20:00:00,2021-01-05 00:00:00,FESTIVO
1,5,2021,22,530,688,1218,2021-05-01 21:00:00,2021-01-05 00:00:00,FESTIVO
1,5,2021,23,545,656,1201,2021-05-01 22:00:00,2021-01-05 00:00:00,FESTIVO
1,5,2021,24,417,495,912,2021-05-01 23:00:00,2021-01-05 00:00:00,FESTIVO
2,5,2021,1,209,235,444,2021-05-02 00:00:00,2021-02-05 00:00:00,LABORABLE
2,5,2021,2,96,118,214,2021-05-02 01:00:00,2021-02-05 00:00:00,LABORABLE
2,5,2021,3,82,84,166,2021-05-02 02:00:00,2021-02-05 00:00:00,LABORABLE
2,5,2021,4,56,80,136,2021-05-02 03:00:00,2021-02-05 00:00:00,LABORABLE
2,5,2021,5,46,63,109,2021-05-02 04:00:00,2021-02-05 00:00:00,LABORABLE
2,5,2021,6,77,76,153,2021-05-02 05:00:00,2021-02-05 00:00:00,LABORABLE
2,5,2021,7,123,102,225,2021-05-02 06:00:00,2021-02-05 00:00:00,LABORABLE
2,5,2021,8,154,159,313,2021-05-02 07:00:00,2021-02-05 00:00:00,LABORABLE
2,5,2021,9,238,255,493,2021-05-02 08:00:00,2021-02-05 00:00:00,LABORABLE
2,5,2021,10,377,478,855,2021-05-02 09:00:00,2021-02-05 00:00:00,LABORABLE
2,5,2021,11,498,593,1091,2021-05-02 10:00:00,2021-02-05 00:00:00,LABORABLE
2,5,2021,12,598,671,1269,2021-05-02 11:00:00,2021-02-05 00:00:00,LABORABLE
2,5,2021,13,667,689,1356,2021-05-02 12:00:00,2021-02-05 00:00:00,LABORABLE
2,5,2021,14,666,837,1503,2021-05-02 13:00:00,2021-02-05 00:00:00,LABORABLE
2,5,2021,15,628,773,1401,2021-05-02 14:00:00,2021-02-05 00:00:00,LABORABLE
2,5,2021,16,517,667,1184,2021-05-02 15:00:00,2021-02-05 00:00:00,LABORABLE
2,5,2021,17,480,745,1225,2021-05-02 16:00:00,2021-02-05 00:00:00,LABORABLE
2,5,2021,18,570,709,1279,2021-05-02 17:00:00,2021-02-05 00:00:00,LABORABLE
2,5,2021,19,571,757,1328,2021-05-02 18:00:00,2021-02-05 00:00:00,LABORABLE
2,5,2021,20,528,677,1205,2021-05-02 19:00:00,2021-02-05 00:00:00,LABORABLE
2,5,2021,21,527,679,1206,2021-05-02 20:00:00,2021-02-05 00:00:00,LABORABLE
2,5,2021,22,482,583,1065,2021-05-02 21:00:00,2021-02-05 00:00:00,LABORABLE
2,5,2021,23,511,549,1060,2021-05-02 22:00:00,2021-02-05 00:00:00,LABORABLE
2,5,2021,24,358,419,777,2021-05-02 23:00:00,2021-02-05 00:00:00,LABORABLE
3,5,2021,1,159,187,346,2021-05-03 00:00:00,2021-03-05 00:00:00,FESTIVO
3,5,2021,2,70,71,141,2021-05-03 01:00:00,2021-03-05 00:00:00,FESTIVO
3,5,2021,3,66,60,126,2021-05-03 02:00:00,2021-03-05 00:00:00,FESTIVO
3,5,2021,4,64,55,119,2021-05-03 03:00:00,2021-03-05 00:00:00,FESTIVO
3,5,2021,5,33,27,60,2021-05-03 04:00:00,2021-03-05 00:00:00,FESTIVO
3,5,2021,6,102,65,167,2021-05-03 05:00:00,2021-03-05 00:00:00,FESTIVO
3,5,2021,7,159,140,299,2021-05-03 06:00:00,2021-03-05 00:00:00,FESTIVO
3,5,2021,8,244,186,430,2021-05-03 07:00:00,2021-03-05 00:00:00,FESTIVO
3,5,2021,9,311,251,562,2021-05-03 08:00:00,2021-03-05 00:00:00,FESTIVO
3,5,2021,10,366,427,793,2021-05-03 09:00:00,2021-03-05 00:00:00,FESTIVO
3,5,2021,11,344,509,853,2021-05-03 10:00:00,2021-03-05 00:00:00,FESTIVO
3,5,2021,12,516,597,1113,2021-05-03 11:00:00,2021-03-05 00:00:00,FESTIVO
3,5,2021,13,534,647,1181,2021-05-03 12:00:00,2021-03-05 00:00:00,FESTIVO
3,5,2021,14,499,627,1126,2021-05-03 13:00:00,2021-03-05 00:00:00,FESTIVO
3,5,2021,15,486,617,1103,2021-05-03 14:00:00,2021-03-05 00:00:00,FESTIVO
3,5,2021,16,440,624,1064,2021-05-03 15:00:00,2021-03-05 00:00:00,FESTIVO
3,5,2021,17,435,576,1011,2021-05-03 16:00:00,2021-03-05 00:00:00,FESTIVO
3,5,2021,18,507,628,1135,2021-05-03 17:00:00,2021-03-05 00:00:00,FESTIVO
3,5,2021,19,512,667,1179,2021-05-03 18:00:00,2021-03-05 00:00:00,FESTIVO
3,5,2021,20,510,675,1185,2021-05-03 19:00:00,2021-03-05 00:00:00,FESTIVO
3,5,2021,21,503,638,1141,2021-05-03 20:00:00,2021-03-05 00:00:00,FESTIVO
3,5,2021,22,481,538,1019,2021-05-03 21:00:00,2021-03-05 00:00:00,FESTIVO
3,5,2021,23,392,443,835,2021-05-03 22:00:00,2021-03-05 00:00:00,FESTIVO
3,5,2021,24,241,318,559,2021-05-03 23:00:00,2021-03-05 00:00:00,FESTIVO
4,5,2021,1,197,285,482,2021-05-04 00:00:00,2021-04-05 00:00:00,LABORABLE
4,5,2021,2,128,205,333,2021-05-04 01:00:00,2021-04-05 00:00:00,LABORABLE
4,5,2021,3,88,137,225,2021-05-04 02:00:00,2021-04-05 00:00:00,LABORABLE
4,5,2021,4,51,112,163,2021-05-04 03:00:00,2021-04-05 00:00:00,LABORABLE
4,5,2021,5,71,97,168,2021-05-04 04:00:00,2021-04-05 00:00:00,LABORABLE
4,5,2021,6,159,105,264,2021-05-04 05:00:00,2021-04-05 00:00:00,LABORABLE
4,5,2021,7,415,299,714,2021-05-04 06:00:00,2021-04-05 00:00:00,LABORABLE
4,5,2021,8,652,530,1182,2021-05-04 07:00:00,2021-04-05 00:00:00,LABORABLE
4,5,2021,9,566,632,1198,2021-05-04 08:00:00,2021-04-05 00:00:00,LABORABLE
4,5,2021,10,568,688,1256,2021-05-04 09:00:00,2021-04-05 00:00:00,LABORABLE
4,5,2021,11,618,637,1255,2021-05-04 10:00:00,2021-04-05 00:00:00,LABORABLE
4,5,2021,12,622,680,1302,2021-05-04 11:00:00,2021-04-05 00:00:00,LABORABLE
4,5,2021,13,668,766,1434,2021-05-04 12:00:00,2021-04-05 00:00:00,LABORABLE
4,5,2021,14,703,706,1409,2021-05-04 13:00:00,2021-04-05 00:00:00,LABORABLE
4,5,2021,15,647,748,1395,2021-05-04 14:00:00,2021-04-05 00:00:00,LABORABLE
4,5,2021,16,636,678,1314,2021-05-04 15:00:00,2021-04-05 00:00:00,LABORABLE
4,5,2021,17,615,685,1300,2021-05-04 16:00:00,2021-04-05 00:00:00,LABORABLE
4,5,2021,18,685,782,1467,2021-05-04 17:00:00,2021-04-05 00:00:00,LABORABLE
4,5,2021,19,675,768,1443,2021-05-04 18:00:00,2021-04-05 00:00:00,LABORABLE
4,5,2021,20,643,830,1473,2021-05-04 19:00:00,2021-04-05 00:00:00,LABORABLE
4,5,2021,21,586,702,1288,2021-05-04 20:00:00,2021-04-05 00:00:00,LABORABLE
4,5,2021,22,513,557,1070,2021-05-04 21:00:00,2021-04-05 00:00:00,LABORABLE
4,5,2021,23,411,452,863,2021-05-04 22:00:00,2021-04-05 00:00:00,LABORABLE
4,5,2021,24,221,405,626,2021-05-04 23:00:00,2021-04-05 00:00:00,LABORABLE
5,5,2021,1,215,285,500,2021-05-05 00:00:00,2021-05-05 00:00:00,LABORABLE
5,5,2021,2,127,209,336,2021-05-05 01:00:00,2021-05-05 00:00:00,LABORABLE
5,5,2021,3,86,142,228,2021-05-05 02:00:00,2021-05-05 00:00:00,LABORABLE
5,5,2021,4,69,86,155,2021-05-05 03:00:00,2021-05-05 00:00:00,LABORABLE
5,5,2021,5,67,99,166,2021-05-05 04:00:00,2021-05-05 00:00:00,LABORABLE
5,5,2021,6,146,119,265,2021-05-05 05:00:00,2021-05-05 00:00:00,LABORABLE
5,5,2021,7,430,319,749,2021-05-05 06:00:00,2021-05-05 00:00:00,LABORABLE
5,5,2021,8,656,607,1263,2021-05-05 07:00:00,2021-05-05 00:00:00,LABORABLE
5,5,2021,9,677,701,1378,2021-05-05 08:00:00,2021-05-05 00:00:00,LABORABLE
5,5,2021,10,650,734,1384,2021-05-05 09:00:00,2021-05-05 00:00:00,LABORABLE
5,5,2021,11,567,673,1240,2021-05-05 10:00:00,2021-05-05 00:00:00,LABORABLE
5,5,2021,12,558,709,1267,2021-05-05 11:00:00,2021-05-05 00:00:00,LABORABLE
5,5,2021,13,577,707,1284,2021-05-05 12:00:00,2021-05-05 00:00:00,LABORABLE
5,5,2021,14,667,727,1394,2021-05-05 13:00:00,2021-05-05 00:00:00,LABORABLE
5,5,2021,15,643,737,1380,2021-05-05 14:00:00,2021-05-05 00:00:00,LABORABLE
5,5,2021,16,679,681,1360,2021-05-05 15:00:00,2021-05-05 00:00:00,LABORABLE
5,5,2021,17,652,701,1353,2021-05-05 16:00:00,2021-05-05 00:00:00,LABORABLE
5,5,2021,18,710,762,1472,2021-05-05 17:00:00,2021-05-05 00:00:00,LABORABLE
5,5,2021,19,656,741,1397,2021-05-05 18:00:00,2021-05-05 00:00:00,LABORABLE
5,5,2021,20,687,733,1420,2021-05-05 19:00:00,2021-05-05 00:00:00,LABORABLE
5,5,2021,21,627,751,1378,2021-05-05 20:00:00,2021-05-05 00:00:00,LABORABLE
5,5,2021,22,523,560,1083,2021-05-05 21:00:00,2021-05-05 00:00:00,LABORABLE
5,5,2021,23,446,486,932,2021-05-05 22:00:00,2021-05-05 00:00:00,LABORABLE
5,5,2021,24,244,307,551,2021-05-05 23:00:00,2021-05-05 00:00:00,LABORABLE
6,5,2021,1,220,304,524,2021-05-06 00:00:00,2021-06-05 00:00:00,LABORABLE
6,5,2021,2,139,224,363,2021-05-06 01:00:00,2021-06-05 00:00:00,LABORABLE
6,5,2021,3,85,156,241,2021-05-06 02:00:00,2021-06-05 00:00:00,LABORABLE
6,5,2021,4,71,124,195,2021-05-06 03:00:00,2021-06-05 00:00:00,LABORABLE
6,5,2021,5,65,106,171,2021-05-06 04:00:00,2021-06-05 00:00:00,LABORABLE
6,5,2021,6,159,128,287,2021-05-06 05:00:00,2021-06-05 00:00:00,LABORABLE
6,5,2021,7,414,300,714,2021-05-06 06:00:00,2021-06-05 00:00:00,LABORABLE
6,5,2021,8,702,609,1311,2021-05-06 07:00:00,2021-06-05 00:00:00,LABORABLE
6,5,2021,9,685,716,1401,2021-05-06 08:00:00,2021-06-05 00:00:00,LABORABLE
6,5,2021,10,681,718,1399,2021-05-06 09:00:00,2021-06-05 00:00:00,LABORABLE
6,5,2021,11,534,599,1133,2021-05-06 10:00:00,2021-06-05 00:00:00,LABORABLE
6,5,2021,12,622,683,1305,2021-05-06 11:00:00,2021-06-05 00:00:00,LABORABLE
6,5,2021,13,610,741,1351,2021-05-06 12:00:00,2021-06-05 00:00:00,LABORABLE
6,5,2021,14,655,778,1433,2021-05-06 13:00:00,2021-06-05 00:00:00,LABORABLE
6,5,2021,15,660,774,1434,2021-05-06 14:00:00,2021-06-05 00:00:00,LABORABLE
6,5,2021,16,632,720,1352,2021-05-06 15:00:00,2021-06-05 00:00:00,LABORABLE
6,5,2021,17,674,776,1450,2021-05-06 16:00:00,2021-06-05 00:00:00,LABORABLE
6,5,2021,18,672,714,1386,2021-05-06 17:00:00,2021-06-05 00:00:00,LABORABLE
6,5,2021,19,727,776,1503,2021-05-06 18:00:00,2021-06-05 00:00:00,LABORABLE
6,5,2021,20,656,784,1440,2021-05-06 19:00:00,2021-06-05 00:00:00,LABORABLE
6,5,2021,21,612,726,1338,2021-05-06 20:00:00,2021-06-05 00:00:00,LABORABLE
6,5,2021,22,529,661,1190,2021-05-06 21:00:00,2021-06-05 00:00:00,LABORABLE
6,5,2021,23,476,460,936,2021-05-06 22:00:00,2021-06-05 00:00:00,LABORABLE
6,5,2021,24,395,478,873,2021-05-06 23:00:00,2021-06-05 00:00:00,LABORABLE
7,5,2021,1,293,391,684,2021-05-07 00:00:00,2021-07-05 00:00:00,LABORABLE
7,5,2021,2,218,303,521,2021-05-07 01:00:00,2021-07-05 00:00:00,LABORABLE
7,5,2021,3,157,241,398,2021-05-07 02:00:00,2021-07-05 00:00:00,LABORABLE
7,5,2021,4,111,187,298,2021-05-07 03:00:00,2021-07-05 00:00:00,LABORABLE
7,5,2021,5,73,151,224,2021-05-07 04:00:00,2021-07-05 00:00:00,LABORABLE
7,5,2021,6,159,140,299,2021-05-07 05:00:00,2021-07-05 00:00:00,LABORABLE
7,5,2021,7,260,317,577,2021-05-07 06:00:00,2021-07-05 00:00:00,LABORABLE
7,5,2021,8,402,608,1010,2021-05-07 07:00:00,2021-07-05 00:00:00,LABORABLE
7,5,2021,9,723,701,1424,2021-05-07 08:00:00,2021-07-05 00:00:00,LABORABLE
7,5,2021,10,639,767,1406,2021-05-07 09:00:00,2021-07-05 00:00:00,LABORABLE
7,5,2021,11,569,700,1269,2021-05-07 10:00:00,2021-07-05 00:00:00,LABORABLE
7,5,2021,12,657,771,1428,2021-05-07 11:00:00,2021-07-05 00:00:00,LABORABLE
7,5,2021,13,600,795,1395,2021-05-07 12:00:00,2021-07-05 00:00:00,LABORABLE
7,5,2021,14,696,775,1471,2021-05-07 13:00:00,2021-07-05 00:00:00,LABORABLE
7,5,2021,15,743,757,1500,2021-05-07 14:00:00,2021-07-05 00:00:00,LABORABLE
7,5,2021,16,660,733,1393,2021-05-07 15:00:00,2021-07-05 00:00:00,LABORABLE
7,5,2021,17,656,769,1425,2021-05-07 16:00:00,2021-07-05 00:00:00,LABORABLE
7,5,2021,18,681,740,1421,2021-05-07 17:00:00,2021-07-05 00:00:00,LABORABLE
7,5,2021,19,720,742,1462,2021-05-07 18:00:00,2021-07-05 00:00:00,LABORABLE
7,5,2021,20,709,782,1491,2021-05-07 19:00:00,2021-07-05 00:00:00,LABORABLE
7,5,2021,21,713,849,1562,2021-05-07 20:00:00,2021-07-05 00:00:00,LABORABLE
7,5,2021,22,591,675,1266,2021-05-07 21:00:00,2021-07-05 00:00:00,LABORABLE
7,5,2021,23,587,686,1273,2021-05-07 22:00:00,2021-07-05 00:00:00,LABORABLE
7,5,2021,24,430,478,908,2021-05-07 23:00:00,2021-07-05 00:00:00,LABORABLE
8,5,2021,1,200,235,435,2021-05-08 00:00:00,2021-08-05 00:00:00,LABORABLE
8,5,2021,2,82,106,188,2021-05-08 01:00:00,2021-08-05 00:00:00,LABORABLE
8,5,2021,3,81,89,170,2021-05-08 02:00:00,2021-08-05 00:00:00,LABORABLE
8,5,2021,4,51,50,101,2021-05-08 03:00:00,2021-08-05 00:00:00,LABORABLE
8,5,2021,5,61,65,126,2021-05-08 04:00:00,2021-08-05 00:00:00,LABORABLE
8,5,2021,6,94,95,189,2021-05-08 05:00:00,2021-08-05 00:00:00,LABORABLE
8,5,2021,7,189,166,355,2021-05-08 06:00:00,2021-08-05 00:00:00,LABORABLE
8,5,2021,8,311,232,543,2021-05-08 07:00:00,2021-08-05 00:00:00,LABORABLE
8,5,2021,9,390,388,778,2021-05-08 08:00:00,2021-08-05 00:00:00,LABORABLE
8,5,2021,10,512,546,1058,2021-05-08 09:00:00,2021-08-05 00:00:00,LABORABLE
8,5,2021,11,590,634,1224,2021-05-08 10:00:00,2021-08-05 00:00:00,LABORABLE
8,5,2021,12,683,716,1399,2021-05-08 11:00:00,2021-08-05 00:00:00,LABORABLE
8,5,2021,13,695,770,1465,2021-05-08 12:00:00,2021-08-05 00:00:00,LABORABLE
8,5,2021,14,676,759,1435,2021-05-08 13:00:00,2021-08-05 00:00:00,LABORABLE
8,5,2021,15,633,735,1368,2021-05-08 14:00:00,2021-08-05 00:00:00,LABORABLE
8,5,2021,16,542,669,1211,2021-05-08 15:00:00,2021-08-05 00:00:00,LABORABLE
8,5,2021,17,522,674,1196,2021-05-08 16:00:00,2021-08-05 00:00:00,LABORABLE
8,5,2021,18,561,688,1249,2021-05-08 17:00:00,2021-08-05 00:00:00,LABORABLE
8,5,2021,19,645,720,1365,2021-05-08 18:00:00,2021-08-05 00:00:00,LABORABLE
8,5,2021,20,639,786,1425,2021-05-08 19:00:00,2021-08-05 00:00:00,LABORABLE
8,5,2021,21,556,703,1259,2021-05-08 20:00:00,2021-08-05 00:00:00,LABORABLE
8,5,2021,22,528,618,1146,2021-05-08 21:00:00,2021-08-05 00:00:00,LABORABLE
8,5,2021,23,590,633,1223,2021-05-08 22:00:00,2021-08-05 00:00:00,LABORABLE
8,5,2021,24,466,558,1024,2021-05-08 23:00:00,2021-08-05 00:00:00,LABORABLE
9,5,2021,1,273,302,575,2021-05-09 00:00:00,2021-09-05 00:00:00,LABORABLE
9,5,2021,2,144,172,316,2021-05-09 01:00:00,2021-09-05 00:00:00,LABORABLE
9,5,2021,3,107,104,211,2021-05-09 02:00:00,2021-09-05 00:00:00,LABORABLE
9,5,2021,4,75,78,153,2021-05-09 03:00:00,2021-09-05 00:00:00,LABORABLE
9,5,2021,5,56,81,137,2021-05-09 04:00:00,2021-09-05 00:00:00,LABORABLE
9,5,2021,6,69,84,153,2021-05-09 05:00:00,2021-09-05 00:00:00,LABORABLE
9,5,2021,7,112,103,215,2021-05-09 06:00:00,2021-09-05 00:00:00,LABORABLE
9,5,2021,8,143,152,295,2021-05-09 07:00:00,2021-09-05 00:00:00,LABORABLE
9,5,2021,9,240,293,533,2021-05-09 08:00:00,2021-09-05 00:00:00,LABORABLE
9,5,2021,10,370,421,791,2021-05-09 09:00:00,2021-09-05 00:00:00,LABORABLE
9,5,2021,11,455,501,956,2021-05-09 10:00:00,2021-09-05 00:00:00,LABORABLE
9,5,2021,12,591,544,1135,2021-05-09 11:00:00,2021-09-05 00:00:00,LABORABLE
9,5,2021,13,600,678,1278,2021-05-09 12:00:00,2021-09-05 00:00:00,LABORABLE
9,5,2021,14,622,711,1333,2021-05-09 13:00:00,2021-09-05 00:00:00,LABORABLE
9,5,2021,15,592,712,1304,2021-05-09 14:00:00,2021-09-05 00:00:00,LABORABLE
9,5,2021,16,487,634,1121,2021-05-09 15:00:00,2021-09-05 00:00:00,LABORABLE
9,5,2021,17,506,615,1121,2021-05-09 16:00:00,2021-09-05 00:00:00,LABORABLE
9,5,2021,18,554,658,1212,2021-05-09 17:00:00,2021-09-05 00:00:00,LABORABLE
9,5,2021,19,577,700,1277,2021-05-09 18:00:00,2021-09-05 00:00:00,LABORABLE
9,5,2021,20,507,625,1132,2021-05-09 19:00:00,2021-09-05 00:00:00,LABORABLE
9,5,2021,21,503,627,1130,2021-05-09 20:00:00,2021-09-05 00:00:00,LABORABLE
9,5,2021,22,437,557,994,2021-05-09 21:00:00,2021-09-05 00:00:00,LABORABLE
9,5,2021,23,415,437,852,2021-05-09 22:00:00,2021-09-05 00:00:00,LABORABLE
9,5,2021,24,334,397,731,2021-05-09 23:00:00,2021-09-05 00:00:00,LABORABLE
10,5,2021,1,200,297,497,2021-05-10 00:00:00,2021-10-05 00:00:00,LABORABLE
10,5,2021,2,80,181,261,2021-05-10 01:00:00,2021-10-05 00:00:00,LABORABLE
10,5,2021,3,57,171,228,2021-05-10 02:00:00,2021-10-05 00:00:00,LABORABLE
10,5,2021,4,58,95,153,2021-05-10 03:00:00,2021-10-05 00:00:00,LABORABLE
10,5,2021,5,55,113,168,2021-05-10 04:00:00,2021-10-05 00:00:00,LABORABLE
10,5,2021,6,159,125,284,2021-05-10 05:00:00,2021-10-05 00:00:00,LABORABLE
10,5,2021,7,287,307,594,2021-05-10 06:00:00,2021-10-05 00:00:00,LABORABLE
10,5,2021,8,692,590,1282,2021-05-10 07:00:00,2021-10-05 00:00:00,LABORABLE
10,5,2021,9,682,753,1435,2021-05-10 08:00:00,2021-10-05 00:00:00,LABORABLE
10,5,2021,10,651,738,1389,2021-05-10 09:00:00,2021-10-05 00:00:00,LABORABLE
10,5,2021,11,566,644,1210,2021-05-10 10:00:00,2021-10-05 00:00:00,LABORABLE
10,5,2021,12,565,745,1310,2021-05-10 11:00:00,2021-10-05 00:00:00,LABORABLE
10,5,2021,13,585,732,1317,2021-05-10 12:00:00,2021-10-05 00:00:00,LABORABLE
10,5,2021,14,624,736,1360,2021-05-10 13:00:00,2021-10-05 00:00:00,LABORABLE
10,5,2021,15,654,737,1391,2021-05-10 14:00:00,2021-10-05 00:00:00,LABORABLE
10,5,2021,16,688,710,1398,2021-05-10 15:00:00,2021-10-05 00:00:00,LABORABLE
10,5,2021,17,642,733,1375,2021-05-10 16:00:00,2021-10-05 00:00:00,LABORABLE
10,5,2021,18,709,728,1437,2021-05-10 17:00:00,2021-10-05 00:00:00,LABORABLE
10,5,2021,19,690,777,1467,2021-05-10 18:00:00,2021-10-05 00:00:00,LABORABLE
10,5,2021,20,654,805,1459,2021-05-10 19:00:00,2021-10-05 00:00:00,LABORABLE
10,5,2021,21,638,708,1346,2021-05-10 20:00:00,2021-10-05 00:00:00,LABORABLE
10,5,2021,22,474,588,1062,2021-05-10 21:00:00,2021-10-05 00:00:00,LABORABLE
10,5,2021,23,358,396,754,2021-05-10 22:00:00,2021-10-05 00:00:00,LABORABLE
10,5,2021,24,215,366,581,2021-05-10 23:00:00,2021-10-05 00:00:00,LABORABLE
11,5,2021,1,142,255,397,2021-05-11 00:00:00,2021-11-05 00:00:00,LABORABLE
11,5,2021,2,74,205,279,2021-05-11 01:00:00,2021-11-05 00:00:00,LABORABLE
11,5,2021,3,88,137,225,2021-05-11 02:00:00,2021-11-05 00:00:00,LABORABLE
11,5,2021,4,58,112,170,2021-05-11 03:00:00,2021-11-05 00:00:00,LABORABLE
11,5,2021,5,65,97,162,2021-05-11 04:00:00,2021-11-05 00:00:00,LABORABLE
11,5,2021,6,168,98,266,2021-05-11 05:00:00,2021-11-05 00:00:00,LABORABLE
11,5,2021,7,401,336,737,2021-05-11 06:00:00,2021-11-05 00:00:00,LABORABLE
11,5,2021,8,703,591,1294,2021-05-11 07:00:00,2021-11-05 00:00:00,LABORABLE
11,5,2021,9,703,700,1403,2021-05-11 08:00:00,2021-11-05 00:00:00,LABORABLE
11,5,2021,10,644,757,1401,2021-05-11 09:00:00,2021-11-05 00:00:00,LABORABLE
11,5,2021,11,566,670,1236,2021-05-11 10:00:00,2021-11-05 00:00:00,LABORABLE
11,5,2021,12,607,716,1323,2021-05-11 11:00:00,2021-11-05 00:00:00,LABORABLE
11,5,2021,13,448,657,1105,2021-05-11 12:00:00,2021-11-05 00:00:00,LABORABLE
11,5,2021,14,677,697,1374,2021-05-11 13:00:00,2021-11-05 00:00:00,LABORABLE
11,5,2021,15,634,711,1345,2021-05-11 14:00:00,2021-11-05 00:00:00,LABORABLE
11,5,2021,16,689,669,1358,2021-05-11 15:00:00,2021-11-05 00:00:00,LABORABLE
11,5,2021,17,652,728,1380,2021-05-11 16:00:00,2021-11-05 00:00:00,LABORABLE
11,5,2021,18,668,732,1400,2021-05-11 17:00:00,2021-11-05 00:00:00,LABORABLE
11,5,2021,19,662,744,1406,2021-05-11 18:00:00,2021-11-05 00:00:00,LABORABLE
11,5,2021,20,662,727,1389,2021-05-11 19:00:00,2021-11-05 00:00:00,LABORABLE
11,5,2021,21,668,763,1431,2021-05-11 20:00:00,2021-11-05 00:00:00,LABORABLE
11,5,2021,22,563,551,1114,2021-05-11 21:00:00,2021-11-05 00:00:00,LABORABLE
11,5,2021,23,399,428,827,2021-05-11 22:00:00,2021-11-05 00:00:00,LABORABLE
11,5,2021,24,233,405,638,2021-05-11 23:00:00,2021-11-05 00:00:00,LABORABLE
12,5,2021,1,169,285,454,2021-05-12 00:00:00,2021-12-05 00:00:00,LABORABLE
12,5,2021,2,127,209,336,2021-05-12 01:00:00,2021-12-05 00:00:00,LABORABLE
12,5,2021,3,86,142,228,2021-05-12 02:00:00,2021-12-05 00:00:00,LABORABLE
12,5,2021,4,69,107,176,2021-05-12 03:00:00,2021-12-05 00:00:00,LABORABLE
12,5,2021,5,53,99,152,2021-05-12 04:00:00,2021-12-05 00:00:00,LABORABLE
12,5,2021,6,153,122,275,2021-05-12 05:00:00,2021-12-05 00:00:00,LABORABLE
12,5,2021,7,424,316,740,2021-05-12 06:00:00,2021-12-05 00:00:00,LABORABLE
12,5,2021,8,666,552,1218,2021-05-12 07:00:00,2021-12-05 00:00:00,LABORABLE
12,5,2021,9,660,742,1402,2021-05-12 08:00:00,2021-12-05 00:00:00,LABORABLE
12,5,2021,10,609,713,1322,2021-05-12 09:00:00,2021-12-05 00:00:00,LABORABLE
12,5,2021,11,538,625,1163,2021-05-12 10:00:00,2021-12-05 00:00:00,LABORABLE
12,5,2021,12,584,701,1285,2021-05-12 11:00:00,2021-12-05 00:00:00,LABORABLE
12,5,2021,13,617,693,1310,2021-05-12 12:00:00,2021-12-05 00:00:00,LABORABLE
12,5,2021,14,626,716,1342,2021-05-12 13:00:00,2021-12-05 00:00:00,LABORABLE
12,5,2021,15,703,711,1414,2021-05-12 14:00:00,2021-12-05 00:00:00,LABORABLE
12,5,2021,16,657,710,1367,2021-05-12 15:00:00,2021-12-05 00:00:00,LABORABLE
12,5,2021,17,694,727,1421,2021-05-12 16:00:00,2021-12-05 00:00:00,LABORABLE
12,5,2021,18,697,743,1440,2021-05-12 17:00:00,2021-12-05 00:00:00,LABORABLE
12,5,2021,19,672,760,1432,2021-05-12 18:00:00,2021-12-05 00:00:00,LABORABLE
12,5,2021,20,681,757,1438,2021-05-12 19:00:00,2021-12-05 00:00:00,LABORABLE
12,5,2021,21,718,727,1445,2021-05-12 20:00:00,2021-12-05 00:00:00,LABORABLE
12,5,2021,22,514,567,1081,2021-05-12 21:00:00,2021-12-05 00:00:00,LABORABLE
12,5,2021,23,402,455,857,2021-05-12 22:00:00,2021-12-05 00:00:00,LABORABLE
12,5,2021,24,236,364,600,2021-05-12 23:00:00,2021-12-05 00:00:00,LABORABLE
13,5,2021,1,173,246,419,2021-05-13 00:00:00,2021-05-13 00:00:00,LABORABLE
13,5,2021,2,139,224,363,2021-05-13 01:00:00,2021-05-13 00:00:00,LABORABLE
13,5,2021,3,85,156,241,2021-05-13 02:00:00,2021-05-13 00:00:00,LABORABLE
13,5,2021,4,67,124,191,2021-05-13 03:00:00,2021-05-13 00:00:00,LABORABLE
13,5,2021,5,91,106,197,2021-05-13 04:00:00,2021-05-13 00:00:00,LABORABLE
13,5,2021,6,179,136,315,2021-05-13 05:00:00,2021-05-13 00:00:00,LABORABLE
13,5,2021,7,421,334,755,2021-05-13 06:00:00,2021-05-13 00:00:00,LABORABLE
13,5,2021,8,713,584,1297,2021-05-13 07:00:00,2021-05-13 00:00:00,LABORABLE
13,5,2021,9,725,700,1425,2021-05-13 08:00:00,2021-05-13 00:00:00,LABORABLE
13,5,2021,10,674,736,1410,2021-05-13 09:00:00,2021-05-13 00:00:00,LABORABLE
13,5,2021,11,577,676,1253,2021-05-13 10:00:00,2021-05-13 00:00:00,LABORABLE
13,5,2021,12,639,693,1332,2021-05-13 11:00:00,2021-05-13 00:00:00,LABORABLE
13,5,2021,13,618,717,1335,2021-05-13 12:00:00,2021-05-13 00:00:00,LABORABLE
13,5,2021,14,672,773,1445,2021-05-13 13:00:00,2021-05-13 00:00:00,LABORABLE
13,5,2021,15,685,697,1382,2021-05-13 14:00:00,2021-05-13 00:00:00,LABORABLE
13,5,2021,16,664,670,1334,2021-05-13 15:00:00,2021-05-13 00:00:00,LABORABLE
13,5,2021,17,677,670,1347,2021-05-13 16:00:00,2021-05-13 00:00:00,LABORABLE
13,5,2021,18,702,779,1481,2021-05-13 17:00:00,2021-05-13 00:00:00,LABORABLE
13,5,2021,19,701,744,1445,2021-05-13 18:00:00,2021-05-13 00:00:00,LABORABLE
13,5,2021,20,679,758,1437,2021-05-13 19:00:00,2021-05-13 00:00:00,LABORABLE
13,5,2021,21,641,718,1359,2021-05-13 20:00:00,2021-05-13 00:00:00,LABORABLE
13,5,2021,22,592,633,1225,2021-05-13 21:00:00,2021-05-13 00:00:00,LABORABLE
13,5,2021,23,543,517,1060,2021-05-13 22:00:00,2021-05-13 00:00:00,LABORABLE
13,5,2021,24,270,416,686,2021-05-13 23:00:00,2021-05-13 00:00:00,LABORABLE
14,5,2021,1,203,360,563,2021-05-14 00:00:00,2021-05-14 00:00:00,LABORABLE
14,5,2021,2,218,303,521,2021-05-14 01:00:00,2021-05-14 00:00:00,LABORABLE
14,5,2021,3,157,241,398,2021-05-14 02:00:00,2021-05-14 00:00:00,LABORABLE
14,5,2021,4,60,187,247,2021-05-14 03:00:00,2021-05-14 00:00:00,LABORABLE
14,5,2021,5,76,151,227,2021-05-14 04:00:00,2021-05-14 00:00:00,LABORABLE
14,5,2021,6,172,141,313,2021-05-14 05:00:00,2021-05-14 00:00:00,LABORABLE
14,5,2021,7,388,294,682,2021-05-14 06:00:00,2021-05-14 00:00:00,LABORABLE
14,5,2021,8,402,567,969,2021-05-14 07:00:00,2021-05-14 00:00:00,LABORABLE
14,5,2021,9,700,656,1356,2021-05-14 08:00:00,2021-05-14 00:00:00,LABORABLE
14,5,2021,10,664,726,1390,2021-05-14 09:00:00,2021-05-14 00:00:00,LABORABLE
14,5,2021,11,617,726,1343,2021-05-14 10:00:00,2021-05-14 00:00:00,LABORABLE
14,5,2021,12,590,662,1252,2021-05-14 11:00:00,2021-05-14 00:00:00,LABORABLE
14,5,2021,13,684,769,1453,2021-05-14 12:00:00,2021-05-14 00:00:00,LABORABLE
14,5,2021,14,683,757,1440,2021-05-14 13:00:00,2021-05-14 00:00:00,LABORABLE
14,5,2021,15,744,834,1578,2021-05-14 14:00:00,2021-05-14 00:00:00,LABORABLE
14,5,2021,16,654,708,1362,2021-05-14 15:00:00,2021-05-14 00:00:00,LABORABLE
14,5,2021,17,693,783,1476,2021-05-14 16:00:00,2021-05-14 00:00:00,LABORABLE
14,5,2021,18,709,798,1507,2021-05-14 17:00:00,2021-05-14 00:00:00,LABORABLE
14,5,2021,19,594,740,1334,2021-05-14 18:00:00,2021-05-14 00:00:00,LABORABLE
14,5,2021,20,733,830,1563,2021-05-14 19:00:00,2021-05-14 00:00:00,LABORABLE
14,5,2021,21,675,850,1525,2021-05-14 20:00:00,2021-05-14 00:00:00,LABORABLE
14,5,2021,22,680,643,1323,2021-05-14 21:00:00,2021-05-14 00:00:00,LABORABLE
14,5,2021,23,608,677,1285,2021-05-14 22:00:00,2021-05-14 00:00:00,LABORABLE
14,5,2021,24,401,433,834,2021-05-14 23:00:00,2021-05-14 00:00:00,LABORABLE
15,5,2021,1,334,432,766,2021-05-15 00:00:00,2021-05-15 00:00:00,FESTIVO
15,5,2021,2,168,227,395,2021-05-15 01:00:00,2021-05-15 00:00:00,FESTIVO
15,5,2021,3,108,176,284,2021-05-15 02:00:00,2021-05-15 00:00:00,FESTIVO
15,5,2021,4,90,101,191,2021-05-15 03:00:00,2021-05-15 00:00:00,FESTIVO
15,5,2021,5,59,59,118,2021-05-15 04:00:00,2021-05-15 00:00:00,FESTIVO
15,5,2021,6,88,93,181,2021-05-15 05:00:00,2021-05-15 00:00:00,FESTIVO
15,5,2021,7,142,119,261,2021-05-15 06:00:00,2021-05-15 00:00:00,FESTIVO
15,5,2021,8,275,237,512,2021-05-15 07:00:00,2021-05-15 00:00:00,FESTIVO
15,5,2021,9,399,361,760,2021-05-15 08:00:00,2021-05-15 00:00:00,FESTIVO
15,5,2021,10,456,419,875,2021-05-15 09:00:00,2021-05-15 00:00:00,FESTIVO
15,5,2021,11,537,568,1105,2021-05-15 10:00:00,2021-05-15 00:00:00,FESTIVO
15,5,2021,12,602,598,1200,2021-05-15 11:00:00,2021-05-15 00:00:00,FESTIVO
15,5,2021,13,656,693,1349,2021-05-15 12:00:00,2021-05-15 00:00:00,FESTIVO
15,5,2021,14,645,712,1357,2021-05-15 13:00:00,2021-05-15 00:00:00,FESTIVO
15,5,2021,15,605,685,1290,2021-05-15 14:00:00,2021-05-15 00:00:00,FESTIVO
15,5,2021,16,505,688,1193,2021-05-15 15:00:00,2021-05-15 00:00:00,FESTIVO
15,5,2021,17,485,668,1153,2021-05-15 16:00:00,2021-05-15 00:00:00,FESTIVO
15,5,2021,18,564,666,1230,2021-05-15 17:00:00,2021-05-15 00:00:00,FESTIVO
15,5,2021,19,606,671,1277,2021-05-15 18:00:00,2021-05-15 00:00:00,FESTIVO
15,5,2021,20,545,660,1205,2021-05-15 19:00:00,2021-05-15 00:00:00,FESTIVO
15,5,2021,21,550,694,1244,2021-05-15 20:00:00,2021-05-15 00:00:00,FESTIVO
15,5,2021,22,655,662,1317,2021-05-15 21:00:00,2021-05-15 00:00:00,FESTIVO
15,5,2021,23,474,589,1063,2021-05-15 22:00:00,2021-05-15 00:00:00,FESTIVO
15,5,2021,24,400,477,877,2021-05-15 23:00:00,2021-05-15 00:00:00,FESTIVO
16,5,2021,1,404,458,862,2021-05-16 00:00:00,2021-05-16 00:00:00,LABORABLE
16,5,2021,2,233,271,504,2021-05-16 01:00:00,2021-05-16 00:00:00,LABORABLE
16,5,2021,3,129,174,303,2021-05-16 02:00:00,2021-05-16 00:00:00,LABORABLE
16,5,2021,4,69,114,183,2021-05-16 03:00:00,2021-05-16 00:00:00,LABORABLE
16,5,2021,5,51,82,133,2021-05-16 04:00:00,2021-05-16 00:00:00,LABORABLE
16,5,2021,6,61,89,150,2021-05-16 05:00:00,2021-05-16 00:00:00,LABORABLE
16,5,2021,7,95,100,195,2021-05-16 06:00:00,2021-05-16 00:00:00,LABORABLE
16,5,2021,8,148,167,315,2021-05-16 07:00:00,2021-05-16 00:00:00,LABORABLE
16,5,2021,9,230,251,481,2021-05-16 08:00:00,2021-05-16 00:00:00,LABORABLE
16,5,2021,10,320,376,696,2021-05-16 09:00:00,2021-05-16 00:00:00,LABORABLE
16,5,2021,11,462,477,939,2021-05-16 10:00:00,2021-05-16 00:00:00,LABORABLE
16,5,2021,12,541,561,1102,2021-05-16 11:00:00,2021-05-16 00:00:00,LABORABLE
16,5,2021,13,574,660,1234,2021-05-16 12:00:00,2021-05-16 00:00:00,LABORABLE
16,5,2021,14,587,699,1286,2021-05-16 13:00:00,2021-05-16 00:00:00,LABORABLE
16,5,2021,15,541,612,1153,2021-05-16 14:00:00,2021-05-16 00:00:00,LABORABLE
16,5,2021,16,473,615,1088,2021-05-16 15:00:00,2021-05-16 00:00:00,LABORABLE
16,5,2021,17,465,664,1129,2021-05-16 16:00:00,2021-05-16 00:00:00,LABORABLE
16,5,2021,18,506,707,1213,2021-05-16 17:00:00,2021-05-16 00:00:00,LABORABLE
16,5,2021,19,525,767,1292,2021-05-16 18:00:00,2021-05-16 00:00:00,LABORABLE
16,5,2021,20,481,769,1250,2021-05-16 19:00:00,2021-05-16 00:00:00,LABORABLE
16,5,2021,21,481,630,1111,2021-05-16 20:00:00,2021-05-16 00:00:00,LABORABLE
16,5,2021,22,609,627,1236,2021-05-16 21:00:00,2021-05-16 00:00:00,LABORABLE
16,5,2021,23,436,454,890,2021-05-16 22:00:00,2021-05-16 00:00:00,LABORABLE
16,5,2021,24,296,332,628,2021-05-16 23:00:00,2021-05-16 00:00:00,LABORABLE
17,5,2021,1,214,275,489,2021-05-17 00:00:00,2021-05-17 00:00:00,LABORABLE
17,5,2021,2,93,226,319,2021-05-17 01:00:00,2021-05-17 00:00:00,LABORABLE
17,5,2021,3,69,171,240,2021-05-17 02:00:00,2021-05-17 00:00:00,LABORABLE
17,5,2021,4,54,127,181,2021-05-17 03:00:00,2021-05-17 00:00:00,LABORABLE
17,5,2021,5,61,92,153,2021-05-17 04:00:00,2021-05-17 00:00:00,LABORABLE
17,5,2021,6,167,110,277,2021-05-17 05:00:00,2021-05-17 00:00:00,LABORABLE
17,5,2021,7,402,292,694,2021-05-17 06:00:00,2021-05-17 00:00:00,LABORABLE
17,5,2021,8,713,581,1294,2021-05-17 07:00:00,2021-05-17 00:00:00,LABORABLE
17,5,2021,9,689,702,1391,2021-05-17 08:00:00,2021-05-17 00:00:00,LABORABLE
17,5,2021,10,616,675,1291,2021-05-17 09:00:00,2021-05-17 00:00:00,LABORABLE
17,5,2021,11,579,661,1240,2021-05-17 10:00:00,2021-05-17 00:00:00,LABORABLE
17,5,2021,12,540,664,1204,2021-05-17 11:00:00,2021-05-17 00:00:00,LABORABLE
17,5,2021,13,609,698,1307,2021-05-17 12:00:00,2021-05-17 00:00:00,LABORABLE
17,5,2021,14,664,756,1420,2021-05-17 13:00:00,2021-05-17 00:00:00,LABORABLE
17,5,2021,15,460,617,1077,2021-05-17 14:00:00,2021-05-17 00:00:00,LABORABLE
17,5,2021,16,649,618,1267,2021-05-17 15:00:00,2021-05-17 00:00:00,LABORABLE
17,5,2021,17,589,734,1323,2021-05-17 16:00:00,2021-05-17 00:00:00,LABORABLE
17,5,2021,18,561,642,1203,2021-05-17 17:00:00,2021-05-17 00:00:00,LABORABLE
17,5,2021,19,718,766,1484,2021-05-17 18:00:00,2021-05-17 00:00:00,LABORABLE
17,5,2021,20,612,775,1387,2021-05-17 19:00:00,2021-05-17 00:00:00,LABORABLE
17,5,2021,21,590,701,1291,2021-05-17 20:00:00,2021-05-17 00:00:00,LABORABLE
17,5,2021,22,496,559,1055,2021-05-17 21:00:00,2021-05-17 00:00:00,LABORABLE
17,5,2021,23,400,395,795,2021-05-17 22:00:00,2021-05-17 00:00:00,LABORABLE
17,5,2021,24,229,397,626,2021-05-17 23:00:00,2021-05-17 00:00:00,LABORABLE
18,5,2021,1,142,234,376,2021-05-18 00:00:00,2021-05-18 00:00:00,LABORABLE
18,5,2021,2,67,205,272,2021-05-18 01:00:00,2021-05-18 00:00:00,LABORABLE
18,5,2021,3,88,137,225,2021-05-18 02:00:00,2021-05-18 00:00:00,LABORABLE
18,5,2021,4,51,112,163,2021-05-18 03:00:00,2021-05-18 00:00:00,LABORABLE
18,5,2021,5,69,97,166,2021-05-18 04:00:00,2021-05-18 00:00:00,LABORABLE
18,5,2021,6,159,117,276,2021-05-18 05:00:00,2021-05-18 00:00:00,LABORABLE
18,5,2021,7,412,410,822,2021-05-18 06:00:00,2021-05-18 00:00:00,LABORABLE
18,5,2021,8,695,572,1267,2021-05-18 07:00:00,2021-05-18 00:00:00,LABORABLE
18,5,2021,9,721,736,1457,2021-05-18 08:00:00,2021-05-18 00:00:00,LABORABLE
18,5,2021,10,627,679,1306,2021-05-18 09:00:00,2021-05-18 00:00:00,LABORABLE
18,5,2021,11,550,654,1204,2021-05-18 10:00:00,2021-05-18 00:00:00,LABORABLE
18,5,2021,12,552,656,1208,2021-05-18 11:00:00,2021-05-18 00:00:00,LABORABLE
18,5,2021,13,580,660,1240,2021-05-18 12:00:00,2021-05-18 00:00:00,LABORABLE
18,5,2021,14,614,818,1432,2021-05-18 13:00:00,2021-05-18 00:00:00,LABORABLE
18,5,2021,15,634,698,1332,2021-05-18 14:00:00,2021-05-18 00:00:00,LABORABLE
18,5,2021,16,664,658,1322,2021-05-18 15:00:00,2021-05-18 00:00:00,LABORABLE
18,5,2021,17,610,681,1291,2021-05-18 16:00:00,2021-05-18 00:00:00,LABORABLE
18,5,2021,18,673,766,1439,2021-05-18 17:00:00,2021-05-18 00:00:00,LABORABLE
18,5,2021,19,683,728,1411,2021-05-18 18:00:00,2021-05-18 00:00:00,LABORABLE
18,5,2021,20,635,807,1442,2021-05-18 19:00:00,2021-05-18 00:00:00,LABORABLE
18,5,2021,21,592,670,1262,2021-05-18 20:00:00,2021-05-18 00:00:00,LABORABLE
18,5,2021,22,559,566,1125,2021-05-18 21:00:00,2021-05-18 00:00:00,LABORABLE
18,5,2021,23,388,447,835,2021-05-18 22:00:00,2021-05-18 00:00:00,LABORABLE
18,5,2021,24,213,317,530,2021-05-18 23:00:00,2021-05-18 00:00:00,LABORABLE
19,5,2021,1,148,285,433,2021-05-19 00:00:00,2021-05-19 00:00:00,LABORABLE
19,5,2021,2,127,170,297,2021-05-19 01:00:00,2021-05-19 00:00:00,LABORABLE
19,5,2021,3,86,142,228,2021-05-19 02:00:00,2021-05-19 00:00:00,LABORABLE
19,5,2021,4,55,135,190,2021-05-19 03:00:00,2021-05-19 00:00:00,LABORABLE
19,5,2021,5,61,99,160,2021-05-19 04:00:00,2021-05-19 00:00:00,LABORABLE
19,5,2021,6,162,114,276,2021-05-19 05:00:00,2021-05-19 00:00:00,LABORABLE
19,5,2021,7,431,327,758,2021-05-19 06:00:00,2021-05-19 00:00:00,LABORABLE
19,5,2021,8,678,596,1274,2021-05-19 07:00:00,2021-05-19 00:00:00,LABORABLE
19,5,2021,9,672,728,1400,2021-05-19 08:00:00,2021-05-19 00:00:00,LABORABLE
19,5,2021,10,633,700,1333,2021-05-19 09:00:00,2021-05-19 00:00:00,LABORABLE
19,5,2021,11,593,661,1254,2021-05-19 10:00:00,2021-05-19 00:00:00,LABORABLE
19,5,2021,12,482,539,1021,2021-05-19 11:00:00,2021-05-19 00:00:00,LABORABLE
19,5,2021,13,578,660,1238,2021-05-19 12:00:00,2021-05-19 00:00:00,LABORABLE
19,5,2021,14,636,707,1343,2021-05-19 13:00:00,2021-05-19 00:00:00,LABORABLE
19,5,2021,15,686,725,1411,2021-05-19 14:00:00,2021-05-19 00:00:00,LABORABLE
19,5,2021,16,650,608,1258,2021-05-19 15:00:00,2021-05-19 00:00:00,LABORABLE
19,5,2021,17,639,706,1345,2021-05-19 16:00:00,2021-05-19 00:00:00,LABORABLE
19,5,2021,18,635,824,1459,2021-05-19 17:00:00,2021-05-19 00:00:00,LABORABLE
19,5,2021,19,686,743,1429,2021-05-19 18:00:00,2021-05-19 00:00:00,LABORABLE
19,5,2021,20,645,759,1404,2021-05-19 19:00:00,2021-05-19 00:00:00,LABORABLE
19,5,2021,21,592,753,1345,2021-05-19 20:00:00,2021-05-19 00:00:00,LABORABLE
19,5,2021,22,571,604,1175,2021-05-19 21:00:00,2021-05-19 00:00:00,LABORABLE
19,5,2021,23,529,464,993,2021-05-19 22:00:00,2021-05-19 00:00:00,LABORABLE
19,5,2021,24,257,295,552,2021-05-19 23:00:00,2021-05-19 00:00:00,LABORABLE
20,5,2021,1,188,272,460,2021-05-20 00:00:00,2021-05-20 00:00:00,LABORABLE
20,5,2021,2,99,224,323,2021-05-20 01:00:00,2021-05-20 00:00:00,LABORABLE
20,5,2021,3,62,156,218,2021-05-20 02:00:00,2021-05-20 00:00:00,LABORABLE
20,5,2021,4,56,124,180,2021-05-20 03:00:00,2021-05-20 00:00:00,LABORABLE
20,5,2021,5,62,73,135,2021-05-20 04:00:00,2021-05-20 00:00:00,LABORABLE
20,5,2021,6,173,137,310,2021-05-20 05:00:00,2021-05-20 00:00:00,LABORABLE
20,5,2021,7,431,451,882,2021-05-20 06:00:00,2021-05-20 00:00:00,LABORABLE
20,5,2021,8,693,682,1375,2021-05-20 07:00:00,2021-05-20 00:00:00,LABORABLE
20,5,2021,9,678,693,1371,2021-05-20 08:00:00,2021-05-20 00:00:00,LABORABLE
20,5,2021,10,587,730,1317,2021-05-20 09:00:00,2021-05-20 00:00:00,LABORABLE
20,5,2021,11,583,630,1213,2021-05-20 10:00:00,2021-05-20 00:00:00,LABORABLE
20,5,2021,12,582,678,1260,2021-05-20 11:00:00,2021-05-20 00:00:00,LABORABLE
20,5,2021,13,493,675,1168,2021-05-20 12:00:00,2021-05-20 00:00:00,LABORABLE
20,5,2021,14,707,714,1421,2021-05-20 13:00:00,2021-05-20 00:00:00,LABORABLE
20,5,2021,15,666,691,1357,2021-05-20 14:00:00,2021-05-20 00:00:00,LABORABLE
20,5,2021,16,630,691,1321,2021-05-20 15:00:00,2021-05-20 00:00:00,LABORABLE
20,5,2021,17,582,710,1292,2021-05-20 16:00:00,2021-05-20 00:00:00,LABORABLE
20,5,2021,18,670,721,1391,2021-05-20 17:00:00,2021-05-20 00:00:00,LABORABLE
20,5,2021,19,689,778,1467,2021-05-20 18:00:00,2021-05-20 00:00:00,LABORABLE
20,5,2021,20,668,746,1414,2021-05-20 19:00:00,2021-05-20 00:00:00,LABORABLE
20,5,2021,21,614,748,1362,2021-05-20 20:00:00,2021-05-20 00:00:00,LABORABLE
20,5,2021,22,627,619,1246,2021-05-20 21:00:00,2021-05-20 00:00:00,LABORABLE
20,5,2021,23,417,462,879,2021-05-20 22:00:00,2021-05-20 00:00:00,LABORABLE
20,5,2021,24,299,330,629,2021-05-20 23:00:00,2021-05-20 00:00:00,LABORABLE
21,5,2021,1,209,346,555,2021-05-21 00:00:00,2021-05-21 00:00:00,LABORABLE
21,5,2021,2,218,303,521,2021-05-21 01:00:00,2021-05-21 00:00:00,LABORABLE
21,5,2021,3,157,241,398,2021-05-21 02:00:00,2021-05-21 00:00:00,LABORABLE
21,5,2021,4,60,187,247,2021-05-21 03:00:00,2021-05-21 00:00:00,LABORABLE
21,5,2021,5,79,151,230,2021-05-21 04:00:00,2021-05-21 00:00:00,LABORABLE
21,5,2021,6,166,148,314,2021-05-21 05:00:00,2021-05-21 00:00:00,LABORABLE
21,5,2021,7,260,333,593,2021-05-21 06:00:00,2021-05-21 00:00:00,LABORABLE
21,5,2021,8,402,624,1026,2021-05-21 07:00:00,2021-05-21 00:00:00,LABORABLE
21,5,2021,9,648,691,1339,2021-05-21 08:00:00,2021-05-21 00:00:00,LABORABLE
21,5,2021,10,606,709,1315,2021-05-21 09:00:00,2021-05-21 00:00:00,LABORABLE
21,5,2021,11,583,659,1242,2021-05-21 10:00:00,2021-05-21 00:00:00,LABORABLE
21,5,2021,12,607,754,1361,2021-05-21 11:00:00,2021-05-21 00:00:00,LABORABLE
21,5,2021,13,587,762,1349,2021-05-21 12:00:00,2021-05-21 00:00:00,LABORABLE
21,5,2021,14,675,756,1431,2021-05-21 13:00:00,2021-05-21 00:00:00,LABORABLE
21,5,2021,15,689,745,1434,2021-05-21 14:00:00,2021-05-21 00:00:00,LABORABLE
21,5,2021,16,636,723,1359,2021-05-21 15:00:00,2021-05-21 00:00:00,LABORABLE
21,5,2021,17,609,770,1379,2021-05-21 16:00:00,2021-05-21 00:00:00,LABORABLE
21,5,2021,18,652,792,1444,2021-05-21 17:00:00,2021-05-21 00:00:00,LABORABLE
21,5,2021,19,647,779,1426,2021-05-21 18:00:00,2021-05-21 00:00:00,LABORABLE
21,5,2021,20,709,838,1547,2021-05-21 19:00:00,2021-05-21 00:00:00,LABORABLE
21,5,2021,21,619,829,1448,2021-05-21 20:00:00,2021-05-21 00:00:00,LABORABLE
21,5,2021,22,655,699,1354,2021-05-21 21:00:00,2021-05-21 00:00:00,LABORABLE
21,5,2021,23,564,528,1092,2021-05-21 22:00:00,2021-05-21 00:00:00,LABORABLE
21,5,2021,24,355,434,789,2021-05-21 23:00:00,2021-05-21 00:00:00,LABORABLE
22,5,2021,1,324,418,742,2021-05-22 00:00:00,2021-05-22 00:00:00,LABORABLE
22,5,2021,2,173,213,386,2021-05-22 01:00:00,2021-05-22 00:00:00,LABORABLE
22,5,2021,3,124,133,257,2021-05-22 02:00:00,2021-05-22 00:00:00,LABORABLE
22,5,2021,4,81,112,193,2021-05-22 03:00:00,2021-05-22 00:00:00,LABORABLE
22,5,2021,5,72,97,169,2021-05-22 04:00:00,2021-05-22 00:00:00,LABORABLE
22,5,2021,6,100,115,215,2021-05-22 05:00:00,2021-05-22 00:00:00,LABORABLE
22,5,2021,7,180,145,325,2021-05-22 06:00:00,2021-05-22 00:00:00,LABORABLE
22,5,2021,8,307,312,619,2021-05-22 07:00:00,2021-05-22 00:00:00,LABORABLE
22,5,2021,9,432,416,848,2021-05-22 08:00:00,2021-05-22 00:00:00,LABORABLE
22,5,2021,10,465,505,970,2021-05-22 09:00:00,2021-05-22 00:00:00,LABORABLE
22,5,2021,11,542,604,1146,2021-05-22 10:00:00,2021-05-22 00:00:00,LABORABLE
22,5,2021,12,640,698,1338,2021-05-22 11:00:00,2021-05-22 00:00:00,LABORABLE
22,5,2021,13,658,691,1349,2021-05-22 12:00:00,2021-05-22 00:00:00,LABORABLE
22,5,2021,14,647,787,1434,2021-05-22 13:00:00,2021-05-22 00:00:00,LABORABLE
22,5,2021,15,659,740,1399,2021-05-22 14:00:00,2021-05-22 00:00:00,LABORABLE
22,5,2021,16,517,673,1190,2021-05-22 15:00:00,2021-05-22 00:00:00,LABORABLE
22,5,2021,17,504,622,1126,2021-05-22 16:00:00,2021-05-22 00:00:00,LABORABLE
22,5,2021,18,573,695,1268,2021-05-22 17:00:00,2021-05-22 00:00:00,LABORABLE
22,5,2021,19,554,685,1239,2021-05-22 18:00:00,2021-05-22 00:00:00,LABORABLE
22,5,2021,20,521,691,1212,2021-05-22 19:00:00,2021-05-22 00:00:00,LABORABLE
22,5,2021,21,525,703,1228,2021-05-22 20:00:00,2021-05-22 00:00:00,LABORABLE
22,5,2021,22,651,617,1268,2021-05-22 21:00:00,2021-05-22 00:00:00,LABORABLE
22,5,2021,23,507,573,1080,2021-05-22 22:00:00,2021-05-22 00:00:00,LABORABLE
22,5,2021,24,376,487,863,2021-05-22 23:00:00,2021-05-22 00:00:00,LABORABLE
23,5,2021,1,403,473,876,2021-05-23 00:00:00,2021-05-23 00:00:00,LABORABLE
23,5,2021,2,215,318,533,2021-05-23 01:00:00,2021-05-23 00:00:00,LABORABLE
23,5,2021,3,113,186,299,2021-05-23 02:00:00,2021-05-23 00:00:00,LABORABLE
23,5,2021,4,85,109,194,2021-05-23 03:00:00,2021-05-23 00:00:00,LABORABLE
23,5,2021,5,61,82,143,2021-05-23 04:00:00,2021-05-23 00:00:00,LABORABLE
23,5,2021,6,66,99,165,2021-05-23 05:00:00,2021-05-23 00:00:00,LABORABLE
23,5,2021,7,90,132,222,2021-05-23 06:00:00,2021-05-23 00:00:00,LABORABLE
23,5,2021,8,153,163,316,2021-05-23 07:00:00,2021-05-23 00:00:00,LABORABLE
23,5,2021,9,235,246,481,2021-05-23 08:00:00,2021-05-23 00:00:00,LABORABLE
23,5,2021,10,351,350,701,2021-05-23 09:00:00,2021-05-23 00:00:00,LABORABLE
23,5,2021,11,434,502,936,2021-05-23 10:00:00,2021-05-23 00:00:00,LABORABLE
23,5,2021,12,502,581,1083,2021-05-23 11:00:00,2021-05-23 00:00:00,LABORABLE
23,5,2021,13,571,644,1215,2021-05-23 12:00:00,2021-05-23 00:00:00,LABORABLE
23,5,2021,14,607,642,1249,2021-05-23 13:00:00,2021-05-23 00:00:00,LABORABLE
23,5,2021,15,540,685,1225,2021-05-23 14:00:00,2021-05-23 00:00:00,LABORABLE
23,5,2021,16,419,586,1005,2021-05-23 15:00:00,2021-05-23 00:00:00,LABORABLE
23,5,2021,17,436,559,995,2021-05-23 16:00:00,2021-05-23 00:00:00,LABORABLE
23,5,2021,18,508,701,1209,2021-05-23 17:00:00,2021-05-23 00:00:00,LABORABLE
23,5,2021,19,535,681,1216,2021-05-23 18:00:00,2021-05-23 00:00:00,LABORABLE
23,5,2021,20,482,659,1141,2021-05-23 19:00:00,2021-05-23 00:00:00,LABORABLE
23,5,2021,21,480,612,1092,2021-05-23 20:00:00,2021-05-23 00:00:00,LABORABLE
23,5,2021,22,568,557,1125,2021-05-23 21:00:00,2021-05-23 00:00:00,LABORABLE
23,5,2021,23,427,432,859,2021-05-23 22:00:00,2021-05-23 00:00:00,LABORABLE
23,5,2021,24,276,329,605,2021-05-23 23:00:00,2021-05-23 00:00:00,LABORABLE
24,5,2021,1,205,291,496,2021-05-24 00:00:00,2021-05-24 00:00:00,LABORABLE
24,5,2021,2,97,226,323,2021-05-24 01:00:00,2021-05-24 00:00:00,LABORABLE
24,5,2021,3,76,171,247,2021-05-24 02:00:00,2021-05-24 00:00:00,LABORABLE
24,5,2021,4,51,72,123,2021-05-24 03:00:00,2021-05-24 00:00:00,LABORABLE
24,5,2021,5,68,98,166,2021-05-24 04:00:00,2021-05-24 00:00:00,LABORABLE
24,5,2021,6,178,168,346,2021-05-24 05:00:00,2021-05-24 00:00:00,LABORABLE
24,5,2021,7,406,412,818,2021-05-24 06:00:00,2021-05-24 00:00:00,LABORABLE
24,5,2021,8,692,580,1272,2021-05-24 07:00:00,2021-05-24 00:00:00,LABORABLE
24,5,2021,9,661,636,1297,2021-05-24 08:00:00,2021-05-24 00:00:00,LABORABLE
24,5,2021,10,729,829,1558,2021-05-24 09:00:00,2021-05-24 00:00:00,LABORABLE
24,5,2021,11,585,625,1210,2021-05-24 10:00:00,2021-05-24 00:00:00,LABORABLE
24,5,2021,12,603,718,1321,2021-05-24 11:00:00,2021-05-24 00:00:00,LABORABLE
24,5,2021,13,579,691,1270,2021-05-24 12:00:00,2021-05-24 00:00:00,LABORABLE
24,5,2021,14,622,751,1373,2021-05-24 13:00:00,2021-05-24 00:00:00,LABORABLE
24,5,2021,15,672,705,1377,2021-05-24 14:00:00,2021-05-24 00:00:00,LABORABLE
24,5,2021,16,648,643,1291,2021-05-24 15:00:00,2021-05-24 00:00:00,LABORABLE
24,5,2021,17,497,556,1053,2021-05-24 16:00:00,2021-05-24 00:00:00,LABORABLE
24,5,2021,18,654,746,1400,2021-05-24 17:00:00,2021-05-24 00:00:00,LABORABLE
24,5,2021,19,647,809,1456,2021-05-24 18:00:00,2021-05-24 00:00:00,LABORABLE
24,5,2021,20,549,827,1376,2021-05-24 19:00:00,2021-05-24 00:00:00,LABORABLE
24,5,2021,21,611,733,1344,2021-05-24 20:00:00,2021-05-24 00:00:00,LABORABLE
24,5,2021,22,489,571,1060,2021-05-24 21:00:00,2021-05-24 00:00:00,LABORABLE
24,5,2021,23,364,449,813,2021-05-24 22:00:00,2021-05-24 00:00:00,LABORABLE
24,5,2021,24,208,397,605,2021-05-24 23:00:00,2021-05-24 00:00:00,LABORABLE
25,5,2021,1,159,285,444,2021-05-25 00:00:00,2021-05-25 00:00:00,LABORABLE
25,5,2021,2,64,205,269,2021-05-25 01:00:00,2021-05-25 00:00:00,LABORABLE
25,5,2021,3,88,137,225,2021-05-25 02:00:00,2021-05-25 00:00:00,LABORABLE
25,5,2021,4,61,112,173,2021-05-25 03:00:00,2021-05-25 00:00:00,LABORABLE
25,5,2021,5,63,97,160,2021-05-25 04:00:00,2021-05-25 00:00:00,LABORABLE
25,5,2021,6,167,114,281,2021-05-25 05:00:00,2021-05-25 00:00:00,LABORABLE
25,5,2021,7,429,328,757,2021-05-25 06:00:00,2021-05-25 00:00:00,LABORABLE
25,5,2021,8,711,627,1338,2021-05-25 07:00:00,2021-05-25 00:00:00,LABORABLE
25,5,2021,9,695,693,1388,2021-05-25 08:00:00,2021-05-25 00:00:00,LABORABLE
25,5,2021,10,715,753,1468,2021-05-25 09:00:00,2021-05-25 00:00:00,LABORABLE
25,5,2021,11,587,658,1245,2021-05-25 10:00:00,2021-05-25 00:00:00,LABORABLE
25,5,2021,12,582,651,1233,2021-05-25 11:00:00,2021-05-25 00:00:00,LABORABLE
25,5,2021,13,573,743,1316,2021-05-25 12:00:00,2021-05-25 00:00:00,LABORABLE
25,5,2021,14,631,730,1361,2021-05-25 13:00:00,2021-05-25 00:00:00,LABORABLE
25,5,2021,15,708,749,1457,2021-05-25 14:00:00,2021-05-25 00:00:00,LABORABLE
25,5,2021,16,694,643,1337,2021-05-25 15:00:00,2021-05-25 00:00:00,LABORABLE
25,5,2021,17,584,738,1322,2021-05-25 16:00:00,2021-05-25 00:00:00,LABORABLE
25,5,2021,18,680,735,1415,2021-05-25 17:00:00,2021-05-25 00:00:00,LABORABLE
25,5,2021,19,670,772,1442,2021-05-25 18:00:00,2021-05-25 00:00:00,LABORABLE
25,5,2021,20,608,791,1399,2021-05-25 19:00:00,2021-05-25 00:00:00,LABORABLE
25,5,2021,21,593,749,1342,2021-05-25 20:00:00,2021-05-25 00:00:00,LABORABLE
25,5,2021,22,536,560,1096,2021-05-25 21:00:00,2021-05-25 00:00:00,LABORABLE
25,5,2021,23,403,432,835,2021-05-25 22:00:00,2021-05-25 00:00:00,LABORABLE
25,5,2021,24,229,402,631,2021-05-25 23:00:00,2021-05-25 00:00:00,LABORABLE
26,5,2021,1,148,234,382,2021-05-26 00:00:00,2021-05-26 00:00:00,LABORABLE
26,5,2021,2,90,209,299,2021-05-26 01:00:00,2021-05-26 00:00:00,LABORABLE
26,5,2021,3,86,142,228,2021-05-26 02:00:00,2021-05-26 00:00:00,LABORABLE
26,5,2021,4,58,107,165,2021-05-26 03:00:00,2021-05-26 00:00:00,LABORABLE
26,5,2021,5,67,99,166,2021-05-26 04:00:00,2021-05-26 00:00:00,LABORABLE
26,5,2021,6,159,121,280,2021-05-26 05:00:00,2021-05-26 00:00:00,LABORABLE
26,5,2021,7,431,338,769,2021-05-26 06:00:00,2021-05-26 00:00:00,LABORABLE
26,5,2021,8,686,614,1300,2021-05-26 07:00:00,2021-05-26 00:00:00,LABORABLE
26,5,2021,9,680,675,1355,2021-05-26 08:00:00,2021-05-26 00:00:00,LABORABLE
26,5,2021,10,624,727,1351,2021-05-26 09:00:00,2021-05-26 00:00:00,LABORABLE
26,5,2021,11,584,740,1324,2021-05-26 10:00:00,2021-05-26 00:00:00,LABORABLE
26,5,2021,12,590,722,1312,2021-05-26 11:00:00,2021-05-26 00:00:00,LABORABLE
26,5,2021,13,583,767,1350,2021-05-26 12:00:00,2021-05-26 00:00:00,LABORABLE
26,5,2021,14,685,735,1420,2021-05-26 13:00:00,2021-05-26 00:00:00,LABORABLE
26,5,2021,15,637,699,1336,2021-05-26 14:00:00,2021-05-26 00:00:00,LABORABLE
26,5,2021,16,625,682,1307,2021-05-26 15:00:00,2021-05-26 00:00:00,LABORABLE
26,5,2021,17,639,716,1355,2021-05-26 16:00:00,2021-05-26 00:00:00,LABORABLE
26,5,2021,18,686,725,1411,2021-05-26 17:00:00,2021-05-26 00:00:00,LABORABLE
26,5,2021,19,681,713,1394,2021-05-26 18:00:00,2021-05-26 00:00:00,LABORABLE
26,5,2021,20,635,763,1398,2021-05-26 19:00:00,2021-05-26 00:00:00,LABORABLE
26,5,2021,21,618,734,1352,2021-05-26 20:00:00,2021-05-26 00:00:00,LABORABLE
26,5,2021,22,504,592,1096,2021-05-26 21:00:00,2021-05-26 00:00:00,LABORABLE
26,5,2021,23,404,455,859,2021-05-26 22:00:00,2021-05-26 00:00:00,LABORABLE
26,5,2021,24,279,391,670,2021-05-26 23:00:00,2021-05-26 00:00:00,LABORABLE
27,5,2021,1,193,228,421,2021-05-27 00:00:00,2021-05-27 00:00:00,LABORABLE
27,5,2021,2,111,224,335,2021-05-27 01:00:00,2021-05-27 00:00:00,LABORABLE
27,5,2021,3,85,156,241,2021-05-27 02:00:00,2021-05-27 00:00:00,LABORABLE
27,5,2021,4,60,124,184,2021-05-27 03:00:00,2021-05-27 00:00:00,LABORABLE
27,5,2021,5,62,104,166,2021-05-27 04:00:00,2021-05-27 00:00:00,LABORABLE
27,5,2021,6,163,126,289,2021-05-27 05:00:00,2021-05-27 00:00:00,LABORABLE
27,5,2021,7,417,321,738,2021-05-27 06:00:00,2021-05-27 00:00:00,LABORABLE
27,5,2021,8,691,565,1256,2021-05-27 07:00:00,2021-05-27 00:00:00,LABORABLE
27,5,2021,9,701,707,1408,2021-05-27 08:00:00,2021-05-27 00:00:00,LABORABLE
27,5,2021,10,567,691,1258,2021-05-27 09:00:00,2021-05-27 00:00:00,LABORABLE
27,5,2021,11,516,693,1209,2021-05-27 10:00:00,2021-05-27 00:00:00,LABORABLE
27,5,2021,12,601,800,1401,2021-05-27 11:00:00,2021-05-27 00:00:00,LABORABLE
27,5,2021,13,593,755,1348,2021-05-27 12:00:00,2021-05-27 00:00:00,LABORABLE
27,5,2021,14,588,802,1390,2021-05-27 13:00:00,2021-05-27 00:00:00,LABORABLE
27,5,2021,15,654,835,1489,2021-05-27 14:00:00,2021-05-27 00:00:00,LABORABLE
27,5,2021,16,642,820,1462,2021-05-27 15:00:00,2021-05-27 00:00:00,LABORABLE
27,5,2021,17,603,800,1403,2021-05-27 16:00:00,2021-05-27 00:00:00,LABORABLE
27,5,2021,18,709,878,1587,2021-05-27 17:00:00,2021-05-27 00:00:00,LABORABLE
27,5,2021,19,663,743,1406,2021-05-27 18:00:00,2021-05-27 00:00:00,LABORABLE
27,5,2021,20,646,779,1425,2021-05-27 19:00:00,2021-05-27 00:00:00,LABORABLE
27,5,2021,21,648,740,1388,2021-05-27 20:00:00,2021-05-27 00:00:00,LABORABLE
27,5,2021,22,547,628,1175,2021-05-27 21:00:00,2021-05-27 00:00:00,LABORABLE
27,5,2021,23,434,438,872,2021-05-27 22:00:00,2021-05-27 00:00:00,LABORABLE
27,5,2021,24,287,348,635,2021-05-27 23:00:00,2021-05-27 00:00:00,LABORABLE
28,5,2021,1,293,271,564,2021-05-28 00:00:00,2021-05-28 00:00:00,LABORABLE
28,5,2021,2,115,303,418,2021-05-28 01:00:00,2021-05-28 00:00:00,LABORABLE
28,5,2021,3,157,121,278,2021-05-28 02:00:00,2021-05-28 00:00:00,LABORABLE
28,5,2021,4,54,187,241,2021-05-28 03:00:00,2021-05-28 00:00:00,LABORABLE
28,5,2021,5,76,119,195,2021-05-28 04:00:00,2021-05-28 00:00:00,LABORABLE
28,5,2021,6,185,138,323,2021-05-28 05:00:00,2021-05-28 00:00:00,LABORABLE
28,5,2021,7,370,310,680,2021-05-28 06:00:00,2021-05-28 00:00:00,LABORABLE
28,5,2021,8,402,626,1028,2021-05-28 07:00:00,2021-05-28 00:00:00,LABORABLE
28,5,2021,9,672,720,1392,2021-05-28 08:00:00,2021-05-28 00:00:00,LABORABLE
28,5,2021,10,656,754,1410,2021-05-28 09:00:00,2021-05-28 00:00:00,LABORABLE
28,5,2021,11,562,726,1288,2021-05-28 10:00:00,2021-05-28 00:00:00,LABORABLE
28,5,2021,12,622,737,1359,2021-05-28 11:00:00,2021-05-28 00:00:00,LABORABLE
28,5,2021,13,607,765,1372,2021-05-28 12:00:00,2021-05-28 00:00:00,LABORABLE
28,5,2021,14,685,771,1456,2021-05-28 13:00:00,2021-05-28 00:00:00,LABORABLE
28,5,2021,15,670,814,1484,2021-05-28 14:00:00,2021-05-28 00:00:00,LABORABLE
28,5,2021,16,705,720,1425,2021-05-28 15:00:00,2021-05-28 00:00:00,LABORABLE
28,5,2021,17,660,735,1395,2021-05-28 16:00:00,2021-05-28 00:00:00,LABORABLE
28,5,2021,18,652,761,1413,2021-05-28 17:00:00,2021-05-28 00:00:00,LABORABLE
28,5,2021,19,698,773,1471,2021-05-28 18:00:00,2021-05-28 00:00:00,LABORABLE
28,5,2021,20,688,796,1484,2021-05-28 19:00:00,2021-05-28 00:00:00,LABORABLE
28,5,2021,21,625,859,1484,2021-05-28 20:00:00,2021-05-28 00:00:00,LABORABLE
28,5,2021,22,558,681,1239,2021-05-28 21:00:00,2021-05-28 00:00:00,LABORABLE
28,5,2021,23,517,592,1109,2021-05-28 22:00:00,2021-05-28 00:00:00,LABORABLE
28,5,2021,24,384,477,861,2021-05-28 23:00:00,2021-05-28 00:00:00,LABORABLE
29,5,2021,1,349,397,746,2021-05-29 00:00:00,2021-05-29 00:00:00,LABORABLE
29,5,2021,2,198,233,431,2021-05-29 01:00:00,2021-05-29 00:00:00,LABORABLE
29,5,2021,3,115,169,284,2021-05-29 02:00:00,2021-05-29 00:00:00,LABORABLE
29,5,2021,4,86,110,196,2021-05-29 03:00:00,2021-05-29 00:00:00,LABORABLE
29,5,2021,5,73,91,164,2021-05-29 04:00:00,2021-05-29 00:00:00,LABORABLE
29,5,2021,6,105,111,216,2021-05-29 05:00:00,2021-05-29 00:00:00,LABORABLE
29,5,2021,7,196,161,357,2021-05-29 06:00:00,2021-05-29 00:00:00,LABORABLE
29,5,2021,8,294,289,583,2021-05-29 07:00:00,2021-05-29 00:00:00,LABORABLE
29,5,2021,9,383,389,772,2021-05-29 08:00:00,2021-05-29 00:00:00,LABORABLE
29,5,2021,10,472,530,1002,2021-05-29 09:00:00,2021-05-29 00:00:00,LABORABLE
29,5,2021,11,638,581,1219,2021-05-29 10:00:00,2021-05-29 00:00:00,LABORABLE
29,5,2021,12,617,727,1344,2021-05-29 11:00:00,2021-05-29 00:00:00,LABORABLE
29,5,2021,13,572,798,1370,2021-05-29 12:00:00,2021-05-29 00:00:00,LABORABLE
29,5,2021,14,648,735,1383,2021-05-29 13:00:00,2021-05-29 00:00:00,LABORABLE
29,5,2021,15,673,739,1412,2021-05-29 14:00:00,2021-05-29 00:00:00,LABORABLE
29,5,2021,16,493,657,1150,2021-05-29 15:00:00,2021-05-29 00:00:00,LABORABLE
29,5,2021,17,489,853,1342,2021-05-29 16:00:00,2021-05-29 00:00:00,LABORABLE
29,5,2021,18,548,959,1507,2021-05-29 17:00:00,2021-05-29 00:00:00,LABORABLE
29,5,2021,19,582,738,1320,2021-05-29 18:00:00,2021-05-29 00:00:00,LABORABLE
29,5,2021,20,572,735,1307,2021-05-29 19:00:00,2021-05-29 00:00:00,LABORABLE
29,5,2021,21,497,742,1239,2021-05-29 20:00:00,2021-05-29 00:00:00,LABORABLE
29,5,2021,22,502,663,1165,2021-05-29 21:00:00,2021-05-29 00:00:00,LABORABLE
29,5,2021,23,489,612,1101,2021-05-29 22:00:00,2021-05-29 00:00:00,LABORABLE
29,5,2021,24,420,561,981,2021-05-29 23:00:00,2021-05-29 00:00:00,LABORABLE
30,5,2021,1,376,551,927,2021-05-30 00:00:00,2021-05-30 00:00:00,LABORABLE
30,5,2021,2,242,288,530,2021-05-30 01:00:00,2021-05-30 00:00:00,LABORABLE
30,5,2021,3,147,174,321,2021-05-30 02:00:00,2021-05-30 00:00:00,LABORABLE
30,5,2021,4,96,142,238,2021-05-30 03:00:00,2021-05-30 00:00:00,LABORABLE
30,5,2021,5,64,107,171,2021-05-30 04:00:00,2021-05-30 00:00:00,LABORABLE
30,5,2021,6,69,102,171,2021-05-30 05:00:00,2021-05-30 00:00:00,LABORABLE
30,5,2021,7,94,128,222,2021-05-30 06:00:00,2021-05-30 00:00:00,LABORABLE
30,5,2021,8,164,181,345,2021-05-30 07:00:00,2021-05-30 00:00:00,LABORABLE
30,5,2021,9,275,288,563,2021-05-30 08:00:00,2021-05-30 00:00:00,LABORABLE
30,5,2021,10,340,449,789,2021-05-30 09:00:00,2021-05-30 00:00:00,LABORABLE
30,5,2021,11,495,564,1059,2021-05-30 10:00:00,2021-05-30 00:00:00,LABORABLE
30,5,2021,12,583,676,1259,2021-05-30 11:00:00,2021-05-30 00:00:00,LABORABLE
30,5,2021,13,616,650,1266,2021-05-30 12:00:00,2021-05-30 00:00:00,LABORABLE
30,5,2021,14,580,698,1278,2021-05-30 13:00:00,2021-05-30 00:00:00,LABORABLE
30,5,2021,15,522,738,1260,2021-05-30 14:00:00,2021-05-30 00:00:00,LABORABLE
30,5,2021,16,441,628,1069,2021-05-30 15:00:00,2021-05-30 00:00:00,LABORABLE
30,5,2021,17,449,663,1112,2021-05-30 16:00:00,2021-05-30 00:00:00,LABORABLE
30,5,2021,18,467,655,1122,2021-05-30 17:00:00,2021-05-30 00:00:00,LABORABLE
30,5,2021,19,502,705,1207,2021-05-30 18:00:00,2021-05-30 00:00:00,LABORABLE
30,5,2021,20,539,687,1226,2021-05-30 19:00:00,2021-05-30 00:00:00,LABORABLE
30,5,2021,21,487,651,1138,2021-05-30 20:00:00,2021-05-30 00:00:00,LABORABLE
30,5,2021,22,481,627,1108,2021-05-30 21:00:00,2021-05-30 00:00:00,LABORABLE
30,5,2021,23,462,538,1000,2021-05-30 22:00:00,2021-05-30 00:00:00,LABORABLE
30,5,2021,24,303,456,759,2021-05-30 23:00:00,2021-05-30 00:00:00,LABORABLE
31,5,2021,1,283,359,642,2021-05-31 00:00:00,2021-05-31 00:00:00,LABORABLE
31,5,2021,2,119,169,288,2021-05-31 01:00:00,2021-05-31 00:00:00,LABORABLE
31,5,2021,3,77,137,214,2021-05-31 02:00:00,2021-05-31 00:00:00,LABORABLE
31,5,2021,4,56,73,129,2021-05-31 03:00:00,2021-05-31 00:00:00,LABORABLE
31,5,2021,5,50,102,152,2021-05-31 04:00:00,2021-05-31 00:00:00,LABORABLE
31,5,2021,6,120,144,264,2021-05-31 05:00:00,2021-05-31 00:00:00,LABORABLE
31,5,2021,7,394,354,748,2021-05-31 06:00:00,2021-05-31 00:00:00,LABORABLE
31,5,2021,8,669,625,1294,2021-05-31 07:00:00,2021-05-31 00:00:00,LABORABLE
31,5,2021,9,670,653,1323,2021-05-31 08:00:00,2021-05-31 00:00:00,LABORABLE
31,5,2021,10,620,675,1295,2021-05-31 09:00:00,2021-05-31 00:00:00,LABORABLE
31,5,2021,11,448,558,1006,2021-05-31 10:00:00,2021-05-31 00:00:00,LABORABLE
31,5,2021,12,554,801,1355,2021-05-31 11:00:00,2021-05-31 00:00:00,LABORABLE
31,5,2021,13,591,709,1300,2021-05-31 12:00:00,2021-05-31 00:00:00,LABORABLE
31,5,2021,14,630,878,1508,2021-05-31 13:00:00,2021-05-31 00:00:00,LABORABLE
31,5,2021,15,650,859,1509,2021-05-31 14:00:00,2021-05-31 00:00:00,LABORABLE
31,5,2021,16,663,590,1253,2021-05-31 15:00:00,2021-05-31 00:00:00,LABORABLE
31,5,2021,17,585,807,1392,2021-05-31 16:00:00,2021-05-31 00:00:00,LABORABLE
31,5,2021,18,502,596,1098,2021-05-31 17:00:00,2021-05-31 00:00:00,LABORABLE
31,5,2021,19,652,805,1457,2021-05-31 18:00:00,2021-05-31 00:00:00,LABORABLE
31,5,2021,20,649,794,1443,2021-05-31 19:00:00,2021-05-31 00:00:00,LABORABLE
31,5,2021,21,605,813,1418,2021-05-31 20:00:00,2021-05-31 00:00:00,LABORABLE
31,5,2021,22,540,633,1173,2021-05-31 21:00:00,2021-05-31 00:00:00,LABORABLE
31,5,2021,23,386,451,837,2021-05-31 22:00:00,2021-05-31 00:00:00,LABORABLE
31,5,2021,24,251,363,614,2021-05-31 23:00:00,2021-05-31 00:00:00,LABORABLE
1,6,2021,1,5668,194,5862,2021-06-01 00:00:00,2021-01-06 00:00:00,LABORABLE
1,6,2021,2,53,114,167,2021-06-01 01:00:00,2021-01-06 00:00:00,LABORABLE
1,6,2021,3,851,78,929,2021-06-01 02:00:00,2021-01-06 00:00:00,LABORABLE
1,6,2021,4,462,65,527,2021-06-01 03:00:00,2021-01-06 00:00:00,LABORABLE
1,6,2021,5,478,62,540,2021-06-01 04:00:00,2021-01-06 00:00:00,LABORABLE
1,6,2021,6,706,109,815,2021-06-01 05:00:00,2021-01-06 00:00:00,LABORABLE
1,6,2021,7,1602,323,1925,2021-06-01 06:00:00,2021-01-06 00:00:00,LABORABLE
1,6,2021,8,4594,612,5206,2021-06-01 07:00:00,2021-01-06 00:00:00,LABORABLE
1,6,2021,9,8932,742,9674,2021-06-01 08:00:00,2021-01-06 00:00:00,LABORABLE
1,6,2021,10,10353,772,11125,2021-06-01 09:00:00,2021-01-06 00:00:00,LABORABLE
1,6,2021,11,9390,716,10106,2021-06-01 10:00:00,2021-01-06 00:00:00,LABORABLE
1,6,2021,12,8250,731,8981,2021-06-01 11:00:00,2021-01-06 00:00:00,LABORABLE
1,6,2021,13,9209,790,9999,2021-06-01 12:00:00,2021-01-06 00:00:00,LABORABLE
1,6,2021,14,10383,873,11256,2021-06-01 13:00:00,2021-01-06 00:00:00,LABORABLE
1,6,2021,15,11032,848,11880,2021-06-01 14:00:00,2021-01-06 00:00:00,LABORABLE
1,6,2021,16,11317,750,12067,2021-06-01 15:00:00,2021-01-06 00:00:00,LABORABLE
1,6,2021,17,11061,759,11820,2021-06-01 16:00:00,2021-01-06 00:00:00,LABORABLE
1,6,2021,18,10960,766,11726,2021-06-01 17:00:00,2021-01-06 00:00:00,LABORABLE
1,6,2021,19,10948,780,11728,2021-06-01 18:00:00,2021-01-06 00:00:00,LABORABLE
1,6,2021,20,10767,835,11602,2021-06-01 19:00:00,2021-01-06 00:00:00,LABORABLE
1,6,2021,21,10564,760,11324,2021-06-01 20:00:00,2021-01-06 00:00:00,LABORABLE
1,6,2021,22,9653,598,10251,2021-06-01 21:00:00,2021-01-06 00:00:00,LABORABLE
1,6,2021,23,7676,478,8154,2021-06-01 22:00:00,2021-01-06 00:00:00,LABORABLE
1,6,2021,24,5611,306,5917,2021-06-01 23:00:00,2021-01-06 00:00:00,LABORABLE
2,6,2021,1,3034,214,3248,2021-06-02 00:00:00,2021-02-06 00:00:00,LABORABLE
2,6,2021,2,1697,140,1837,2021-06-02 01:00:00,2021-02-06 00:00:00,LABORABLE
2,6,2021,3,890,94,984,2021-06-02 02:00:00,2021-02-06 00:00:00,LABORABLE
2,6,2021,4,516,63,579,2021-06-02 03:00:00,2021-02-06 00:00:00,LABORABLE
2,6,2021,5,498,69,567,2021-06-02 04:00:00,2021-02-06 00:00:00,LABORABLE
2,6,2021,6,710,116,826,2021-06-02 05:00:00,2021-02-06 00:00:00,LABORABLE
2,6,2021,7,1652,314,1966,2021-06-02 06:00:00,2021-02-06 00:00:00,LABORABLE
2,6,2021,8,4677,621,5298,2021-06-02 07:00:00,2021-02-06 00:00:00,LABORABLE
2,6,2021,9,9409,759,10168,2021-06-02 08:00:00,2021-02-06 00:00:00,LABORABLE
2,6,2021,10,10507,783,11290,2021-06-02 09:00:00,2021-02-06 00:00:00,LABORABLE
2,6,2021,11,9706,797,10503,2021-06-02 10:00:00,2021-02-06 00:00:00,LABORABLE
2,6,2021,12,8606,750,9356,2021-06-02 11:00:00,2021-02-06 00:00:00,LABORABLE
2,6,2021,13,9430,615,10045,2021-06-02 12:00:00,2021-02-06 00:00:00,LABORABLE
2,6,2021,14,10348,827,11175,2021-06-02 13:00:00,2021-02-06 00:00:00,LABORABLE
2,6,2021,15,10914,782,11696,2021-06-02 14:00:00,2021-02-06 00:00:00,LABORABLE
2,6,2021,16,10907,743,11650,2021-06-02 15:00:00,2021-02-06 00:00:00,LABORABLE
2,6,2021,17,10980,699,11679,2021-06-02 16:00:00,2021-02-06 00:00:00,LABORABLE
2,6,2021,18,11019,721,11740,2021-06-02 17:00:00,2021-02-06 00:00:00,LABORABLE
2,6,2021,19,10915,754,11669,2021-06-02 18:00:00,2021-02-06 00:00:00,LABORABLE
2,6,2021,20,10787,768,11555,2021-06-02 19:00:00,2021-02-06 00:00:00,LABORABLE
2,6,2021,21,10593,710,11303,2021-06-02 20:00:00,2021-02-06 00:00:00,LABORABLE
2,6,2021,22,10440,636,11076,2021-06-02 21:00:00,2021-02-06 00:00:00,LABORABLE
2,6,2021,23,8091,420,8511,2021-06-02 22:00:00,2021-02-06 00:00:00,LABORABLE
2,6,2021,24,5823,311,6134,2021-06-02 23:00:00,2021-02-06 00:00:00,LABORABLE
3,6,2021,1,3603,232,3835,2021-06-03 00:00:00,2021-03-06 00:00:00,LABORABLE
3,6,2021,2,2341,182,2523,2021-06-03 01:00:00,2021-03-06 00:00:00,LABORABLE
3,6,2021,3,1223,103,1326,2021-06-03 02:00:00,2021-03-06 00:00:00,LABORABLE
3,6,2021,4,627,76,703,2021-06-03 03:00:00,2021-03-06 00:00:00,LABORABLE
3,6,2021,5,491,75,566,2021-06-03 04:00:00,2021-03-06 00:00:00,LABORABLE
3,6,2021,6,697,121,818,2021-06-03 05:00:00,2021-03-06 00:00:00,LABORABLE
3,6,2021,7,1518,335,1853,2021-06-03 06:00:00,2021-03-06 00:00:00,LABORABLE
3,6,2021,8,4528,597,5125,2021-06-03 07:00:00,2021-03-06 00:00:00,LABORABLE
3,6,2021,9,8873,733,9606,2021-06-03 08:00:00,2021-03-06 00:00:00,LABORABLE
3,6,2021,10,10849,702,11551,2021-06-03 09:00:00,2021-03-06 00:00:00,LABORABLE
3,6,2021,11,9743,685,10428,2021-06-03 10:00:00,2021-03-06 00:00:00,LABORABLE
3,6,2021,12,8936,622,9558,2021-06-03 11:00:00,2021-03-06 00:00:00,LABORABLE
3,6,2021,13,9813,124,9937,2021-06-03 12:00:00,2021-03-06 00:00:00,LABORABLE
3,6,2021,14,10787,716,11503,2021-06-03 13:00:00,2021-03-06 00:00:00,LABORABLE
3,6,2021,15,10947,631,11578,2021-06-03 14:00:00,2021-03-06 00:00:00,LABORABLE
3,6,2021,16,10890,631,11521,2021-06-03 15:00:00,2021-03-06 00:00:00,LABORABLE
3,6,2021,17,10907,749,11656,2021-06-03 16:00:00,2021-03-06 00:00:00,LABORABLE
3,6,2021,18,10989,713,11702,2021-06-03 17:00:00,2021-03-06 00:00:00,LABORABLE
3,6,2021,19,11003,775,11778,2021-06-03 18:00:00,2021-03-06 00:00:00,LABORABLE
3,6,2021,20,10852,812,11664,2021-06-03 19:00:00,2021-03-06 00:00:00,LABORABLE
3,6,2021,21,10686,710,11396,2021-06-03 20:00:00,2021-03-06 00:00:00,LABORABLE
3,6,2021,22,10438,671,11109,2021-06-03 21:00:00,2021-03-06 00:00:00,LABORABLE
3,6,2021,23,7836,543,8379,2021-06-03 22:00:00,2021-03-06 00:00:00,LABORABLE
3,6,2021,24,5994,345,6339,2021-06-03 23:00:00,2021-03-06 00:00:00,LABORABLE
4,6,2021,1,3671,270,3941,2021-06-04 00:00:00,2021-04-06 00:00:00,LABORABLE
4,6,2021,2,2627,172,2799,2021-06-04 01:00:00,2021-04-06 00:00:00,LABORABLE
4,6,2021,3,1506,123,1629,2021-06-04 02:00:00,2021-04-06 00:00:00,LABORABLE
4,6,2021,4,717,86,803,2021-06-04 03:00:00,2021-04-06 00:00:00,LABORABLE
4,6,2021,5,625,86,711,2021-06-04 04:00:00,2021-04-06 00:00:00,LABORABLE
4,6,2021,6,759,139,898,2021-06-04 05:00:00,2021-04-06 00:00:00,LABORABLE
4,6,2021,7,1611,303,1914,2021-06-04 06:00:00,2021-04-06 00:00:00,LABORABLE
4,6,2021,8,4658,601,5259,2021-06-04 07:00:00,2021-04-06 00:00:00,LABORABLE
4,6,2021,9,9209,668,9877,2021-06-04 08:00:00,2021-04-06 00:00:00,LABORABLE
4,6,2021,10,10345,699,11044,2021-06-04 09:00:00,2021-04-06 00:00:00,LABORABLE
4,6,2021,11,9551,679,10230,2021-06-04 10:00:00,2021-04-06 00:00:00,LABORABLE
4,6,2021,12,9240,759,9999,2021-06-04 11:00:00,2021-04-06 00:00:00,LABORABLE
4,6,2021,13,10175,727,10902,2021-06-04 12:00:00,2021-04-06 00:00:00,LABORABLE
4,6,2021,14,11072,739,11811,2021-06-04 13:00:00,2021-04-06 00:00:00,LABORABLE
4,6,2021,15,11061,750,11811,2021-06-04 14:00:00,2021-04-06 00:00:00,LABORABLE
4,6,2021,16,10823,732,11555,2021-06-04 15:00:00,2021-04-06 00:00:00,LABORABLE
4,6,2021,17,10902,672,11574,2021-06-04 16:00:00,2021-04-06 00:00:00,LABORABLE
4,6,2021,18,10885,768,11653,2021-06-04 17:00:00,2021-04-06 00:00:00,LABORABLE
4,6,2021,19,10923,798,11721,2021-06-04 18:00:00,2021-04-06 00:00:00,LABORABLE
4,6,2021,20,10805,847,11652,2021-06-04 19:00:00,2021-04-06 00:00:00,LABORABLE
4,6,2021,21,10724,821,11545,2021-06-04 20:00:00,2021-04-06 00:00:00,LABORABLE
4,6,2021,22,10581,700,11281,2021-06-04 21:00:00,2021-04-06 00:00:00,LABORABLE
4,6,2021,23,8941,558,9499,2021-06-04 22:00:00,2021-04-06 00:00:00,LABORABLE
4,6,2021,24,6861,449,7310,2021-06-04 23:00:00,2021-04-06 00:00:00,LABORABLE
5,6,2021,1,320,405,725,2021-06-05 00:00:00,2021-05-06 00:00:00,LABORABLE
5,6,2021,2,243,330,573,2021-06-05 01:00:00,2021-05-06 00:00:00,LABORABLE
5,6,2021,3,174,201,375,2021-06-05 02:00:00,2021-05-06 00:00:00,LABORABLE
5,6,2021,4,123,126,249,2021-06-05 03:00:00,2021-05-06 00:00:00,LABORABLE
5,6,2021,5,88,113,201,2021-06-05 04:00:00,2021-05-06 00:00:00,LABORABLE
5,6,2021,6,124,105,229,2021-06-05 05:00:00,2021-05-06 00:00:00,LABORABLE
5,6,2021,7,206,169,375,2021-06-05 06:00:00,2021-05-06 00:00:00,LABORABLE
5,6,2021,8,282,272,554,2021-06-05 07:00:00,2021-05-06 00:00:00,LABORABLE
5,6,2021,9,434,382,816,2021-06-05 08:00:00,2021-05-06 00:00:00,LABORABLE
5,6,2021,10,444,562,1006,2021-06-05 09:00:00,2021-05-06 00:00:00,LABORABLE
5,6,2021,11,549,586,1135,2021-06-05 10:00:00,2021-05-06 00:00:00,LABORABLE
5,6,2021,12,604,685,1289,2021-06-05 11:00:00,2021-05-06 00:00:00,LABORABLE
5,6,2021,13,614,742,1356,2021-06-05 12:00:00,2021-05-06 00:00:00,LABORABLE
5,6,2021,14,641,825,1466,2021-06-05 13:00:00,2021-05-06 00:00:00,LABORABLE
5,6,2021,15,648,758,1406,2021-06-05 14:00:00,2021-05-06 00:00:00,LABORABLE
5,6,2021,16,513,687,1200,2021-06-05 15:00:00,2021-05-06 00:00:00,LABORABLE
5,6,2021,17,533,693,1226,2021-06-05 16:00:00,2021-05-06 00:00:00,LABORABLE
5,6,2021,18,526,653,1179,2021-06-05 17:00:00,2021-05-06 00:00:00,LABORABLE
5,6,2021,19,619,679,1298,2021-06-05 18:00:00,2021-05-06 00:00:00,LABORABLE
5,6,2021,20,638,753,1391,2021-06-05 19:00:00,2021-05-06 00:00:00,LABORABLE
5,6,2021,21,525,721,1246,2021-06-05 20:00:00,2021-05-06 00:00:00,LABORABLE
5,6,2021,22,497,632,1129,2021-06-05 21:00:00,2021-05-06 00:00:00,LABORABLE
5,6,2021,23,488,561,1049,2021-06-05 22:00:00,2021-05-06 00:00:00,LABORABLE
5,6,2021,24,372,485,857,2021-06-05 23:00:00,2021-05-06 00:00:00,LABORABLE
6,6,2021,1,330,399,729,2021-06-06 00:00:00,2021-06-06 00:00:00,LABORABLE
6,6,2021,2,252,358,610,2021-06-06 01:00:00,2021-06-06 00:00:00,LABORABLE
6,6,2021,3,180,197,377,2021-06-06 02:00:00,2021-06-06 00:00:00,LABORABLE
6,6,2021,4,108,124,232,2021-06-06 03:00:00,2021-06-06 00:00:00,LABORABLE
6,6,2021,5,70,87,157,2021-06-06 04:00:00,2021-06-06 00:00:00,LABORABLE
6,6,2021,6,76,104,180,2021-06-06 05:00:00,2021-06-06 00:00:00,LABORABLE
6,6,2021,7,105,114,219,2021-06-06 06:00:00,2021-06-06 00:00:00,LABORABLE
6,6,2021,8,183,186,369,2021-06-06 07:00:00,2021-06-06 00:00:00,LABORABLE
6,6,2021,9,252,268,520,2021-06-06 08:00:00,2021-06-06 00:00:00,LABORABLE
6,6,2021,10,373,380,753,2021-06-06 09:00:00,2021-06-06 00:00:00,LABORABLE
6,6,2021,11,465,527,992,2021-06-06 10:00:00,2021-06-06 00:00:00,LABORABLE
6,6,2021,12,563,642,1205,2021-06-06 11:00:00,2021-06-06 00:00:00,LABORABLE
6,6,2021,13,568,668,1236,2021-06-06 12:00:00,2021-06-06 00:00:00,LABORABLE
6,6,2021,14,591,659,1250,2021-06-06 13:00:00,2021-06-06 00:00:00,LABORABLE
6,6,2021,15,579,670,1249,2021-06-06 14:00:00,2021-06-06 00:00:00,LABORABLE
6,6,2021,16,457,596,1053,2021-06-06 15:00:00,2021-06-06 00:00:00,LABORABLE
6,6,2021,17,465,630,1095,2021-06-06 16:00:00,2021-06-06 00:00:00,LABORABLE
6,6,2021,18,528,679,1207,2021-06-06 17:00:00,2021-06-06 00:00:00,LABORABLE
6,6,2021,19,511,649,1160,2021-06-06 18:00:00,2021-06-06 00:00:00,LABORABLE
6,6,2021,20,527,639,1166,2021-06-06 19:00:00,2021-06-06 00:00:00,LABORABLE
6,6,2021,21,497,658,1155,2021-06-06 20:00:00,2021-06-06 00:00:00,LABORABLE
6,6,2021,22,473,572,1045,2021-06-06 21:00:00,2021-06-06 00:00:00,LABORABLE
6,6,2021,23,455,487,942,2021-06-06 22:00:00,2021-06-06 00:00:00,LABORABLE
6,6,2021,24,348,360,708,2021-06-06 23:00:00,2021-06-06 00:00:00,LABORABLE
7,6,2021,1,4192,313,4505,2021-06-07 00:00:00,2021-07-06 00:00:00,LABORABLE
7,6,2021,2,2398,227,2625,2021-06-07 01:00:00,2021-07-06 00:00:00,LABORABLE
7,6,2021,3,1100,115,1215,2021-06-07 02:00:00,2021-07-06 00:00:00,LABORABLE
7,6,2021,4,598,86,684,2021-06-07 03:00:00,2021-07-06 00:00:00,LABORABLE
7,6,2021,5,465,61,526,2021-06-07 04:00:00,2021-07-06 00:00:00,LABORABLE
7,6,2021,6,636,124,760,2021-06-07 05:00:00,2021-07-06 00:00:00,LABORABLE
7,6,2021,7,1592,324,1916,2021-06-07 06:00:00,2021-07-06 00:00:00,LABORABLE
7,6,2021,8,4949,605,5554,2021-06-07 07:00:00,2021-07-06 00:00:00,LABORABLE
7,6,2021,9,9494,702,10196,2021-06-07 08:00:00,2021-07-06 00:00:00,LABORABLE
7,6,2021,10,10439,672,11111,2021-06-07 09:00:00,2021-07-06 00:00:00,LABORABLE
7,6,2021,11,9443,633,10076,2021-06-07 10:00:00,2021-07-06 00:00:00,LABORABLE
7,6,2021,12,8595,665,9260,2021-06-07 11:00:00,2021-07-06 00:00:00,LABORABLE
7,6,2021,13,9195,586,9781,2021-06-07 12:00:00,2021-07-06 00:00:00,LABORABLE
7,6,2021,14,10100,593,10693,2021-06-07 13:00:00,2021-07-06 00:00:00,LABORABLE
7,6,2021,15,10774,682,11456,2021-06-07 14:00:00,2021-07-06 00:00:00,LABORABLE
7,6,2021,16,10795,671,11466,2021-06-07 15:00:00,2021-07-06 00:00:00,LABORABLE
7,6,2021,17,10867,633,11500,2021-06-07 16:00:00,2021-07-06 00:00:00,LABORABLE
7,6,2021,18,10753,711,11464,2021-06-07 17:00:00,2021-07-06 00:00:00,LABORABLE
7,6,2021,19,10849,779,11628,2021-06-07 18:00:00,2021-07-06 00:00:00,LABORABLE
7,6,2021,20,10765,762,11527,2021-06-07 19:00:00,2021-07-06 00:00:00,LABORABLE
7,6,2021,21,10547,729,11276,2021-06-07 20:00:00,2021-07-06 00:00:00,LABORABLE
7,6,2021,22,9786,600,10386,2021-06-07 21:00:00,2021-07-06 00:00:00,LABORABLE
7,6,2021,23,7477,428,7905,2021-06-07 22:00:00,2021-07-06 00:00:00,LABORABLE
7,6,2021,24,5646,328,5974,2021-06-07 23:00:00,2021-07-06 00:00:00,LABORABLE
8,6,2021,1,3037,216,3253,2021-06-08 00:00:00,2021-08-06 00:00:00,LABORABLE
8,6,2021,2,1582,146,1728,2021-06-08 01:00:00,2021-08-06 00:00:00,LABORABLE
8,6,2021,3,903,92,995,2021-06-08 02:00:00,2021-08-06 00:00:00,LABORABLE
8,6,2021,4,535,52,587,2021-06-08 03:00:00,2021-08-06 00:00:00,LABORABLE
8,6,2021,5,507,81,588,2021-06-08 04:00:00,2021-08-06 00:00:00,LABORABLE
8,6,2021,6,760,119,879,2021-06-08 05:00:00,2021-08-06 00:00:00,LABORABLE
8,6,2021,7,1727,337,2064,2021-06-08 06:00:00,2021-08-06 00:00:00,LABORABLE
8,6,2021,8,4990,636,5626,2021-06-08 07:00:00,2021-08-06 00:00:00,LABORABLE
8,6,2021,9,9851,669,10520,2021-06-08 08:00:00,2021-08-06 00:00:00,LABORABLE
8,6,2021,10,10615,759,11374,2021-06-08 09:00:00,2021-08-06 00:00:00,LABORABLE
8,6,2021,11,10115,684,10799,2021-06-08 10:00:00,2021-08-06 00:00:00,LABORABLE
8,6,2021,12,9277,718,9995,2021-06-08 11:00:00,2021-08-06 00:00:00,LABORABLE
8,6,2021,13,9686,658,10344,2021-06-08 12:00:00,2021-08-06 00:00:00,LABORABLE
8,6,2021,14,10747,578,11325,2021-06-08 13:00:00,2021-08-06 00:00:00,LABORABLE
8,6,2021,15,11120,738,11858,2021-06-08 14:00:00,2021-08-06 00:00:00,LABORABLE
8,6,2021,16,10993,629,11622,2021-06-08 15:00:00,2021-08-06 00:00:00,LABORABLE
8,6,2021,17,11023,653,11676,2021-06-08 16:00:00,2021-08-06 00:00:00,LABORABLE
8,6,2021,18,10992,734,11726,2021-06-08 17:00:00,2021-08-06 00:00:00,LABORABLE
8,6,2021,19,10990,809,11799,2021-06-08 18:00:00,2021-08-06 00:00:00,LABORABLE
8,6,2021,20,10728,916,11644,2021-06-08 19:00:00,2021-08-06 00:00:00,LABORABLE
8,6,2021,21,10553,722,11275,2021-06-08 20:00:00,2021-08-06 00:00:00,LABORABLE
8,6,2021,22,10374,593,10967,2021-06-08 21:00:00,2021-08-06 00:00:00,LABORABLE
8,6,2021,23,7920,412,8332,2021-06-08 22:00:00,2021-08-06 00:00:00,LABORABLE
8,6,2021,24,6117,257,6374,2021-06-08 23:00:00,2021-08-06 00:00:00,LABORABLE
9,6,2021,1,3383,210,3593,2021-06-09 00:00:00,2021-09-06 00:00:00,LABORABLE
9,6,2021,2,1780,147,1927,2021-06-09 01:00:00,2021-09-06 00:00:00,LABORABLE
9,6,2021,3,844,101,945,2021-06-09 02:00:00,2021-09-06 00:00:00,LABORABLE
9,6,2021,4,512,60,572,2021-06-09 03:00:00,2021-09-06 00:00:00,LABORABLE
9,6,2021,5,437,76,513,2021-06-09 04:00:00,2021-09-06 00:00:00,LABORABLE
9,6,2021,6,718,155,873,2021-06-09 05:00:00,2021-09-06 00:00:00,LABORABLE
9,6,2021,7,1686,335,2021,2021-06-09 06:00:00,2021-09-06 00:00:00,LABORABLE
9,6,2021,8,5050,600,5650,2021-06-09 07:00:00,2021-09-06 00:00:00,LABORABLE
9,6,2021,9,9087,729,9816,2021-06-09 08:00:00,2021-09-06 00:00:00,LABORABLE
9,6,2021,10,10317,684,11001,2021-06-09 09:00:00,2021-09-06 00:00:00,LABORABLE
9,6,2021,11,10071,700,10771,2021-06-09 10:00:00,2021-09-06 00:00:00,LABORABLE
9,6,2021,12,9226,691,9917,2021-06-09 11:00:00,2021-09-06 00:00:00,LABORABLE
9,6,2021,13,9754,673,10427,2021-06-09 12:00:00,2021-09-06 00:00:00,LABORABLE
9,6,2021,14,10656,712,11368,2021-06-09 13:00:00,2021-09-06 00:00:00,LABORABLE
9,6,2021,15,10911,750,11661,2021-06-09 14:00:00,2021-09-06 00:00:00,LABORABLE
9,6,2021,16,10897,644,11541,2021-06-09 15:00:00,2021-09-06 00:00:00,LABORABLE
9,6,2021,17,10851,607,11458,2021-06-09 16:00:00,2021-09-06 00:00:00,LABORABLE
9,6,2021,18,10969,723,11692,2021-06-09 17:00:00,2021-09-06 00:00:00,LABORABLE
9,6,2021,19,10999,756,11755,2021-06-09 18:00:00,2021-09-06 00:00:00,LABORABLE
9,6,2021,20,10822,762,11584,2021-06-09 19:00:00,2021-09-06 00:00:00,LABORABLE
9,6,2021,21,10625,706,11331,2021-06-09 20:00:00,2021-09-06 00:00:00,LABORABLE
9,6,2021,22,10416,595,11011,2021-06-09 21:00:00,2021-09-06 00:00:00,LABORABLE
9,6,2021,23,8246,431,8677,2021-06-09 22:00:00,2021-09-06 00:00:00,LABORABLE
9,6,2021,24,6006,313,6319,2021-06-09 23:00:00,2021-09-06 00:00:00,LABORABLE
10,6,2021,1,3535,228,3763,2021-06-10 00:00:00,2021-10-06 00:00:00,LABORABLE
10,6,2021,2,2437,162,2599,2021-06-10 01:00:00,2021-10-06 00:00:00,LABORABLE
10,6,2021,3,1132,96,1228,2021-06-10 02:00:00,2021-10-06 00:00:00,LABORABLE
10,6,2021,4,589,68,657,2021-06-10 03:00:00,2021-10-06 00:00:00,LABORABLE
10,6,2021,5,535,63,598,2021-06-10 04:00:00,2021-10-06 00:00:00,LABORABLE
10,6,2021,6,730,144,874,2021-06-10 05:00:00,2021-10-06 00:00:00,LABORABLE
10,6,2021,7,1745,326,2071,2021-06-10 06:00:00,2021-10-06 00:00:00,LABORABLE
10,6,2021,8,5042,635,5677,2021-06-10 07:00:00,2021-10-06 00:00:00,LABORABLE
10,6,2021,9,9625,677,10302,2021-06-10 08:00:00,2021-10-06 00:00:00,LABORABLE
10,6,2021,10,10523,748,11271,2021-06-10 09:00:00,2021-10-06 00:00:00,LABORABLE
10,6,2021,11,9761,654,10415,2021-06-10 10:00:00,2021-10-06 00:00:00,LABORABLE
10,6,2021,12,8690,642,9332,2021-06-10 11:00:00,2021-10-06 00:00:00,LABORABLE
10,6,2021,13,10035,755,10790,2021-06-10 12:00:00,2021-10-06 00:00:00,LABORABLE
10,6,2021,14,11009,758,11767,2021-06-10 13:00:00,2021-10-06 00:00:00,LABORABLE
10,6,2021,15,10945,721,11666,2021-06-10 14:00:00,2021-10-06 00:00:00,LABORABLE
10,6,2021,16,10971,668,11639,2021-06-10 15:00:00,2021-10-06 00:00:00,LABORABLE
10,6,2021,17,11122,702,11824,2021-06-10 16:00:00,2021-10-06 00:00:00,LABORABLE
10,6,2021,18,11115,625,11740,2021-06-10 17:00:00,2021-10-06 00:00:00,LABORABLE
10,6,2021,19,11183,797,11980,2021-06-10 18:00:00,2021-10-06 00:00:00,LABORABLE
10,6,2021,20,10871,694,11565,2021-06-10 19:00:00,2021-10-06 00:00:00,LABORABLE
10,6,2021,21,10602,768,11370,2021-06-10 20:00:00,2021-10-06 00:00:00,LABORABLE
10,6,2021,22,10232,595,10827,2021-06-10 21:00:00,2021-10-06 00:00:00,LABORABLE
10,6,2021,23,8009,466,8475,2021-06-10 22:00:00,2021-10-06 00:00:00,LABORABLE
10,6,2021,24,6645,348,6993,2021-06-10 23:00:00,2021-10-06 00:00:00,LABORABLE
11,6,2021,1,4320,242,4562,2021-06-11 00:00:00,2021-11-06 00:00:00,LABORABLE
11,6,2021,2,3031,188,3219,2021-06-11 01:00:00,2021-11-06 00:00:00,LABORABLE
11,6,2021,3,1575,124,1699,2021-06-11 02:00:00,2021-11-06 00:00:00,LABORABLE
11,6,2021,4,733,72,805,2021-06-11 03:00:00,2021-11-06 00:00:00,LABORABLE
11,6,2021,5,653,79,732,2021-06-11 04:00:00,2021-11-06 00:00:00,LABORABLE
11,6,2021,6,798,138,936,2021-06-11 05:00:00,2021-11-06 00:00:00,LABORABLE
11,6,2021,7,1795,312,2107,2021-06-11 06:00:00,2021-11-06 00:00:00,LABORABLE
11,6,2021,8,4878,564,5442,2021-06-11 07:00:00,2021-11-06 00:00:00,LABORABLE
11,6,2021,9,9328,668,9996,2021-06-11 08:00:00,2021-11-06 00:00:00,LABORABLE
11,6,2021,10,10633,709,11342,2021-06-11 09:00:00,2021-11-06 00:00:00,LABORABLE
11,6,2021,11,10382,667,11049,2021-06-11 10:00:00,2021-11-06 00:00:00,LABORABLE
11,6,2021,12,9468,722,10190,2021-06-11 11:00:00,2021-11-06 00:00:00,LABORABLE
11,6,2021,13,10414,734,11148,2021-06-11 12:00:00,2021-11-06 00:00:00,LABORABLE
11,6,2021,14,11192,648,11840,2021-06-11 13:00:00,2021-11-06 00:00:00,LABORABLE
11,6,2021,15,11039,784,11823,2021-06-11 14:00:00,2021-11-06 00:00:00,LABORABLE
11,6,2021,16,10863,717,11580,2021-06-11 15:00:00,2021-11-06 00:00:00,LABORABLE
11,6,2021,17,10933,707,11640,2021-06-11 16:00:00,2021-11-06 00:00:00,LABORABLE
11,6,2021,18,10962,715,11677,2021-06-11 17:00:00,2021-11-06 00:00:00,LABORABLE
11,6,2021,19,10959,770,11729,2021-06-11 18:00:00,2021-11-06 00:00:00,LABORABLE
11,6,2021,20,10906,771,11677,2021-06-11 19:00:00,2021-11-06 00:00:00,LABORABLE
11,6,2021,21,10613,815,11428,2021-06-11 20:00:00,2021-11-06 00:00:00,LABORABLE
11,6,2021,22,10512,701,11213,2021-06-11 21:00:00,2021-11-06 00:00:00,LABORABLE
11,6,2021,23,8702,530,9232,2021-06-11 22:00:00,2021-11-06 00:00:00,LABORABLE
11,6,2021,24,6065,447,6512,2021-06-11 23:00:00,2021-11-06 00:00:00,LABORABLE
12,6,2021,1,320,370,690,2021-06-12 00:00:00,2021-12-06 00:00:00,LABORABLE
12,6,2021,2,243,329,572,2021-06-12 01:00:00,2021-12-06 00:00:00,LABORABLE
12,6,2021,3,174,215,389,2021-06-12 02:00:00,2021-12-06 00:00:00,LABORABLE
12,6,2021,4,123,140,263,2021-06-12 03:00:00,2021-12-06 00:00:00,LABORABLE
12,6,2021,5,88,84,172,2021-06-12 04:00:00,2021-12-06 00:00:00,LABORABLE
12,6,2021,6,124,118,242,2021-06-12 05:00:00,2021-12-06 00:00:00,LABORABLE
12,6,2021,7,206,167,373,2021-06-12 06:00:00,2021-12-06 00:00:00,LABORABLE
12,6,2021,8,282,321,603,2021-06-12 07:00:00,2021-12-06 00:00:00,LABORABLE
12,6,2021,9,434,412,846,2021-06-12 08:00:00,2021-12-06 00:00:00,LABORABLE
12,6,2021,10,444,476,920,2021-06-12 09:00:00,2021-12-06 00:00:00,LABORABLE
12,6,2021,11,549,575,1124,2021-06-12 10:00:00,2021-12-06 00:00:00,LABORABLE
12,6,2021,12,604,697,1301,2021-06-12 11:00:00,2021-12-06 00:00:00,LABORABLE
12,6,2021,13,658,736,1394,2021-06-12 12:00:00,2021-12-06 00:00:00,LABORABLE
12,6,2021,14,615,726,1341,2021-06-12 13:00:00,2021-12-06 00:00:00,LABORABLE
12,6,2021,15,600,734,1334,2021-06-12 14:00:00,2021-12-06 00:00:00,LABORABLE
12,6,2021,16,497,653,1150,2021-06-12 15:00:00,2021-12-06 00:00:00,LABORABLE
12,6,2021,17,454,611,1065,2021-06-12 16:00:00,2021-12-06 00:00:00,LABORABLE
12,6,2021,18,525,647,1172,2021-06-12 17:00:00,2021-12-06 00:00:00,LABORABLE
12,6,2021,19,549,705,1254,2021-06-12 18:00:00,2021-12-06 00:00:00,LABORABLE
12,6,2021,20,579,721,1300,2021-06-12 19:00:00,2021-12-06 00:00:00,LABORABLE
12,6,2021,21,468,684,1152,2021-06-12 20:00:00,2021-12-06 00:00:00,LABORABLE
12,6,2021,22,517,654,1171,2021-06-12 21:00:00,2021-12-06 00:00:00,LABORABLE
12,6,2021,23,477,632,1109,2021-06-12 22:00:00,2021-12-06 00:00:00,LABORABLE
12,6,2021,24,380,494,874,2021-06-12 23:00:00,2021-12-06 00:00:00,LABORABLE
13,6,2021,1,364,494,858,2021-06-13 00:00:00,2021-06-13 00:00:00,LABORABLE
13,6,2021,2,287,377,664,2021-06-13 01:00:00,2021-06-13 00:00:00,LABORABLE
13,6,2021,3,185,275,460,2021-06-13 02:00:00,2021-06-13 00:00:00,LABORABLE
13,6,2021,4,114,152,266,2021-06-13 03:00:00,2021-06-13 00:00:00,LABORABLE
13,6,2021,5,68,100,168,2021-06-13 04:00:00,2021-06-13 00:00:00,LABORABLE
13,6,2021,6,59,82,141,2021-06-13 05:00:00,2021-06-13 00:00:00,LABORABLE
13,6,2021,7,104,115,219,2021-06-13 06:00:00,2021-06-13 00:00:00,LABORABLE
13,6,2021,8,159,192,351,2021-06-13 07:00:00,2021-06-13 00:00:00,LABORABLE
13,6,2021,9,239,282,521,2021-06-13 08:00:00,2021-06-13 00:00:00,LABORABLE
13,6,2021,10,328,421,749,2021-06-13 09:00:00,2021-06-13 00:00:00,LABORABLE
13,6,2021,11,482,581,1063,2021-06-13 10:00:00,2021-06-13 00:00:00,LABORABLE
13,6,2021,12,530,541,1071,2021-06-13 11:00:00,2021-06-13 00:00:00,LABORABLE
13,6,2021,13,532,653,1185,2021-06-13 12:00:00,2021-06-13 00:00:00,LABORABLE
13,6,2021,14,632,644,1276,2021-06-13 13:00:00,2021-06-13 00:00:00,LABORABLE
13,6,2021,15,574,673,1247,2021-06-13 14:00:00,2021-06-13 00:00:00,LABORABLE
13,6,2021,16,444,587,1031,2021-06-13 15:00:00,2021-06-13 00:00:00,LABORABLE
13,6,2021,17,387,562,949,2021-06-13 16:00:00,2021-06-13 00:00:00,LABORABLE
13,6,2021,18,475,611,1086,2021-06-13 17:00:00,2021-06-13 00:00:00,LABORABLE
13,6,2021,19,569,630,1199,2021-06-13 18:00:00,2021-06-13 00:00:00,LABORABLE
13,6,2021,20,475,666,1141,2021-06-13 19:00:00,2021-06-13 00:00:00,LABORABLE
13,6,2021,21,490,632,1122,2021-06-13 20:00:00,2021-06-13 00:00:00,LABORABLE
13,6,2021,22,463,557,1020,2021-06-13 21:00:00,2021-06-13 00:00:00,LABORABLE
13,6,2021,23,454,498,952,2021-06-13 22:00:00,2021-06-13 00:00:00,LABORABLE
13,6,2021,24,306,352,658,2021-06-13 23:00:00,2021-06-13 00:00:00,LABORABLE
14,6,2021,1,4180,321,4501,2021-06-14 00:00:00,2021-06-14 00:00:00,LABORABLE
14,6,2021,2,2099,215,2314,2021-06-14 01:00:00,2021-06-14 00:00:00,LABORABLE
14,6,2021,3,1102,121,1223,2021-06-14 02:00:00,2021-06-14 00:00:00,LABORABLE
14,6,2021,4,638,83,721,2021-06-14 03:00:00,2021-06-14 00:00:00,LABORABLE
14,6,2021,5,481,63,544,2021-06-14 04:00:00,2021-06-14 00:00:00,LABORABLE
14,6,2021,6,638,141,779,2021-06-14 05:00:00,2021-06-14 00:00:00,LABORABLE
14,6,2021,7,1625,298,1923,2021-06-14 06:00:00,2021-06-14 00:00:00,LABORABLE
14,6,2021,8,4940,613,5553,2021-06-14 07:00:00,2021-06-14 00:00:00,LABORABLE
14,6,2021,9,9688,678,10366,2021-06-14 08:00:00,2021-06-14 00:00:00,LABORABLE
14,6,2021,10,9501,676,10177,2021-06-14 09:00:00,2021-06-14 00:00:00,LABORABLE
14,6,2021,11,9435,680,10115,2021-06-14 10:00:00,2021-06-14 00:00:00,LABORABLE
14,6,2021,12,9025,674,9699,2021-06-14 11:00:00,2021-06-14 00:00:00,LABORABLE
14,6,2021,13,9576,726,10302,2021-06-14 12:00:00,2021-06-14 00:00:00,LABORABLE
14,6,2021,14,10314,754,11068,2021-06-14 13:00:00,2021-06-14 00:00:00,LABORABLE
14,6,2021,15,10792,593,11385,2021-06-14 14:00:00,2021-06-14 00:00:00,LABORABLE
14,6,2021,16,10827,667,11494,2021-06-14 15:00:00,2021-06-14 00:00:00,LABORABLE
14,6,2021,17,10804,679,11483,2021-06-14 16:00:00,2021-06-14 00:00:00,LABORABLE
14,6,2021,18,10887,690,11577,2021-06-14 17:00:00,2021-06-14 00:00:00,LABORABLE
14,6,2021,19,10827,798,11625,2021-06-14 18:00:00,2021-06-14 00:00:00,LABORABLE
14,6,2021,20,10808,750,11558,2021-06-14 19:00:00,2021-06-14 00:00:00,LABORABLE
14,6,2021,21,10544,720,11264,2021-06-14 20:00:00,2021-06-14 00:00:00,LABORABLE
14,6,2021,22,9892,522,10414,2021-06-14 21:00:00,2021-06-14 00:00:00,LABORABLE
14,6,2021,23,7445,398,7843,2021-06-14 22:00:00,2021-06-14 00:00:00,LABORABLE
14,6,2021,24,5481,283,5764,2021-06-14 23:00:00,2021-06-14 00:00:00,LABORABLE
15,6,2021,1,3608,198,3806,2021-06-15 00:00:00,2021-06-15 00:00:00,LABORABLE
15,6,2021,2,1918,148,2066,2021-06-15 01:00:00,2021-06-15 00:00:00,LABORABLE
15,6,2021,3,928,77,1005,2021-06-15 02:00:00,2021-06-15 00:00:00,LABORABLE
15,6,2021,4,523,58,581,2021-06-15 03:00:00,2021-06-15 00:00:00,LABORABLE
15,6,2021,5,491,44,535,2021-06-15 04:00:00,2021-06-15 00:00:00,LABORABLE
15,6,2021,6,758,124,882,2021-06-15 05:00:00,2021-06-15 00:00:00,LABORABLE
15,6,2021,7,1633,362,1995,2021-06-15 06:00:00,2021-06-15 00:00:00,LABORABLE
15,6,2021,8,5064,619,5683,2021-06-15 07:00:00,2021-06-15 00:00:00,LABORABLE
15,6,2021,9,9639,664,10303,2021-06-15 08:00:00,2021-06-15 00:00:00,LABORABLE
15,6,2021,10,10084,836,10920,2021-06-15 09:00:00,2021-06-15 00:00:00,LABORABLE
15,6,2021,11,10034,661,10695,2021-06-15 10:00:00,2021-06-15 00:00:00,LABORABLE
15,6,2021,12,9122,606,9728,2021-06-15 11:00:00,2021-06-15 00:00:00,LABORABLE
15,6,2021,13,9866,736,10602,2021-06-15 12:00:00,2021-06-15 00:00:00,LABORABLE
15,6,2021,14,10485,725,11210,2021-06-15 13:00:00,2021-06-15 00:00:00,LABORABLE
15,6,2021,15,10856,753,11609,2021-06-15 14:00:00,2021-06-15 00:00:00,LABORABLE
15,6,2021,16,10839,663,11502,2021-06-15 15:00:00,2021-06-15 00:00:00,LABORABLE
15,6,2021,17,10906,710,11616,2021-06-15 16:00:00,2021-06-15 00:00:00,LABORABLE
15,6,2021,18,10874,757,11631,2021-06-15 17:00:00,2021-06-15 00:00:00,LABORABLE
15,6,2021,19,10903,824,11727,2021-06-15 18:00:00,2021-06-15 00:00:00,LABORABLE
15,6,2021,20,10786,769,11555,2021-06-15 19:00:00,2021-06-15 00:00:00,LABORABLE
15,6,2021,21,10544,702,11246,2021-06-15 20:00:00,2021-06-15 00:00:00,LABORABLE
15,6,2021,22,10321,565,10886,2021-06-15 21:00:00,2021-06-15 00:00:00,LABORABLE
15,6,2021,23,7907,423,8330,2021-06-15 22:00:00,2021-06-15 00:00:00,LABORABLE
15,6,2021,24,5964,340,6304,2021-06-15 23:00:00,2021-06-15 00:00:00,LABORABLE
16,6,2021,1,3715,213,3928,2021-06-16 00:00:00,2021-06-16 00:00:00,LABORABLE
16,6,2021,2,2260,148,2408,2021-06-16 01:00:00,2021-06-16 00:00:00,LABORABLE
16,6,2021,3,1067,104,1171,2021-06-16 02:00:00,2021-06-16 00:00:00,LABORABLE
16,6,2021,4,549,50,599,2021-06-16 03:00:00,2021-06-16 00:00:00,LABORABLE
16,6,2021,5,511,72,583,2021-06-16 04:00:00,2021-06-16 00:00:00,LABORABLE
16,6,2021,6,698,124,822,2021-06-16 05:00:00,2021-06-16 00:00:00,LABORABLE
16,6,2021,7,1703,345,2048,2021-06-16 06:00:00,2021-06-16 00:00:00,LABORABLE
16,6,2021,8,4892,608,5500,2021-06-16 07:00:00,2021-06-16 00:00:00,LABORABLE
16,6,2021,9,9667,712,10379,2021-06-16 08:00:00,2021-06-16 00:00:00,LABORABLE
16,6,2021,10,10604,682,11286,2021-06-16 09:00:00,2021-06-16 00:00:00,LABORABLE
16,6,2021,11,9707,671,10378,2021-06-16 10:00:00,2021-06-16 00:00:00,LABORABLE
16,6,2021,12,9160,686,9846,2021-06-16 11:00:00,2021-06-16 00:00:00,LABORABLE
16,6,2021,13,9890,721,10611,2021-06-16 12:00:00,2021-06-16 00:00:00,LABORABLE
16,6,2021,14,9966,766,10732,2021-06-16 13:00:00,2021-06-16 00:00:00,LABORABLE
16,6,2021,15,10886,715,11601,2021-06-16 14:00:00,2021-06-16 00:00:00,LABORABLE
16,6,2021,16,10892,656,11548,2021-06-16 15:00:00,2021-06-16 00:00:00,LABORABLE
16,6,2021,17,10861,705,11566,2021-06-16 16:00:00,2021-06-16 00:00:00,LABORABLE
16,6,2021,18,10885,736,11621,2021-06-16 17:00:00,2021-06-16 00:00:00,LABORABLE
16,6,2021,19,10916,698,11614,2021-06-16 18:00:00,2021-06-16 00:00:00,LABORABLE
16,6,2021,20,10758,780,11538,2021-06-16 19:00:00,2021-06-16 00:00:00,LABORABLE
16,6,2021,21,10696,703,11399,2021-06-16 20:00:00,2021-06-16 00:00:00,LABORABLE
16,6,2021,22,10187,607,10794,2021-06-16 21:00:00,2021-06-16 00:00:00,LABORABLE
16,6,2021,23,7250,528,7778,2021-06-16 22:00:00,2021-06-16 00:00:00,LABORABLE
16,6,2021,24,6730,366,7096,2021-06-16 23:00:00,2021-06-16 00:00:00,LABORABLE
17,6,2021,1,3897,243,4140,2021-06-17 00:00:00,2021-06-17 00:00:00,LABORABLE
17,6,2021,2,2256,175,2431,2021-06-17 01:00:00,2021-06-17 00:00:00,LABORABLE
17,6,2021,3,1179,103,1282,2021-06-17 02:00:00,2021-06-17 00:00:00,LABORABLE
17,6,2021,4,606,71,677,2021-06-17 03:00:00,2021-06-17 00:00:00,LABORABLE
17,6,2021,5,501,98,599,2021-06-17 04:00:00,2021-06-17 00:00:00,LABORABLE
17,6,2021,6,768,120,888,2021-06-17 05:00:00,2021-06-17 00:00:00,LABORABLE
17,6,2021,7,1717,342,2059,2021-06-17 06:00:00,2021-06-17 00:00:00,LABORABLE
17,6,2021,8,4888,573,5461,2021-06-17 07:00:00,2021-06-17 00:00:00,LABORABLE
17,6,2021,9,9352,648,10000,2021-06-17 08:00:00,2021-06-17 00:00:00,LABORABLE
17,6,2021,10,10274,758,11032,2021-06-17 09:00:00,2021-06-17 00:00:00,LABORABLE
17,6,2021,11,9441,665,10106,2021-06-17 10:00:00,2021-06-17 00:00:00,LABORABLE
17,6,2021,12,8760,689,9449,2021-06-17 11:00:00,2021-06-17 00:00:00,LABORABLE
17,6,2021,13,9538,581,10119,2021-06-17 12:00:00,2021-06-17 00:00:00,LABORABLE
17,6,2021,14,10004,761,10765,2021-06-17 13:00:00,2021-06-17 00:00:00,LABORABLE
17,6,2021,15,10957,718,11675,2021-06-17 14:00:00,2021-06-17 00:00:00,LABORABLE
17,6,2021,16,10840,615,11455,2021-06-17 15:00:00,2021-06-17 00:00:00,LABORABLE
17,6,2021,17,10853,686,11539,2021-06-17 16:00:00,2021-06-17 00:00:00,LABORABLE
17,6,2021,18,10984,736,11720,2021-06-17 17:00:00,2021-06-17 00:00:00,LABORABLE
17,6,2021,19,10877,779,11656,2021-06-17 18:00:00,2021-06-17 00:00:00,LABORABLE
17,6,2021,20,10855,747,11602,2021-06-17 19:00:00,2021-06-17 00:00:00,LABORABLE
17,6,2021,21,10700,698,11398,2021-06-17 20:00:00,2021-06-17 00:00:00,LABORABLE
17,6,2021,22,10467,627,11094,2021-06-17 21:00:00,2021-06-17 00:00:00,LABORABLE
17,6,2021,23,7768,472,8240,2021-06-17 22:00:00,2021-06-17 00:00:00,LABORABLE
17,6,2021,24,6118,362,6480,2021-06-17 23:00:00,2021-06-17 00:00:00,LABORABLE
18,6,2021,1,3908,261,4169,2021-06-18 00:00:00,2021-06-18 00:00:00,LABORABLE
18,6,2021,2,2785,187,2972,2021-06-18 01:00:00,2021-06-18 00:00:00,LABORABLE
18,6,2021,3,1607,96,1703,2021-06-18 02:00:00,2021-06-18 00:00:00,LABORABLE
18,6,2021,4,754,86,840,2021-06-18 03:00:00,2021-06-18 00:00:00,LABORABLE
18,6,2021,5,649,95,744,2021-06-18 04:00:00,2021-06-18 00:00:00,LABORABLE
18,6,2021,6,778,120,898,2021-06-18 05:00:00,2021-06-18 00:00:00,LABORABLE
18,6,2021,7,1603,350,1953,2021-06-18 06:00:00,2021-06-18 00:00:00,LABORABLE
18,6,2021,8,4555,586,5141,2021-06-18 07:00:00,2021-06-18 00:00:00,LABORABLE
18,6,2021,9,9127,705,9832,2021-06-18 08:00:00,2021-06-18 00:00:00,LABORABLE
18,6,2021,10,10331,715,11046,2021-06-18 09:00:00,2021-06-18 00:00:00,LABORABLE
18,6,2021,11,10097,546,10643,2021-06-18 10:00:00,2021-06-18 00:00:00,LABORABLE
18,6,2021,12,9156,714,9870,2021-06-18 11:00:00,2021-06-18 00:00:00,LABORABLE
18,6,2021,13,10023,761,10784,2021-06-18 12:00:00,2021-06-18 00:00:00,LABORABLE
18,6,2021,14,11118,733,11851,2021-06-18 13:00:00,2021-06-18 00:00:00,LABORABLE
18,6,2021,15,11017,755,11772,2021-06-18 14:00:00,2021-06-18 00:00:00,LABORABLE
18,6,2021,16,10814,670,11484,2021-06-18 15:00:00,2021-06-18 00:00:00,LABORABLE
18,6,2021,17,10830,765,11595,2021-06-18 16:00:00,2021-06-18 00:00:00,LABORABLE
18,6,2021,18,10882,758,11640,2021-06-18 17:00:00,2021-06-18 00:00:00,LABORABLE
18,6,2021,19,10890,784,11674,2021-06-18 18:00:00,2021-06-18 00:00:00,LABORABLE
18,6,2021,20,10848,752,11600,2021-06-18 19:00:00,2021-06-18 00:00:00,LABORABLE
18,6,2021,21,10733,826,11559,2021-06-18 20:00:00,2021-06-18 00:00:00,LABORABLE
18,6,2021,22,10522,737,11259,2021-06-18 21:00:00,2021-06-18 00:00:00,LABORABLE
18,6,2021,23,8824,598,9422,2021-06-18 22:00:00,2021-06-18 00:00:00,LABORABLE
18,6,2021,24,6602,490,7092,2021-06-18 23:00:00,2021-06-18 00:00:00,LABORABLE
19,6,2021,1,315,370,685,2021-06-19 00:00:00,2021-06-19 00:00:00,LABORABLE
19,6,2021,2,269,329,598,2021-06-19 01:00:00,2021-06-19 00:00:00,LABORABLE
19,6,2021,3,147,215,362,2021-06-19 02:00:00,2021-06-19 00:00:00,LABORABLE
19,6,2021,4,72,140,212,2021-06-19 03:00:00,2021-06-19 00:00:00,LABORABLE
19,6,2021,5,85,84,169,2021-06-19 04:00:00,2021-06-19 00:00:00,LABORABLE
19,6,2021,6,115,118,233,2021-06-19 05:00:00,2021-06-19 00:00:00,LABORABLE
19,6,2021,7,190,167,357,2021-06-19 06:00:00,2021-06-19 00:00:00,LABORABLE
19,6,2021,8,340,321,661,2021-06-19 07:00:00,2021-06-19 00:00:00,LABORABLE
19,6,2021,9,424,412,836,2021-06-19 08:00:00,2021-06-19 00:00:00,LABORABLE
19,6,2021,10,419,514,933,2021-06-19 09:00:00,2021-06-19 00:00:00,LABORABLE
19,6,2021,11,572,586,1158,2021-06-19 10:00:00,2021-06-19 00:00:00,LABORABLE
19,6,2021,12,609,663,1272,2021-06-19 11:00:00,2021-06-19 00:00:00,LABORABLE
19,6,2021,13,600,720,1320,2021-06-19 12:00:00,2021-06-19 00:00:00,LABORABLE
19,6,2021,14,693,718,1411,2021-06-19 13:00:00,2021-06-19 00:00:00,LABORABLE
19,6,2021,15,619,766,1385,2021-06-19 14:00:00,2021-06-19 00:00:00,LABORABLE
19,6,2021,16,570,705,1275,2021-06-19 15:00:00,2021-06-19 00:00:00,LABORABLE
19,6,2021,17,516,638,1154,2021-06-19 16:00:00,2021-06-19 00:00:00,LABORABLE
19,6,2021,18,551,675,1226,2021-06-19 17:00:00,2021-06-19 00:00:00,LABORABLE
19,6,2021,19,536,652,1188,2021-06-19 18:00:00,2021-06-19 00:00:00,LABORABLE
19,6,2021,20,594,701,1295,2021-06-19 19:00:00,2021-06-19 00:00:00,LABORABLE
19,6,2021,21,563,685,1248,2021-06-19 20:00:00,2021-06-19 00:00:00,LABORABLE
19,6,2021,22,487,621,1108,2021-06-19 21:00:00,2021-06-19 00:00:00,LABORABLE
19,6,2021,23,430,520,950,2021-06-19 22:00:00,2021-06-19 00:00:00,LABORABLE
19,6,2021,24,400,498,898,2021-06-19 23:00:00,2021-06-19 00:00:00,LABORABLE
20,6,2021,1,315,409,724,2021-06-20 00:00:00,2021-06-20 00:00:00,LABORABLE
20,6,2021,2,324,399,723,2021-06-20 01:00:00,2021-06-20 00:00:00,LABORABLE
20,6,2021,3,182,232,414,2021-06-20 02:00:00,2021-06-20 00:00:00,LABORABLE
20,6,2021,4,109,141,250,2021-06-20 03:00:00,2021-06-20 00:00:00,LABORABLE
20,6,2021,5,66,119,185,2021-06-20 04:00:00,2021-06-20 00:00:00,LABORABLE
20,6,2021,6,79,99,178,2021-06-20 05:00:00,2021-06-20 00:00:00,LABORABLE
20,6,2021,7,115,122,237,2021-06-20 06:00:00,2021-06-20 00:00:00,LABORABLE
20,6,2021,8,160,181,341,2021-06-20 07:00:00,2021-06-20 00:00:00,LABORABLE
20,6,2021,9,238,249,487,2021-06-20 08:00:00,2021-06-20 00:00:00,LABORABLE
20,6,2021,10,338,378,716,2021-06-20 09:00:00,2021-06-20 00:00:00,LABORABLE
20,6,2021,11,440,474,914,2021-06-20 10:00:00,2021-06-20 00:00:00,LABORABLE
20,6,2021,12,474,609,1083,2021-06-20 11:00:00,2021-06-20 00:00:00,LABORABLE
20,6,2021,13,564,612,1176,2021-06-20 12:00:00,2021-06-20 00:00:00,LABORABLE
20,6,2021,14,628,655,1283,2021-06-20 13:00:00,2021-06-20 00:00:00,LABORABLE
20,6,2021,15,559,658,1217,2021-06-20 14:00:00,2021-06-20 00:00:00,LABORABLE
20,6,2021,16,424,591,1015,2021-06-20 15:00:00,2021-06-20 00:00:00,LABORABLE
20,6,2021,17,427,614,1041,2021-06-20 16:00:00,2021-06-20 00:00:00,LABORABLE
20,6,2021,18,526,643,1169,2021-06-20 17:00:00,2021-06-20 00:00:00,LABORABLE
20,6,2021,19,538,665,1203,2021-06-20 18:00:00,2021-06-20 00:00:00,LABORABLE
20,6,2021,20,494,632,1126,2021-06-20 19:00:00,2021-06-20 00:00:00,LABORABLE
20,6,2021,21,551,626,1177,2021-06-20 20:00:00,2021-06-20 00:00:00,LABORABLE
20,6,2021,22,484,587,1071,2021-06-20 21:00:00,2021-06-20 00:00:00,LABORABLE
20,6,2021,23,387,440,827,2021-06-20 22:00:00,2021-06-20 00:00:00,LABORABLE
20,6,2021,24,290,348,638,2021-06-20 23:00:00,2021-06-20 00:00:00,LABORABLE
21,6,2021,1,3671,251,3922,2021-06-21 00:00:00,2021-06-21 00:00:00,LABORABLE
21,6,2021,2,2174,214,2388,2021-06-21 01:00:00,2021-06-21 00:00:00,LABORABLE
21,6,2021,3,1100,135,1235,2021-06-21 02:00:00,2021-06-21 00:00:00,LABORABLE
21,6,2021,4,596,125,721,2021-06-21 03:00:00,2021-06-21 00:00:00,LABORABLE
21,6,2021,5,525,91,616,2021-06-21 04:00:00,2021-06-21 00:00:00,LABORABLE
21,6,2021,6,665,110,775,2021-06-21 05:00:00,2021-06-21 00:00:00,LABORABLE
21,6,2021,7,1598,336,1934,2021-06-21 06:00:00,2021-06-21 00:00:00,LABORABLE
21,6,2021,8,4909,575,5484,2021-06-21 07:00:00,2021-06-21 00:00:00,LABORABLE
21,6,2021,9,9366,710,10076,2021-06-21 08:00:00,2021-06-21 00:00:00,LABORABLE
21,6,2021,10,10406,689,11095,2021-06-21 09:00:00,2021-06-21 00:00:00,LABORABLE
21,6,2021,11,9451,594,10045,2021-06-21 10:00:00,2021-06-21 00:00:00,LABORABLE
21,6,2021,12,8813,677,9490,2021-06-21 11:00:00,2021-06-21 00:00:00,LABORABLE
21,6,2021,13,9503,713,10216,2021-06-21 12:00:00,2021-06-21 00:00:00,LABORABLE
21,6,2021,14,9957,742,10699,2021-06-21 13:00:00,2021-06-21 00:00:00,LABORABLE
21,6,2021,15,10871,721,11592,2021-06-21 14:00:00,2021-06-21 00:00:00,LABORABLE
21,6,2021,16,10764,654,11418,2021-06-21 15:00:00,2021-06-21 00:00:00,LABORABLE
21,6,2021,17,10826,667,11493,2021-06-21 16:00:00,2021-06-21 00:00:00,LABORABLE
21,6,2021,18,10821,741,11562,2021-06-21 17:00:00,2021-06-21 00:00:00,LABORABLE
21,6,2021,19,10831,767,11598,2021-06-21 18:00:00,2021-06-21 00:00:00,LABORABLE
21,6,2021,20,10698,743,11441,2021-06-21 19:00:00,2021-06-21 00:00:00,LABORABLE
21,6,2021,21,10522,715,11237,2021-06-21 20:00:00,2021-06-21 00:00:00,LABORABLE
21,6,2021,22,9795,537,10332,2021-06-21 21:00:00,2021-06-21 00:00:00,LABORABLE
21,6,2021,23,7168,437,7605,2021-06-21 22:00:00,2021-06-21 00:00:00,LABORABLE
21,6,2021,24,5495,286,5781,2021-06-21 23:00:00,2021-06-21 00:00:00,LABORABLE
22,6,2021,1,3207,201,3408,2021-06-22 00:00:00,2021-06-22 00:00:00,LABORABLE
22,6,2021,2,1891,119,2010,2021-06-22 01:00:00,2021-06-22 00:00:00,LABORABLE
22,6,2021,3,827,86,913,2021-06-22 02:00:00,2021-06-22 00:00:00,LABORABLE
22,6,2021,4,538,59,597,2021-06-22 03:00:00,2021-06-22 00:00:00,LABORABLE
22,6,2021,5,542,70,612,2021-06-22 04:00:00,2021-06-22 00:00:00,LABORABLE
22,6,2021,6,765,138,903,2021-06-22 05:00:00,2021-06-22 00:00:00,LABORABLE
22,6,2021,7,1704,343,2047,2021-06-22 06:00:00,2021-06-22 00:00:00,LABORABLE
22,6,2021,8,5072,605,5677,2021-06-22 07:00:00,2021-06-22 00:00:00,LABORABLE
22,6,2021,9,9501,692,10193,2021-06-22 08:00:00,2021-06-22 00:00:00,LABORABLE
22,6,2021,10,10686,741,11427,2021-06-22 09:00:00,2021-06-22 00:00:00,LABORABLE
22,6,2021,11,10139,727,10866,2021-06-22 10:00:00,2021-06-22 00:00:00,LABORABLE
22,6,2021,12,8656,726,9382,2021-06-22 11:00:00,2021-06-22 00:00:00,LABORABLE
22,6,2021,13,9497,697,10194,2021-06-22 12:00:00,2021-06-22 00:00:00,LABORABLE
22,6,2021,14,10437,717,11154,2021-06-22 13:00:00,2021-06-22 00:00:00,LABORABLE
22,6,2021,15,10895,669,11564,2021-06-22 14:00:00,2021-06-22 00:00:00,LABORABLE
22,6,2021,16,10859,642,11501,2021-06-22 15:00:00,2021-06-22 00:00:00,LABORABLE
22,6,2021,17,10857,664,11521,2021-06-22 16:00:00,2021-06-22 00:00:00,LABORABLE
22,6,2021,18,10939,708,11647,2021-06-22 17:00:00,2021-06-22 00:00:00,LABORABLE
22,6,2021,19,10862,766,11628,2021-06-22 18:00:00,2021-06-22 00:00:00,LABORABLE
22,6,2021,20,10742,772,11514,2021-06-22 19:00:00,2021-06-22 00:00:00,LABORABLE
22,6,2021,21,10513,720,11233,2021-06-22 20:00:00,2021-06-22 00:00:00,LABORABLE
22,6,2021,22,10037,569,10606,2021-06-22 21:00:00,2021-06-22 00:00:00,LABORABLE
22,6,2021,23,7934,408,8342,2021-06-22 22:00:00,2021-06-22 00:00:00,LABORABLE
22,6,2021,24,5721,308,6029,2021-06-22 23:00:00,2021-06-22 00:00:00,LABORABLE
23,6,2021,1,3567,206,3773,2021-06-23 00:00:00,2021-06-23 00:00:00,LABORABLE
23,6,2021,2,2035,122,2157,2021-06-23 01:00:00,2021-06-23 00:00:00,LABORABLE
23,6,2021,3,928,84,1012,2021-06-23 02:00:00,2021-06-23 00:00:00,LABORABLE
23,6,2021,4,565,55,620,2021-06-23 03:00:00,2021-06-23 00:00:00,LABORABLE
23,6,2021,5,608,62,670,2021-06-23 04:00:00,2021-06-23 00:00:00,LABORABLE
23,6,2021,6,777,121,898,2021-06-23 05:00:00,2021-06-23 00:00:00,LABORABLE
23,6,2021,7,1704,357,2061,2021-06-23 06:00:00,2021-06-23 00:00:00,LABORABLE
23,6,2021,8,4894,597,5491,2021-06-23 07:00:00,2021-06-23 00:00:00,LABORABLE
23,6,2021,9,9653,677,10330,2021-06-23 08:00:00,2021-06-23 00:00:00,LABORABLE
23,6,2021,10,10640,710,11350,2021-06-23 09:00:00,2021-06-23 00:00:00,LABORABLE
23,6,2021,11,9331,560,9891,2021-06-23 10:00:00,2021-06-23 00:00:00,LABORABLE
23,6,2021,12,9085,645,9730,2021-06-23 11:00:00,2021-06-23 00:00:00,LABORABLE
23,6,2021,13,9643,748,10391,2021-06-23 12:00:00,2021-06-23 00:00:00,LABORABLE
23,6,2021,14,10375,681,11056,2021-06-23 13:00:00,2021-06-23 00:00:00,LABORABLE
23,6,2021,15,10849,682,11531,2021-06-23 14:00:00,2021-06-23 00:00:00,LABORABLE
23,6,2021,16,10839,629,11468,2021-06-23 15:00:00,2021-06-23 00:00:00,LABORABLE
23,6,2021,17,10941,679,11620,2021-06-23 16:00:00,2021-06-23 00:00:00,LABORABLE
23,6,2021,18,10903,706,11609,2021-06-23 17:00:00,2021-06-23 00:00:00,LABORABLE
23,6,2021,19,10825,723,11548,2021-06-23 18:00:00,2021-06-23 00:00:00,LABORABLE
23,6,2021,20,10747,700,11447,2021-06-23 19:00:00,2021-06-23 00:00:00,LABORABLE
23,6,2021,21,10548,733,11281,2021-06-23 20:00:00,2021-06-23 00:00:00,LABORABLE
23,6,2021,22,10328,578,10906,2021-06-23 21:00:00,2021-06-23 00:00:00,LABORABLE
23,6,2021,23,7811,434,8245,2021-06-23 22:00:00,2021-06-23 00:00:00,LABORABLE
23,6,2021,24,6283,355,6638,2021-06-23 23:00:00,2021-06-23 00:00:00,LABORABLE
24,6,2021,1,4333,222,4555,2021-06-24 00:00:00,2021-06-24 00:00:00,LABORABLE
24,6,2021,2,2522,136,2658,2021-06-24 01:00:00,2021-06-24 00:00:00,LABORABLE
24,6,2021,3,1243,104,1347,2021-06-24 02:00:00,2021-06-24 00:00:00,LABORABLE
24,6,2021,4,703,86,789,2021-06-24 03:00:00,2021-06-24 00:00:00,LABORABLE
24,6,2021,5,668,69,737,2021-06-24 04:00:00,2021-06-24 00:00:00,LABORABLE
24,6,2021,6,779,105,884,2021-06-24 05:00:00,2021-06-24 00:00:00,LABORABLE
24,6,2021,7,1744,350,2094,2021-06-24 06:00:00,2021-06-24 00:00:00,LABORABLE
24,6,2021,8,4811,598,5409,2021-06-24 07:00:00,2021-06-24 00:00:00,LABORABLE
24,6,2021,9,9361,678,10039,2021-06-24 08:00:00,2021-06-24 00:00:00,LABORABLE
24,6,2021,10,10849,663,11512,2021-06-24 09:00:00,2021-06-24 00:00:00,LABORABLE
24,6,2021,11,9603,666,10269,2021-06-24 10:00:00,2021-06-24 00:00:00,LABORABLE
24,6,2021,12,8825,594,9419,2021-06-24 11:00:00,2021-06-24 00:00:00,LABORABLE
24,6,2021,13,10033,746,10779,2021-06-24 12:00:00,2021-06-24 00:00:00,LABORABLE
24,6,2021,14,10665,790,11455,2021-06-24 13:00:00,2021-06-24 00:00:00,LABORABLE
24,6,2021,15,10896,743,11639,2021-06-24 14:00:00,2021-06-24 00:00:00,LABORABLE
24,6,2021,16,10798,608,11406,2021-06-24 15:00:00,2021-06-24 00:00:00,LABORABLE
24,6,2021,17,10913,685,11598,2021-06-24 16:00:00,2021-06-24 00:00:00,LABORABLE
24,6,2021,18,10916,723,11639,2021-06-24 17:00:00,2021-06-24 00:00:00,LABORABLE
24,6,2021,19,11003,829,11832,2021-06-24 18:00:00,2021-06-24 00:00:00,LABORABLE
24,6,2021,20,10838,807,11645,2021-06-24 19:00:00,2021-06-24 00:00:00,LABORABLE
24,6,2021,21,10723,707,11430,2021-06-24 20:00:00,2021-06-24 00:00:00,LABORABLE
24,6,2021,22,10238,653,10891,2021-06-24 21:00:00,2021-06-24 00:00:00,LABORABLE
24,6,2021,23,8143,471,8614,2021-06-24 22:00:00,2021-06-24 00:00:00,LABORABLE
24,6,2021,24,6240,381,6621,2021-06-24 23:00:00,2021-06-24 00:00:00,LABORABLE
25,6,2021,1,4446,269,4715,2021-06-25 00:00:00,2021-06-25 00:00:00,LABORABLE
25,6,2021,2,3338,195,3533,2021-06-25 01:00:00,2021-06-25 00:00:00,LABORABLE
25,6,2021,3,1740,153,1893,2021-06-25 02:00:00,2021-06-25 00:00:00,LABORABLE
25,6,2021,4,939,115,1054,2021-06-25 03:00:00,2021-06-25 00:00:00,LABORABLE
25,6,2021,5,853,110,963,2021-06-25 04:00:00,2021-06-25 00:00:00,LABORABLE
25,6,2021,6,923,110,1033,2021-06-25 05:00:00,2021-06-25 00:00:00,LABORABLE
25,6,2021,7,1769,357,2126,2021-06-25 06:00:00,2021-06-25 00:00:00,LABORABLE
25,6,2021,8,4468,586,5054,2021-06-25 07:00:00,2021-06-25 00:00:00,LABORABLE
25,6,2021,9,8894,651,9545,2021-06-25 08:00:00,2021-06-25 00:00:00,LABORABLE
25,6,2021,10,10066,653,10719,2021-06-25 09:00:00,2021-06-25 00:00:00,LABORABLE
25,6,2021,11,9019,690,9709,2021-06-25 10:00:00,2021-06-25 00:00:00,LABORABLE
25,6,2021,12,8649,699,9348,2021-06-25 11:00:00,2021-06-25 00:00:00,LABORABLE
25,6,2021,13,10404,757,11161,2021-06-25 12:00:00,2021-06-25 00:00:00,LABORABLE
25,6,2021,14,11127,717,11844,2021-06-25 13:00:00,2021-06-25 00:00:00,LABORABLE
25,6,2021,15,10933,742,11675,2021-06-25 14:00:00,2021-06-25 00:00:00,LABORABLE
25,6,2021,16,10815,659,11474,2021-06-25 15:00:00,2021-06-25 00:00:00,LABORABLE
25,6,2021,17,10901,721,11622,2021-06-25 16:00:00,2021-06-25 00:00:00,LABORABLE
25,6,2021,18,10864,721,11585,2021-06-25 17:00:00,2021-06-25 00:00:00,LABORABLE
25,6,2021,19,10799,758,11557,2021-06-25 18:00:00,2021-06-25 00:00:00,LABORABLE
25,6,2021,20,10806,843,11649,2021-06-25 19:00:00,2021-06-25 00:00:00,LABORABLE
25,6,2021,21,10711,794,11505,2021-06-25 20:00:00,2021-06-25 00:00:00,LABORABLE
25,6,2021,22,10488,730,11218,2021-06-25 21:00:00,2021-06-25 00:00:00,LABORABLE
25,6,2021,23,8750,596,9346,2021-06-25 22:00:00,2021-06-25 00:00:00,LABORABLE
25,6,2021,24,6468,438,6906,2021-06-25 23:00:00,2021-06-25 00:00:00,LABORABLE
26,6,2021,1,317,389,706,2021-06-26 00:00:00,2021-06-26 00:00:00,LABORABLE
26,6,2021,2,256,325,581,2021-06-26 01:00:00,2021-06-26 00:00:00,LABORABLE
26,6,2021,3,169,259,428,2021-06-26 02:00:00,2021-06-26 00:00:00,LABORABLE
26,6,2021,4,124,243,367,2021-06-26 03:00:00,2021-06-26 00:00:00,LABORABLE
26,6,2021,5,127,120,247,2021-06-26 04:00:00,2021-06-26 00:00:00,LABORABLE
26,6,2021,6,119,120,239,2021-06-26 05:00:00,2021-06-26 00:00:00,LABORABLE
26,6,2021,7,218,187,405,2021-06-26 06:00:00,2021-06-26 00:00:00,LABORABLE
26,6,2021,8,313,308,621,2021-06-26 07:00:00,2021-06-26 00:00:00,LABORABLE
26,6,2021,9,404,400,804,2021-06-26 08:00:00,2021-06-26 00:00:00,LABORABLE
26,6,2021,10,441,500,941,2021-06-26 09:00:00,2021-06-26 00:00:00,LABORABLE
26,6,2021,11,532,589,1121,2021-06-26 10:00:00,2021-06-26 00:00:00,LABORABLE
26,6,2021,12,635,663,1298,2021-06-26 11:00:00,2021-06-26 00:00:00,LABORABLE
26,6,2021,13,601,669,1270,2021-06-26 12:00:00,2021-06-26 00:00:00,LABORABLE
26,6,2021,14,619,705,1324,2021-06-26 13:00:00,2021-06-26 00:00:00,LABORABLE
26,6,2021,15,560,670,1230,2021-06-26 14:00:00,2021-06-26 00:00:00,LABORABLE
26,6,2021,16,480,619,1099,2021-06-26 15:00:00,2021-06-26 00:00:00,LABORABLE
26,6,2021,17,478,631,1109,2021-06-26 16:00:00,2021-06-26 00:00:00,LABORABLE
26,6,2021,18,524,661,1185,2021-06-26 17:00:00,2021-06-26 00:00:00,LABORABLE
26,6,2021,19,521,668,1189,2021-06-26 18:00:00,2021-06-26 00:00:00,LABORABLE
26,6,2021,20,558,631,1189,2021-06-26 19:00:00,2021-06-26 00:00:00,LABORABLE
26,6,2021,21,541,400,941,2021-06-26 20:00:00,2021-06-26 00:00:00,LABORABLE
26,6,2021,22,516,702,1218,2021-06-26 21:00:00,2021-06-26 00:00:00,LABORABLE
26,6,2021,23,489,558,1047,2021-06-26 22:00:00,2021-06-26 00:00:00,LABORABLE
26,6,2021,24,385,504,889,2021-06-26 23:00:00,2021-06-26 00:00:00,LABORABLE
27,6,2021,1,313,474,787,2021-06-27 00:00:00,2021-06-27 00:00:00,LABORABLE
27,6,2021,2,257,356,613,2021-06-27 01:00:00,2021-06-27 00:00:00,LABORABLE
27,6,2021,3,185,277,462,2021-06-27 02:00:00,2021-06-27 00:00:00,LABORABLE
27,6,2021,4,177,219,396,2021-06-27 03:00:00,2021-06-27 00:00:00,LABORABLE
27,6,2021,5,111,171,282,2021-06-27 04:00:00,2021-06-27 00:00:00,LABORABLE
27,6,2021,6,96,94,190,2021-06-27 05:00:00,2021-06-27 00:00:00,LABORABLE
27,6,2021,7,125,143,268,2021-06-27 06:00:00,2021-06-27 00:00:00,LABORABLE
27,6,2021,8,169,196,365,2021-06-27 07:00:00,2021-06-27 00:00:00,LABORABLE
27,6,2021,9,266,257,523,2021-06-27 08:00:00,2021-06-27 00:00:00,LABORABLE
27,6,2021,10,329,467,796,2021-06-27 09:00:00,2021-06-27 00:00:00,LABORABLE
27,6,2021,11,428,502,930,2021-06-27 10:00:00,2021-06-27 00:00:00,LABORABLE
27,6,2021,12,510,560,1070,2021-06-27 11:00:00,2021-06-27 00:00:00,LABORABLE
27,6,2021,13,557,623,1180,2021-06-27 12:00:00,2021-06-27 00:00:00,LABORABLE
27,6,2021,14,570,662,1232,2021-06-27 13:00:00,2021-06-27 00:00:00,LABORABLE
27,6,2021,15,516,626,1142,2021-06-27 14:00:00,2021-06-27 00:00:00,LABORABLE
27,6,2021,16,419,594,1013,2021-06-27 15:00:00,2021-06-27 00:00:00,LABORABLE
27,6,2021,17,411,596,1007,2021-06-27 16:00:00,2021-06-27 00:00:00,LABORABLE
27,6,2021,18,460,572,1032,2021-06-27 17:00:00,2021-06-27 00:00:00,LABORABLE
27,6,2021,19,499,591,1090,2021-06-27 18:00:00,2021-06-27 00:00:00,LABORABLE
27,6,2021,20,513,649,1162,2021-06-27 19:00:00,2021-06-27 00:00:00,LABORABLE
27,6,2021,21,478,616,1094,2021-06-27 20:00:00,2021-06-27 00:00:00,LABORABLE
27,6,2021,22,464,557,1021,2021-06-27 21:00:00,2021-06-27 00:00:00,LABORABLE
27,6,2021,23,400,510,910,2021-06-27 22:00:00,2021-06-27 00:00:00,LABORABLE
27,6,2021,24,308,367,675,2021-06-27 23:00:00,2021-06-27 00:00:00,LABORABLE
28,6,2021,1,4319,268,4587,2021-06-28 00:00:00,2021-06-28 00:00:00,LABORABLE
28,6,2021,2,2548,206,2754,2021-06-28 01:00:00,2021-06-28 00:00:00,LABORABLE
28,6,2021,3,1218,140,1358,2021-06-28 02:00:00,2021-06-28 00:00:00,LABORABLE
28,6,2021,4,676,127,803,2021-06-28 03:00:00,2021-06-28 00:00:00,LABORABLE
28,6,2021,5,679,107,786,2021-06-28 04:00:00,2021-06-28 00:00:00,LABORABLE
28,6,2021,6,701,127,828,2021-06-28 05:00:00,2021-06-28 00:00:00,LABORABLE
28,6,2021,7,1654,341,1995,2021-06-28 06:00:00,2021-06-28 00:00:00,LABORABLE
28,6,2021,8,4788,604,5392,2021-06-28 07:00:00,2021-06-28 00:00:00,LABORABLE
28,6,2021,9,9027,625,9652,2021-06-28 08:00:00,2021-06-28 00:00:00,LABORABLE
28,6,2021,10,10145,684,10829,2021-06-28 09:00:00,2021-06-28 00:00:00,LABORABLE
28,6,2021,11,8871,654,9525,2021-06-28 10:00:00,2021-06-28 00:00:00,LABORABLE
28,6,2021,12,9500,688,10188,2021-06-28 11:00:00,2021-06-28 00:00:00,LABORABLE
28,6,2021,13,9607,639,10246,2021-06-28 12:00:00,2021-06-28 00:00:00,LABORABLE
28,6,2021,14,10148,700,10848,2021-06-28 13:00:00,2021-06-28 00:00:00,LABORABLE
28,6,2021,15,10821,599,11420,2021-06-28 14:00:00,2021-06-28 00:00:00,LABORABLE
28,6,2021,16,10776,594,11370,2021-06-28 15:00:00,2021-06-28 00:00:00,LABORABLE
28,6,2021,17,10802,524,11326,2021-06-28 16:00:00,2021-06-28 00:00:00,LABORABLE
28,6,2021,18,10776,686,11462,2021-06-28 17:00:00,2021-06-28 00:00:00,LABORABLE
28,6,2021,19,10684,740,11424,2021-06-28 18:00:00,2021-06-28 00:00:00,LABORABLE
28,6,2021,20,10657,718,11375,2021-06-28 19:00:00,2021-06-28 00:00:00,LABORABLE
28,6,2021,21,9843,692,10535,2021-06-28 20:00:00,2021-06-28 00:00:00,LABORABLE
28,6,2021,22,8825,610,9435,2021-06-28 21:00:00,2021-06-28 00:00:00,LABORABLE
28,6,2021,23,7719,449,8168,2021-06-28 22:00:00,2021-06-28 00:00:00,LABORABLE
28,6,2021,24,5344,308,5652,2021-06-28 23:00:00,2021-06-28 00:00:00,LABORABLE
29,6,2021,1,3201,235,3436,2021-06-29 00:00:00,2021-06-29 00:00:00,LABORABLE
29,6,2021,2,2158,150,2308,2021-06-29 01:00:00,2021-06-29 00:00:00,LABORABLE
29,6,2021,3,977,114,1091,2021-06-29 02:00:00,2021-06-29 00:00:00,LABORABLE
29,6,2021,4,645,87,732,2021-06-29 03:00:00,2021-06-29 00:00:00,LABORABLE
29,6,2021,5,642,75,717,2021-06-29 04:00:00,2021-06-29 00:00:00,LABORABLE
29,6,2021,6,766,113,879,2021-06-29 05:00:00,2021-06-29 00:00:00,LABORABLE
29,6,2021,7,1712,323,2035,2021-06-29 06:00:00,2021-06-29 00:00:00,LABORABLE
29,6,2021,8,4848,564,5412,2021-06-29 07:00:00,2021-06-29 00:00:00,LABORABLE
29,6,2021,9,9155,634,9789,2021-06-29 08:00:00,2021-06-29 00:00:00,LABORABLE
29,6,2021,10,9960,698,10658,2021-06-29 09:00:00,2021-06-29 00:00:00,LABORABLE
29,6,2021,11,8775,606,9381,2021-06-29 10:00:00,2021-06-29 00:00:00,LABORABLE
29,6,2021,12,8395,728,9123,2021-06-29 11:00:00,2021-06-29 00:00:00,LABORABLE
29,6,2021,13,9008,651,9659,2021-06-29 12:00:00,2021-06-29 00:00:00,LABORABLE
29,6,2021,14,9617,752,10369,2021-06-29 13:00:00,2021-06-29 00:00:00,LABORABLE
29,6,2021,15,10627,656,11283,2021-06-29 14:00:00,2021-06-29 00:00:00,LABORABLE
29,6,2021,16,10804,607,11411,2021-06-29 15:00:00,2021-06-29 00:00:00,LABORABLE
29,6,2021,17,10978,655,11633,2021-06-29 16:00:00,2021-06-29 00:00:00,LABORABLE
29,6,2021,18,10951,742,11693,2021-06-29 17:00:00,2021-06-29 00:00:00,LABORABLE
29,6,2021,19,10876,740,11616,2021-06-29 18:00:00,2021-06-29 00:00:00,LABORABLE
29,6,2021,20,10783,757,11540,2021-06-29 19:00:00,2021-06-29 00:00:00,LABORABLE
29,6,2021,21,10575,699,11274,2021-06-29 20:00:00,2021-06-29 00:00:00,LABORABLE
29,6,2021,22,10236,615,10851,2021-06-29 21:00:00,2021-06-29 00:00:00,LABORABLE
29,6,2021,23,7886,450,8336,2021-06-29 22:00:00,2021-06-29 00:00:00,LABORABLE
29,6,2021,24,5816,330,6146,2021-06-29 23:00:00,2021-06-29 00:00:00,LABORABLE
30,6,2021,1,3781,267,4048,2021-06-30 00:00:00,2021-06-30 00:00:00,LABORABLE
30,6,2021,2,2530,175,2705,2021-06-30 01:00:00,2021-06-30 00:00:00,LABORABLE
30,6,2021,3,1273,112,1385,2021-06-30 02:00:00,2021-06-30 00:00:00,LABORABLE
30,6,2021,4,711,100,811,2021-06-30 03:00:00,2021-06-30 00:00:00,LABORABLE
30,6,2021,5,627,74,701,2021-06-30 04:00:00,2021-06-30 00:00:00,LABORABLE
30,6,2021,6,745,142,887,2021-06-30 05:00:00,2021-06-30 00:00:00,LABORABLE
30,6,2021,7,1709,360,2069,2021-06-30 06:00:00,2021-06-30 00:00:00,LABORABLE
30,6,2021,8,4743,616,5359,2021-06-30 07:00:00,2021-06-30 00:00:00,LABORABLE
30,6,2021,9,9106,644,9750,2021-06-30 08:00:00,2021-06-30 00:00:00,LABORABLE
30,6,2021,10,10155,665,10820,2021-06-30 09:00:00,2021-06-30 00:00:00,LABORABLE
30,6,2021,11,9328,661,9989,2021-06-30 10:00:00,2021-06-30 00:00:00,LABORABLE
30,6,2021,12,9108,717,9825,2021-06-30 11:00:00,2021-06-30 00:00:00,LABORABLE
30,6,2021,13,9775,607,10382,2021-06-30 12:00:00,2021-06-30 00:00:00,LABORABLE
30,6,2021,14,10912,738,11650,2021-06-30 13:00:00,2021-06-30 00:00:00,LABORABLE
30,6,2021,15,10873,728,11601,2021-06-30 14:00:00,2021-06-30 00:00:00,LABORABLE
30,6,2021,16,10863,624,11487,2021-06-30 15:00:00,2021-06-30 00:00:00,LABORABLE
30,6,2021,17,10914,666,11580,2021-06-30 16:00:00,2021-06-30 00:00:00,LABORABLE
30,6,2021,18,9819,685,10504,2021-06-30 17:00:00,2021-06-30 00:00:00,LABORABLE
30,6,2021,19,11003,739,11742,2021-06-30 18:00:00,2021-06-30 00:00:00,LABORABLE
30,6,2021,20,10805,824,11629,2021-06-30 19:00:00,2021-06-30 00:00:00,LABORABLE
30,6,2021,21,10262,754,11016,2021-06-30 20:00:00,2021-06-30 00:00:00,LABORABLE
30,6,2021,22,10415,620,11035,2021-06-30 21:00:00,2021-06-30 00:00:00,LABORABLE
30,6,2021,23,8747,513,9260,2021-06-30 22:00:00,2021-06-30 00:00:00,LABORABLE
30,6,2021,24,6143,383,6526,2021-06-30 23:00:00,2021-06-30 00:00:00,LABORABLE
1,7,2021,1,209,286,495,2021-07-01 00:00:00,2021-01-07 00:00:00,LABORABLE
1,7,2021,2,100,151,251,2021-07-01 01:00:00,2021-01-07 00:00:00,LABORABLE
1,7,2021,3,50,48,98,2021-07-01 02:00:00,2021-01-07 00:00:00,LABORABLE
1,7,2021,4,93,112,205,2021-07-01 03:00:00,2021-01-07 00:00:00,LABORABLE
1,7,2021,5,91,78,169,2021-07-01 04:00:00,2021-01-07 00:00:00,LABORABLE
1,7,2021,6,168,135,303,2021-07-01 05:00:00,2021-01-07 00:00:00,LABORABLE
1,7,2021,7,426,350,776,2021-07-01 06:00:00,2021-01-07 00:00:00,LABORABLE
1,7,2021,8,677,587,1264,2021-07-01 07:00:00,2021-01-07 00:00:00,LABORABLE
1,7,2021,9,576,655,1231,2021-07-01 08:00:00,2021-01-07 00:00:00,LABORABLE
1,7,2021,10,594,685,1279,2021-07-01 09:00:00,2021-01-07 00:00:00,LABORABLE
1,7,2021,11,571,738,1309,2021-07-01 10:00:00,2021-01-07 00:00:00,LABORABLE
1,7,2021,12,622,724,1346,2021-07-01 11:00:00,2021-01-07 00:00:00,LABORABLE
1,7,2021,13,567,698,1265,2021-07-01 12:00:00,2021-01-07 00:00:00,LABORABLE
1,7,2021,14,629,764,1393,2021-07-01 13:00:00,2021-01-07 00:00:00,LABORABLE
1,7,2021,15,618,735,1353,2021-07-01 14:00:00,2021-01-07 00:00:00,LABORABLE
1,7,2021,16,618,677,1295,2021-07-01 15:00:00,2021-01-07 00:00:00,LABORABLE
1,7,2021,17,598,682,1280,2021-07-01 16:00:00,2021-01-07 00:00:00,LABORABLE
1,7,2021,18,676,763,1439,2021-07-01 17:00:00,2021-01-07 00:00:00,LABORABLE
1,7,2021,19,677,821,1498,2021-07-01 18:00:00,2021-01-07 00:00:00,LABORABLE
1,7,2021,20,704,759,1463,2021-07-01 19:00:00,2021-01-07 00:00:00,LABORABLE
1,7,2021,21,665,785,1450,2021-07-01 20:00:00,2021-01-07 00:00:00,LABORABLE
1,7,2021,22,570,660,1230,2021-07-01 21:00:00,2021-01-07 00:00:00,LABORABLE
1,7,2021,23,479,501,980,2021-07-01 22:00:00,2021-01-07 00:00:00,LABORABLE
1,7,2021,24,318,396,714,2021-07-01 23:00:00,2021-01-07 00:00:00,LABORABLE
2,7,2021,1,227,321,548,2021-07-02 00:00:00,2021-02-07 00:00:00,LABORABLE
2,7,2021,2,141,225,366,2021-07-02 01:00:00,2021-02-07 00:00:00,LABORABLE
2,7,2021,3,96,153,249,2021-07-02 02:00:00,2021-02-07 00:00:00,LABORABLE
2,7,2021,4,72,131,203,2021-07-02 03:00:00,2021-02-07 00:00:00,LABORABLE
2,7,2021,5,91,99,190,2021-07-02 04:00:00,2021-02-07 00:00:00,LABORABLE
2,7,2021,6,176,144,320,2021-07-02 05:00:00,2021-02-07 00:00:00,LABORABLE
2,7,2021,7,431,342,773,2021-07-02 06:00:00,2021-02-07 00:00:00,LABORABLE
2,7,2021,8,649,553,1202,2021-07-02 07:00:00,2021-02-07 00:00:00,LABORABLE
2,7,2021,9,561,614,1175,2021-07-02 08:00:00,2021-02-07 00:00:00,LABORABLE
2,7,2021,10,585,670,1255,2021-07-02 09:00:00,2021-02-07 00:00:00,LABORABLE
2,7,2021,11,557,652,1209,2021-07-02 10:00:00,2021-02-07 00:00:00,LABORABLE
2,7,2021,12,599,671,1270,2021-07-02 11:00:00,2021-02-07 00:00:00,LABORABLE
2,7,2021,13,645,730,1375,2021-07-02 12:00:00,2021-02-07 00:00:00,LABORABLE
2,7,2021,14,661,764,1425,2021-07-02 13:00:00,2021-02-07 00:00:00,LABORABLE
2,7,2021,15,676,740,1416,2021-07-02 14:00:00,2021-02-07 00:00:00,LABORABLE
2,7,2021,16,641,689,1330,2021-07-02 15:00:00,2021-02-07 00:00:00,LABORABLE
2,7,2021,17,656,741,1397,2021-07-02 16:00:00,2021-02-07 00:00:00,LABORABLE
2,7,2021,18,628,758,1386,2021-07-02 17:00:00,2021-02-07 00:00:00,LABORABLE
2,7,2021,19,628,720,1348,2021-07-02 18:00:00,2021-02-07 00:00:00,LABORABLE
2,7,2021,20,596,742,1338,2021-07-02 19:00:00,2021-02-07 00:00:00,LABORABLE
2,7,2021,21,565,722,1287,2021-07-02 20:00:00,2021-02-07 00:00:00,LABORABLE
2,7,2021,22,620,683,1303,2021-07-02 21:00:00,2021-02-07 00:00:00,LABORABLE
2,7,2021,23,456,587,1043,2021-07-02 22:00:00,2021-02-07 00:00:00,LABORABLE
2,7,2021,24,375,523,898,2021-07-02 23:00:00,2021-02-07 00:00:00,LABORABLE
3,7,2021,1,300,356,656,2021-07-03 00:00:00,2021-03-07 00:00:00,LABORABLE
3,7,2021,2,244,336,580,2021-07-03 01:00:00,2021-03-07 00:00:00,LABORABLE
3,7,2021,3,165,247,412,2021-07-03 02:00:00,2021-03-07 00:00:00,LABORABLE
3,7,2021,4,159,227,386,2021-07-03 03:00:00,2021-03-07 00:00:00,LABORABLE
3,7,2021,5,116,179,295,2021-07-03 04:00:00,2021-03-07 00:00:00,LABORABLE
3,7,2021,6,135,139,274,2021-07-03 05:00:00,2021-03-07 00:00:00,LABORABLE
3,7,2021,7,190,197,387,2021-07-03 06:00:00,2021-03-07 00:00:00,LABORABLE
3,7,2021,8,309,280,589,2021-07-03 07:00:00,2021-03-07 00:00:00,LABORABLE
3,7,2021,9,374,421,795,2021-07-03 08:00:00,2021-03-07 00:00:00,LABORABLE
3,7,2021,10,429,501,930,2021-07-03 09:00:00,2021-03-07 00:00:00,LABORABLE
3,7,2021,11,541,568,1109,2021-07-03 10:00:00,2021-03-07 00:00:00,LABORABLE
3,7,2021,12,598,692,1290,2021-07-03 11:00:00,2021-03-07 00:00:00,LABORABLE
3,7,2021,13,618,779,1397,2021-07-03 12:00:00,2021-03-07 00:00:00,LABORABLE
3,7,2021,14,647,753,1400,2021-07-03 13:00:00,2021-03-07 00:00:00,LABORABLE
3,7,2021,15,561,748,1309,2021-07-03 14:00:00,2021-03-07 00:00:00,LABORABLE
3,7,2021,16,501,616,1117,2021-07-03 15:00:00,2021-03-07 00:00:00,LABORABLE
3,7,2021,17,493,640,1133,2021-07-03 16:00:00,2021-03-07 00:00:00,LABORABLE
3,7,2021,18,563,674,1237,2021-07-03 17:00:00,2021-03-07 00:00:00,LABORABLE
3,7,2021,19,555,670,1225,2021-07-03 18:00:00,2021-03-07 00:00:00,LABORABLE
3,7,2021,20,575,698,1273,2021-07-03 19:00:00,2021-03-07 00:00:00,LABORABLE
3,7,2021,21,550,690,1240,2021-07-03 20:00:00,2021-03-07 00:00:00,LABORABLE
3,7,2021,22,517,663,1180,2021-07-03 21:00:00,2021-03-07 00:00:00,LABORABLE
3,7,2021,23,470,600,1070,2021-07-03 22:00:00,2021-03-07 00:00:00,LABORABLE
3,7,2021,24,380,491,871,2021-07-03 23:00:00,2021-03-07 00:00:00,LABORABLE
4,7,2021,1,336,456,792,2021-07-04 00:00:00,2021-04-07 00:00:00,LABORABLE
4,7,2021,2,294,405,699,2021-07-04 01:00:00,2021-04-07 00:00:00,LABORABLE
4,7,2021,3,206,335,541,2021-07-04 02:00:00,2021-04-07 00:00:00,LABORABLE
4,7,2021,4,189,266,455,2021-07-04 03:00:00,2021-04-07 00:00:00,LABORABLE
4,7,2021,5,123,213,336,2021-07-04 04:00:00,2021-04-07 00:00:00,LABORABLE
4,7,2021,6,102,167,269,2021-07-04 05:00:00,2021-04-07 00:00:00,LABORABLE
4,7,2021,7,103,150,253,2021-07-04 06:00:00,2021-04-07 00:00:00,LABORABLE
4,7,2021,8,169,191,360,2021-07-04 07:00:00,2021-04-07 00:00:00,LABORABLE
4,7,2021,9,232,258,490,2021-07-04 08:00:00,2021-04-07 00:00:00,LABORABLE
4,7,2021,10,347,418,765,2021-07-04 09:00:00,2021-04-07 00:00:00,LABORABLE
4,7,2021,11,419,480,899,2021-07-04 10:00:00,2021-04-07 00:00:00,LABORABLE
4,7,2021,12,481,543,1024,2021-07-04 11:00:00,2021-04-07 00:00:00,LABORABLE
4,7,2021,13,518,609,1127,2021-07-04 12:00:00,2021-04-07 00:00:00,LABORABLE
4,7,2021,14,492,609,1101,2021-07-04 13:00:00,2021-04-07 00:00:00,LABORABLE
4,7,2021,15,522,676,1198,2021-07-04 14:00:00,2021-04-07 00:00:00,LABORABLE
4,7,2021,16,431,571,1002,2021-07-04 15:00:00,2021-04-07 00:00:00,LABORABLE
4,7,2021,17,427,570,997,2021-07-04 16:00:00,2021-04-07 00:00:00,LABORABLE
4,7,2021,18,417,591,1008,2021-07-04 17:00:00,2021-04-07 00:00:00,LABORABLE
4,7,2021,19,528,614,1142,2021-07-04 18:00:00,2021-04-07 00:00:00,LABORABLE
4,7,2021,20,455,639,1094,2021-07-04 19:00:00,2021-04-07 00:00:00,LABORABLE
4,7,2021,21,503,613,1116,2021-07-04 20:00:00,2021-04-07 00:00:00,LABORABLE
4,7,2021,22,459,578,1037,2021-07-04 21:00:00,2021-04-07 00:00:00,LABORABLE
4,7,2021,23,456,515,971,2021-07-04 22:00:00,2021-04-07 00:00:00,LABORABLE
4,7,2021,24,330,389,719,2021-07-04 23:00:00,2021-04-07 00:00:00,LABORABLE
5,7,2021,1,244,349,593,2021-07-05 00:00:00,2021-05-07 00:00:00,LABORABLE
5,7,2021,2,143,241,384,2021-07-05 01:00:00,2021-05-07 00:00:00,LABORABLE
5,7,2021,3,123,156,279,2021-07-05 02:00:00,2021-05-07 00:00:00,LABORABLE
5,7,2021,4,102,139,241,2021-07-05 03:00:00,2021-05-07 00:00:00,LABORABLE
5,7,2021,5,100,100,200,2021-07-05 04:00:00,2021-05-07 00:00:00,LABORABLE
5,7,2021,6,184,145,329,2021-07-05 05:00:00,2021-05-07 00:00:00,LABORABLE
5,7,2021,7,434,353,787,2021-07-05 06:00:00,2021-05-07 00:00:00,LABORABLE
5,7,2021,8,218,589,807,2021-07-05 07:00:00,2021-05-07 00:00:00,LABORABLE
5,7,2021,9,8,616,624,2021-07-05 08:00:00,2021-05-07 00:00:00,LABORABLE
5,7,2021,10,548,690,1238,2021-07-05 09:00:00,2021-05-07 00:00:00,LABORABLE
5,7,2021,11,587,633,1220,2021-07-05 10:00:00,2021-05-07 00:00:00,LABORABLE
5,7,2021,12,587,645,1232,2021-07-05 11:00:00,2021-05-07 00:00:00,LABORABLE
5,7,2021,13,613,709,1322,2021-07-05 12:00:00,2021-05-07 00:00:00,LABORABLE
5,7,2021,14,618,690,1308,2021-07-05 13:00:00,2021-05-07 00:00:00,LABORABLE
5,7,2021,15,627,676,1303,2021-07-05 14:00:00,2021-05-07 00:00:00,LABORABLE
5,7,2021,16,612,653,1265,2021-07-05 15:00:00,2021-05-07 00:00:00,LABORABLE
5,7,2021,17,580,671,1251,2021-07-05 16:00:00,2021-05-07 00:00:00,LABORABLE
5,7,2021,18,578,704,1282,2021-07-05 17:00:00,2021-05-07 00:00:00,LABORABLE
5,7,2021,19,657,797,1454,2021-07-05 18:00:00,2021-05-07 00:00:00,LABORABLE
5,7,2021,20,608,792,1400,2021-07-05 19:00:00,2021-05-07 00:00:00,LABORABLE
5,7,2021,21,559,730,1289,2021-07-05 20:00:00,2021-05-07 00:00:00,LABORABLE
5,7,2021,22,500,587,1087,2021-07-05 21:00:00,2021-05-07 00:00:00,LABORABLE
5,7,2021,23,431,446,877,2021-07-05 22:00:00,2021-05-07 00:00:00,LABORABLE
5,7,2021,24,264,309,573,2021-07-05 23:00:00,2021-05-07 00:00:00,LABORABLE
6,7,2021,1,171,205,376,2021-07-06 00:00:00,2021-06-07 00:00:00,LABORABLE
6,7,2021,2,97,174,271,2021-07-06 01:00:00,2021-06-07 00:00:00,LABORABLE
6,7,2021,3,82,106,188,2021-07-06 02:00:00,2021-06-07 00:00:00,LABORABLE
6,7,2021,4,93,118,211,2021-07-06 03:00:00,2021-06-07 00:00:00,LABORABLE
6,7,2021,5,78,85,163,2021-07-06 04:00:00,2021-06-07 00:00:00,LABORABLE
6,7,2021,6,166,125,291,2021-07-06 05:00:00,2021-06-07 00:00:00,LABORABLE
6,7,2021,7,400,345,745,2021-07-06 06:00:00,2021-06-07 00:00:00,LABORABLE
6,7,2021,8,636,571,1207,2021-07-06 07:00:00,2021-06-07 00:00:00,LABORABLE
6,7,2021,9,584,684,1268,2021-07-06 08:00:00,2021-06-07 00:00:00,LABORABLE
6,7,2021,10,567,672,1239,2021-07-06 09:00:00,2021-06-07 00:00:00,LABORABLE
6,7,2021,11,555,643,1198,2021-07-06 10:00:00,2021-06-07 00:00:00,LABORABLE
6,7,2021,12,457,600,1057,2021-07-06 11:00:00,2021-06-07 00:00:00,LABORABLE
6,7,2021,13,594,719,1313,2021-07-06 12:00:00,2021-06-07 00:00:00,LABORABLE
6,7,2021,14,600,686,1286,2021-07-06 13:00:00,2021-06-07 00:00:00,LABORABLE
6,7,2021,15,636,710,1346,2021-07-06 14:00:00,2021-06-07 00:00:00,LABORABLE
6,7,2021,16,580,634,1214,2021-07-06 15:00:00,2021-06-07 00:00:00,LABORABLE
6,7,2021,17,575,632,1207,2021-07-06 16:00:00,2021-06-07 00:00:00,LABORABLE
6,7,2021,18,600,688,1288,2021-07-06 17:00:00,2021-06-07 00:00:00,LABORABLE
6,7,2021,19,629,785,1414,2021-07-06 18:00:00,2021-06-07 00:00:00,LABORABLE
6,7,2021,20,636,760,1396,2021-07-06 19:00:00,2021-06-07 00:00:00,LABORABLE
6,7,2021,21,622,718,1340,2021-07-06 20:00:00,2021-06-07 00:00:00,LABORABLE
6,7,2021,22,418,510,928,2021-07-06 21:00:00,2021-06-07 00:00:00,LABORABLE
6,7,2021,23,336,352,688,2021-07-06 22:00:00,2021-06-07 00:00:00,LABORABLE
6,7,2021,24,196,279,475,2021-07-06 23:00:00,2021-06-07 00:00:00,LABORABLE
7,7,2021,1,239,265,504,2021-07-07 00:00:00,2021-07-07 00:00:00,LABORABLE
7,7,2021,2,113,181,294,2021-07-07 01:00:00,2021-07-07 00:00:00,LABORABLE
7,7,2021,3,73,109,182,2021-07-07 02:00:00,2021-07-07 00:00:00,LABORABLE
7,7,2021,4,66,73,139,2021-07-07 03:00:00,2021-07-07 00:00:00,LABORABLE
7,7,2021,5,93,69,162,2021-07-07 04:00:00,2021-07-07 00:00:00,LABORABLE
7,7,2021,6,160,134,294,2021-07-07 05:00:00,2021-07-07 00:00:00,LABORABLE
7,7,2021,7,411,332,743,2021-07-07 06:00:00,2021-07-07 00:00:00,LABORABLE
7,7,2021,8,656,581,1237,2021-07-07 07:00:00,2021-07-07 00:00:00,LABORABLE
7,7,2021,9,594,613,1207,2021-07-07 08:00:00,2021-07-07 00:00:00,LABORABLE
7,7,2021,10,569,648,1217,2021-07-07 09:00:00,2021-07-07 00:00:00,LABORABLE
7,7,2021,11,557,572,1129,2021-07-07 10:00:00,2021-07-07 00:00:00,LABORABLE
7,7,2021,12,552,743,1295,2021-07-07 11:00:00,2021-07-07 00:00:00,LABORABLE
7,7,2021,13,468,653,1121,2021-07-07 12:00:00,2021-07-07 00:00:00,LABORABLE
7,7,2021,14,617,716,1333,2021-07-07 13:00:00,2021-07-07 00:00:00,LABORABLE
7,7,2021,15,611,690,1301,2021-07-07 14:00:00,2021-07-07 00:00:00,LABORABLE
7,7,2021,16,582,669,1251,2021-07-07 15:00:00,2021-07-07 00:00:00,LABORABLE
7,7,2021,17,569,702,1271,2021-07-07 16:00:00,2021-07-07 00:00:00,LABORABLE
7,7,2021,18,619,757,1376,2021-07-07 17:00:00,2021-07-07 00:00:00,LABORABLE
7,7,2021,19,693,755,1448,2021-07-07 18:00:00,2021-07-07 00:00:00,LABORABLE
7,7,2021,20,631,768,1399,2021-07-07 19:00:00,2021-07-07 00:00:00,LABORABLE
7,7,2021,21,602,689,1291,2021-07-07 20:00:00,2021-07-07 00:00:00,LABORABLE
7,7,2021,22,563,633,1196,2021-07-07 21:00:00,2021-07-07 00:00:00,LABORABLE
7,7,2021,23,435,442,877,2021-07-07 22:00:00,2021-07-07 00:00:00,LABORABLE
7,7,2021,24,262,337,599,2021-07-07 23:00:00,2021-07-07 00:00:00,LABORABLE
8,7,2021,1,183,259,442,2021-07-08 00:00:00,2021-08-07 00:00:00,LABORABLE
8,7,2021,2,101,193,294,2021-07-08 01:00:00,2021-08-07 00:00:00,LABORABLE
8,7,2021,3,90,112,202,2021-07-08 02:00:00,2021-08-07 00:00:00,LABORABLE
8,7,2021,4,61,112,173,2021-07-08 03:00:00,2021-08-07 00:00:00,LABORABLE
8,7,2021,5,71,87,158,2021-07-08 04:00:00,2021-08-07 00:00:00,LABORABLE
8,7,2021,6,172,136,308,2021-07-08 05:00:00,2021-08-07 00:00:00,LABORABLE
8,7,2021,7,441,349,790,2021-07-08 06:00:00,2021-08-07 00:00:00,LABORABLE
8,7,2021,8,644,595,1239,2021-07-08 07:00:00,2021-08-07 00:00:00,LABORABLE
8,7,2021,9,583,728,1311,2021-07-08 08:00:00,2021-08-07 00:00:00,LABORABLE
8,7,2021,10,584,665,1249,2021-07-08 09:00:00,2021-08-07 00:00:00,LABORABLE
8,7,2021,11,613,623,1236,2021-07-08 10:00:00,2021-08-07 00:00:00,LABORABLE
8,7,2021,12,581,725,1306,2021-07-08 11:00:00,2021-08-07 00:00:00,LABORABLE
8,7,2021,13,614,698,1312,2021-07-08 12:00:00,2021-08-07 00:00:00,LABORABLE
8,7,2021,14,626,712,1338,2021-07-08 13:00:00,2021-08-07 00:00:00,LABORABLE
8,7,2021,15,630,714,1344,2021-07-08 14:00:00,2021-08-07 00:00:00,LABORABLE
8,7,2021,16,579,667,1246,2021-07-08 15:00:00,2021-08-07 00:00:00,LABORABLE
8,7,2021,17,578,675,1253,2021-07-08 16:00:00,2021-08-07 00:00:00,LABORABLE
8,7,2021,18,677,739,1416,2021-07-08 17:00:00,2021-08-07 00:00:00,LABORABLE
8,7,2021,19,702,791,1493,2021-07-08 18:00:00,2021-08-07 00:00:00,LABORABLE
8,7,2021,20,699,837,1536,2021-07-08 19:00:00,2021-08-07 00:00:00,LABORABLE
8,7,2021,21,642,729,1371,2021-07-08 20:00:00,2021-08-07 00:00:00,LABORABLE
8,7,2021,22,512,657,1169,2021-07-08 21:00:00,2021-08-07 00:00:00,LABORABLE
8,7,2021,23,462,513,975,2021-07-08 22:00:00,2021-08-07 00:00:00,LABORABLE
8,7,2021,24,421,386,807,2021-07-08 23:00:00,2021-08-07 00:00:00,LABORABLE
9,7,2021,1,244,305,549,2021-07-09 00:00:00,2021-09-07 00:00:00,LABORABLE
9,7,2021,2,151,204,355,2021-07-09 01:00:00,2021-09-07 00:00:00,LABORABLE
9,7,2021,3,104,149,253,2021-07-09 02:00:00,2021-09-07 00:00:00,LABORABLE
9,7,2021,4,93,106,199,2021-07-09 03:00:00,2021-09-07 00:00:00,LABORABLE
9,7,2021,5,87,98,185,2021-07-09 04:00:00,2021-09-07 00:00:00,LABORABLE
9,7,2021,6,169,140,309,2021-07-09 05:00:00,2021-09-07 00:00:00,LABORABLE
9,7,2021,7,450,329,779,2021-07-09 06:00:00,2021-09-07 00:00:00,LABORABLE
9,7,2021,8,645,545,1190,2021-07-09 07:00:00,2021-09-07 00:00:00,LABORABLE
9,7,2021,9,569,606,1175,2021-07-09 08:00:00,2021-09-07 00:00:00,LABORABLE
9,7,2021,10,571,668,1239,2021-07-09 09:00:00,2021-09-07 00:00:00,LABORABLE
9,7,2021,11,569,617,1186,2021-07-09 10:00:00,2021-09-07 00:00:00,LABORABLE
9,7,2021,12,589,711,1300,2021-07-09 11:00:00,2021-09-07 00:00:00,LABORABLE
9,7,2021,13,603,757,1360,2021-07-09 12:00:00,2021-09-07 00:00:00,LABORABLE
9,7,2021,14,637,753,1390,2021-07-09 13:00:00,2021-09-07 00:00:00,LABORABLE
9,7,2021,15,638,729,1367,2021-07-09 14:00:00,2021-09-07 00:00:00,LABORABLE
9,7,2021,16,600,669,1269,2021-07-09 15:00:00,2021-09-07 00:00:00,LABORABLE
9,7,2021,17,567,729,1296,2021-07-09 16:00:00,2021-09-07 00:00:00,LABORABLE
9,7,2021,18,684,779,1463,2021-07-09 17:00:00,2021-09-07 00:00:00,LABORABLE
9,7,2021,19,643,784,1427,2021-07-09 18:00:00,2021-09-07 00:00:00,LABORABLE
9,7,2021,20,659,785,1444,2021-07-09 19:00:00,2021-09-07 00:00:00,LABORABLE
9,7,2021,21,650,751,1401,2021-07-09 20:00:00,2021-09-07 00:00:00,LABORABLE
9,7,2021,22,572,770,1342,2021-07-09 21:00:00,2021-09-07 00:00:00,LABORABLE
9,7,2021,23,466,589,1055,2021-07-09 22:00:00,2021-09-07 00:00:00,LABORABLE
9,7,2021,24,370,440,810,2021-07-09 23:00:00,2021-09-07 00:00:00,LABORABLE
10,7,2021,1,330,405,735,2021-07-10 00:00:00,2021-10-07 00:00:00,LABORABLE
10,7,2021,2,212,403,615,2021-07-10 01:00:00,2021-10-07 00:00:00,LABORABLE
10,7,2021,3,198,224,422,2021-07-10 02:00:00,2021-10-07 00:00:00,LABORABLE
10,7,2021,4,166,223,389,2021-07-10 03:00:00,2021-10-07 00:00:00,LABORABLE
10,7,2021,5,132,157,289,2021-07-10 04:00:00,2021-10-07 00:00:00,LABORABLE
10,7,2021,6,145,151,296,2021-07-10 05:00:00,2021-10-07 00:00:00,LABORABLE
10,7,2021,7,198,199,397,2021-07-10 06:00:00,2021-10-07 00:00:00,LABORABLE
10,7,2021,8,294,303,597,2021-07-10 07:00:00,2021-10-07 00:00:00,LABORABLE
10,7,2021,9,392,392,784,2021-07-10 08:00:00,2021-10-07 00:00:00,LABORABLE
10,7,2021,10,463,474,937,2021-07-10 09:00:00,2021-10-07 00:00:00,LABORABLE
10,7,2021,11,578,573,1151,2021-07-10 10:00:00,2021-10-07 00:00:00,LABORABLE
10,7,2021,12,628,639,1267,2021-07-10 11:00:00,2021-10-07 00:00:00,LABORABLE
10,7,2021,13,575,685,1260,2021-07-10 12:00:00,2021-10-07 00:00:00,LABORABLE
10,7,2021,14,592,758,1350,2021-07-10 13:00:00,2021-10-07 00:00:00,LABORABLE
10,7,2021,15,538,691,1229,2021-07-10 14:00:00,2021-10-07 00:00:00,LABORABLE
10,7,2021,16,485,591,1076,2021-07-10 15:00:00,2021-10-07 00:00:00,LABORABLE
10,7,2021,17,430,615,1045,2021-07-10 16:00:00,2021-10-07 00:00:00,LABORABLE
10,7,2021,18,457,620,1077,2021-07-10 17:00:00,2021-10-07 00:00:00,LABORABLE
10,7,2021,19,566,644,1210,2021-07-10 18:00:00,2021-10-07 00:00:00,LABORABLE
10,7,2021,20,532,675,1207,2021-07-10 19:00:00,2021-10-07 00:00:00,LABORABLE
10,7,2021,21,529,684,1213,2021-07-10 20:00:00,2021-10-07 00:00:00,LABORABLE
10,7,2021,22,455,692,1147,2021-07-10 21:00:00,2021-10-07 00:00:00,LABORABLE
10,7,2021,23,457,599,1056,2021-07-10 22:00:00,2021-10-07 00:00:00,LABORABLE
10,7,2021,24,388,506,894,2021-07-10 23:00:00,2021-10-07 00:00:00,LABORABLE
11,7,2021,1,325,450,775,2021-07-11 00:00:00,2021-11-07 00:00:00,LABORABLE
11,7,2021,2,321,403,724,2021-07-11 01:00:00,2021-11-07 00:00:00,LABORABLE
11,7,2021,3,209,339,548,2021-07-11 02:00:00,2021-11-07 00:00:00,LABORABLE
11,7,2021,4,187,293,480,2021-07-11 03:00:00,2021-11-07 00:00:00,LABORABLE
11,7,2021,5,131,213,344,2021-07-11 04:00:00,2021-11-07 00:00:00,LABORABLE
11,7,2021,6,85,161,246,2021-07-11 05:00:00,2021-11-07 00:00:00,LABORABLE
11,7,2021,7,108,163,271,2021-07-11 06:00:00,2021-11-07 00:00:00,LABORABLE
11,7,2021,8,163,202,365,2021-07-11 07:00:00,2021-11-07 00:00:00,LABORABLE
11,7,2021,9,227,268,495,2021-07-11 08:00:00,2021-11-07 00:00:00,LABORABLE
11,7,2021,10,364,383,747,2021-07-11 09:00:00,2021-11-07 00:00:00,LABORABLE
11,7,2021,11,432,528,960,2021-07-11 10:00:00,2021-11-07 00:00:00,LABORABLE
11,7,2021,12,459,563,1022,2021-07-11 11:00:00,2021-11-07 00:00:00,LABORABLE
11,7,2021,13,546,629,1175,2021-07-11 12:00:00,2021-11-07 00:00:00,LABORABLE
11,7,2021,14,498,647,1145,2021-07-11 13:00:00,2021-11-07 00:00:00,LABORABLE
11,7,2021,15,496,582,1078,2021-07-11 14:00:00,2021-11-07 00:00:00,LABORABLE
11,7,2021,16,388,517,905,2021-07-11 15:00:00,2021-11-07 00:00:00,LABORABLE
11,7,2021,17,369,512,881,2021-07-11 16:00:00,2021-11-07 00:00:00,LABORABLE
11,7,2021,18,386,590,976,2021-07-11 17:00:00,2021-11-07 00:00:00,LABORABLE
11,7,2021,19,478,543,1021,2021-07-11 18:00:00,2021-11-07 00:00:00,LABORABLE
11,7,2021,20,467,626,1093,2021-07-11 19:00:00,2021-11-07 00:00:00,LABORABLE
11,7,2021,21,449,589,1038,2021-07-11 20:00:00,2021-11-07 00:00:00,LABORABLE
11,7,2021,22,429,562,991,2021-07-11 21:00:00,2021-11-07 00:00:00,LABORABLE
11,7,2021,23,392,482,874,2021-07-11 22:00:00,2021-11-07 00:00:00,LABORABLE
11,7,2021,24,284,397,681,2021-07-11 23:00:00,2021-11-07 00:00:00,LABORABLE
12,7,2021,1,230,343,573,2021-07-12 00:00:00,2021-12-07 00:00:00,LABORABLE
12,7,2021,2,137,198,335,2021-07-12 01:00:00,2021-12-07 00:00:00,LABORABLE
12,7,2021,3,109,149,258,2021-07-12 02:00:00,2021-12-07 00:00:00,LABORABLE
12,7,2021,4,115,169,284,2021-07-12 03:00:00,2021-12-07 00:00:00,LABORABLE
12,7,2021,5,80,113,193,2021-07-12 04:00:00,2021-12-07 00:00:00,LABORABLE
12,7,2021,6,171,139,310,2021-07-12 05:00:00,2021-12-07 00:00:00,LABORABLE
12,7,2021,7,378,346,724,2021-07-12 06:00:00,2021-12-07 00:00:00,LABORABLE
12,7,2021,8,617,525,1142,2021-07-12 07:00:00,2021-12-07 00:00:00,LABORABLE
12,7,2021,9,609,617,1226,2021-07-12 08:00:00,2021-12-07 00:00:00,LABORABLE
12,7,2021,10,578,630,1208,2021-07-12 09:00:00,2021-12-07 00:00:00,LABORABLE
12,7,2021,11,542,669,1211,2021-07-12 10:00:00,2021-12-07 00:00:00,LABORABLE
12,7,2021,12,585,686,1271,2021-07-12 11:00:00,2021-12-07 00:00:00,LABORABLE
12,7,2021,13,581,757,1338,2021-07-12 12:00:00,2021-12-07 00:00:00,LABORABLE
12,7,2021,14,566,725,1291,2021-07-12 13:00:00,2021-12-07 00:00:00,LABORABLE
12,7,2021,15,651,652,1303,2021-07-12 14:00:00,2021-12-07 00:00:00,LABORABLE
12,7,2021,16,551,630,1181,2021-07-12 15:00:00,2021-12-07 00:00:00,LABORABLE
12,7,2021,17,525,677,1202,2021-07-12 16:00:00,2021-12-07 00:00:00,LABORABLE
12,7,2021,18,627,716,1343,2021-07-12 17:00:00,2021-12-07 00:00:00,LABORABLE
12,7,2021,19,631,753,1384,2021-07-12 18:00:00,2021-12-07 00:00:00,LABORABLE
12,7,2021,20,601,761,1362,2021-07-12 19:00:00,2021-12-07 00:00:00,LABORABLE
12,7,2021,21,613,670,1283,2021-07-12 20:00:00,2021-12-07 00:00:00,LABORABLE
12,7,2021,22,464,579,1043,2021-07-12 21:00:00,2021-12-07 00:00:00,LABORABLE
12,7,2021,23,385,493,878,2021-07-12 22:00:00,2021-12-07 00:00:00,LABORABLE
12,7,2021,24,246,351,597,2021-07-12 23:00:00,2021-12-07 00:00:00,LABORABLE
13,7,2021,1,182,250,432,2021-07-13 00:00:00,2021-07-13 00:00:00,LABORABLE
13,7,2021,2,90,167,257,2021-07-13 01:00:00,2021-07-13 00:00:00,LABORABLE
13,7,2021,3,71,109,180,2021-07-13 02:00:00,2021-07-13 00:00:00,LABORABLE
13,7,2021,4,62,104,166,2021-07-13 03:00:00,2021-07-13 00:00:00,LABORABLE
13,7,2021,5,78,81,159,2021-07-13 04:00:00,2021-07-13 00:00:00,LABORABLE
13,7,2021,6,149,136,285,2021-07-13 05:00:00,2021-07-13 00:00:00,LABORABLE
13,7,2021,7,420,336,756,2021-07-13 06:00:00,2021-07-13 00:00:00,LABORABLE
13,7,2021,8,607,559,1166,2021-07-13 07:00:00,2021-07-13 00:00:00,LABORABLE
13,7,2021,9,547,586,1133,2021-07-13 08:00:00,2021-07-13 00:00:00,LABORABLE
13,7,2021,10,572,650,1222,2021-07-13 09:00:00,2021-07-13 00:00:00,LABORABLE
13,7,2021,11,590,635,1225,2021-07-13 10:00:00,2021-07-13 00:00:00,LABORABLE
13,7,2021,12,545,652,1197,2021-07-13 11:00:00,2021-07-13 00:00:00,LABORABLE
13,7,2021,13,567,644,1211,2021-07-13 12:00:00,2021-07-13 00:00:00,LABORABLE
13,7,2021,14,585,712,1297,2021-07-13 13:00:00,2021-07-13 00:00:00,LABORABLE
13,7,2021,15,597,616,1213,2021-07-13 14:00:00,2021-07-13 00:00:00,LABORABLE
13,7,2021,16,530,662,1192,2021-07-13 15:00:00,2021-07-13 00:00:00,LABORABLE
13,7,2021,17,581,686,1267,2021-07-13 16:00:00,2021-07-13 00:00:00,LABORABLE
13,7,2021,18,594,754,1348,2021-07-13 17:00:00,2021-07-13 00:00:00,LABORABLE
13,7,2021,19,676,755,1431,2021-07-13 18:00:00,2021-07-13 00:00:00,LABORABLE
13,7,2021,20,624,779,1403,2021-07-13 19:00:00,2021-07-13 00:00:00,LABORABLE
13,7,2021,21,574,729,1303,2021-07-13 20:00:00,2021-07-13 00:00:00,LABORABLE
13,7,2021,22,522,621,1143,2021-07-13 21:00:00,2021-07-13 00:00:00,LABORABLE
13,7,2021,23,413,486,899,2021-07-13 22:00:00,2021-07-13 00:00:00,LABORABLE
13,7,2021,24,252,346,598,2021-07-13 23:00:00,2021-07-13 00:00:00,LABORABLE
14,7,2021,1,203,247,450,2021-07-14 00:00:00,2021-07-14 00:00:00,LABORABLE
14,7,2021,2,132,150,282,2021-07-14 01:00:00,2021-07-14 00:00:00,LABORABLE
14,7,2021,3,56,119,175,2021-07-14 02:00:00,2021-07-14 00:00:00,LABORABLE
14,7,2021,4,65,82,147,2021-07-14 03:00:00,2021-07-14 00:00:00,LABORABLE
14,7,2021,5,69,84,153,2021-07-14 04:00:00,2021-07-14 00:00:00,LABORABLE
14,7,2021,6,171,140,311,2021-07-14 05:00:00,2021-07-14 00:00:00,LABORABLE
14,7,2021,7,433,319,752,2021-07-14 06:00:00,2021-07-14 00:00:00,LABORABLE
14,7,2021,8,599,579,1178,2021-07-14 07:00:00,2021-07-14 00:00:00,LABORABLE
14,7,2021,9,541,572,1113,2021-07-14 08:00:00,2021-07-14 00:00:00,LABORABLE
14,7,2021,10,560,683,1243,2021-07-14 09:00:00,2021-07-14 00:00:00,LABORABLE
14,7,2021,11,555,598,1153,2021-07-14 10:00:00,2021-07-14 00:00:00,LABORABLE
14,7,2021,12,564,693,1257,2021-07-14 11:00:00,2021-07-14 00:00:00,LABORABLE
14,7,2021,13,557,703,1260,2021-07-14 12:00:00,2021-07-14 00:00:00,LABORABLE
14,7,2021,14,597,699,1296,2021-07-14 13:00:00,2021-07-14 00:00:00,LABORABLE
14,7,2021,15,617,639,1256,2021-07-14 14:00:00,2021-07-14 00:00:00,LABORABLE
14,7,2021,16,576,647,1223,2021-07-14 15:00:00,2021-07-14 00:00:00,LABORABLE
14,7,2021,17,594,687,1281,2021-07-14 16:00:00,2021-07-14 00:00:00,LABORABLE
14,7,2021,18,593,719,1312,2021-07-14 17:00:00,2021-07-14 00:00:00,LABORABLE
14,7,2021,19,715,738,1453,2021-07-14 18:00:00,2021-07-14 00:00:00,LABORABLE
14,7,2021,20,620,757,1377,2021-07-14 19:00:00,2021-07-14 00:00:00,LABORABLE
14,7,2021,21,611,736,1347,2021-07-14 20:00:00,2021-07-14 00:00:00,LABORABLE
14,7,2021,22,453,589,1042,2021-07-14 21:00:00,2021-07-14 00:00:00,LABORABLE
14,7,2021,23,433,454,887,2021-07-14 22:00:00,2021-07-14 00:00:00,LABORABLE
14,7,2021,24,267,343,610,2021-07-14 23:00:00,2021-07-14 00:00:00,LABORABLE
15,7,2021,1,193,236,429,2021-07-15 00:00:00,2021-07-15 00:00:00,LABORABLE
15,7,2021,2,126,175,301,2021-07-15 01:00:00,2021-07-15 00:00:00,LABORABLE
15,7,2021,3,88,111,199,2021-07-15 02:00:00,2021-07-15 00:00:00,LABORABLE
15,7,2021,4,70,115,185,2021-07-15 03:00:00,2021-07-15 00:00:00,LABORABLE
15,7,2021,5,79,86,165,2021-07-15 04:00:00,2021-07-15 00:00:00,LABORABLE
15,7,2021,6,166,134,300,2021-07-15 05:00:00,2021-07-15 00:00:00,LABORABLE
15,7,2021,7,419,312,731,2021-07-15 06:00:00,2021-07-15 00:00:00,LABORABLE
15,7,2021,8,612,603,1215,2021-07-15 07:00:00,2021-07-15 00:00:00,LABORABLE
15,7,2021,9,594,626,1220,2021-07-15 08:00:00,2021-07-15 00:00:00,LABORABLE
15,7,2021,10,604,620,1224,2021-07-15 09:00:00,2021-07-15 00:00:00,LABORABLE
15,7,2021,11,510,683,1193,2021-07-15 10:00:00,2021-07-15 00:00:00,LABORABLE
15,7,2021,12,549,687,1236,2021-07-15 11:00:00,2021-07-15 00:00:00,LABORABLE
15,7,2021,13,557,673,1230,2021-07-15 12:00:00,2021-07-15 00:00:00,LABORABLE
15,7,2021,14,619,778,1397,2021-07-15 13:00:00,2021-07-15 00:00:00,LABORABLE
15,7,2021,15,588,676,1264,2021-07-15 14:00:00,2021-07-15 00:00:00,LABORABLE
15,7,2021,16,582,652,1234,2021-07-15 15:00:00,2021-07-15 00:00:00,LABORABLE
15,7,2021,17,594,642,1236,2021-07-15 16:00:00,2021-07-15 00:00:00,LABORABLE
15,7,2021,18,613,804,1417,2021-07-15 17:00:00,2021-07-15 00:00:00,LABORABLE
15,7,2021,19,640,704,1344,2021-07-15 18:00:00,2021-07-15 00:00:00,LABORABLE
15,7,2021,20,670,805,1475,2021-07-15 19:00:00,2021-07-15 00:00:00,LABORABLE
15,7,2021,21,615,783,1398,2021-07-15 20:00:00,2021-07-15 00:00:00,LABORABLE
15,7,2021,22,533,642,1175,2021-07-15 21:00:00,2021-07-15 00:00:00,LABORABLE
15,7,2021,23,411,519,930,2021-07-15 22:00:00,2021-07-15 00:00:00,LABORABLE
15,7,2021,24,306,415,721,2021-07-15 23:00:00,2021-07-15 00:00:00,LABORABLE
16,7,2021,1,213,317,530,2021-07-16 00:00:00,2021-07-16 00:00:00,LABORABLE
16,7,2021,2,162,246,408,2021-07-16 01:00:00,2021-07-16 00:00:00,LABORABLE
16,7,2021,3,95,172,267,2021-07-16 02:00:00,2021-07-16 00:00:00,LABORABLE
16,7,2021,4,85,112,197,2021-07-16 03:00:00,2021-07-16 00:00:00,LABORABLE
16,7,2021,5,92,101,193,2021-07-16 04:00:00,2021-07-16 00:00:00,LABORABLE
16,7,2021,6,178,158,336,2021-07-16 05:00:00,2021-07-16 00:00:00,LABORABLE
16,7,2021,7,398,312,710,2021-07-16 06:00:00,2021-07-16 00:00:00,LABORABLE
16,7,2021,8,625,553,1178,2021-07-16 07:00:00,2021-07-16 00:00:00,LABORABLE
16,7,2021,9,571,610,1181,2021-07-16 08:00:00,2021-07-16 00:00:00,LABORABLE
16,7,2021,10,550,666,1216,2021-07-16 09:00:00,2021-07-16 00:00:00,LABORABLE
16,7,2021,11,567,689,1256,2021-07-16 10:00:00,2021-07-16 00:00:00,LABORABLE
16,7,2021,12,603,748,1351,2021-07-16 11:00:00,2021-07-16 00:00:00,LABORABLE
16,7,2021,13,575,769,1344,2021-07-16 12:00:00,2021-07-16 00:00:00,LABORABLE
16,7,2021,14,615,748,1363,2021-07-16 13:00:00,2021-07-16 00:00:00,LABORABLE
16,7,2021,15,600,732,1332,2021-07-16 14:00:00,2021-07-16 00:00:00,LABORABLE
16,7,2021,16,635,709,1344,2021-07-16 15:00:00,2021-07-16 00:00:00,LABORABLE
16,7,2021,17,579,753,1332,2021-07-16 16:00:00,2021-07-16 00:00:00,LABORABLE
16,7,2021,18,655,727,1382,2021-07-16 17:00:00,2021-07-16 00:00:00,LABORABLE
16,7,2021,19,633,824,1457,2021-07-16 18:00:00,2021-07-16 00:00:00,LABORABLE
16,7,2021,20,639,761,1400,2021-07-16 19:00:00,2021-07-16 00:00:00,LABORABLE
16,7,2021,21,632,811,1443,2021-07-16 20:00:00,2021-07-16 00:00:00,LABORABLE
16,7,2021,22,553,708,1261,2021-07-16 21:00:00,2021-07-16 00:00:00,LABORABLE
16,7,2021,23,492,639,1131,2021-07-16 22:00:00,2021-07-16 00:00:00,LABORABLE
16,7,2021,24,414,493,907,2021-07-16 23:00:00,2021-07-16 00:00:00,LABORABLE
17,7,2021,1,316,428,744,2021-07-17 00:00:00,2021-07-17 00:00:00,LABORABLE
17,7,2021,2,248,349,597,2021-07-17 01:00:00,2021-07-17 00:00:00,LABORABLE
17,7,2021,3,182,265,447,2021-07-17 02:00:00,2021-07-17 00:00:00,LABORABLE
17,7,2021,4,177,230,407,2021-07-17 03:00:00,2021-07-17 00:00:00,LABORABLE
17,7,2021,5,116,177,293,2021-07-17 04:00:00,2021-07-17 00:00:00,LABORABLE
17,7,2021,6,135,132,267,2021-07-17 05:00:00,2021-07-17 00:00:00,LABORABLE
17,7,2021,7,179,165,344,2021-07-17 06:00:00,2021-07-17 00:00:00,LABORABLE
17,7,2021,8,265,297,562,2021-07-17 07:00:00,2021-07-17 00:00:00,LABORABLE
17,7,2021,9,368,368,736,2021-07-17 08:00:00,2021-07-17 00:00:00,LABORABLE
17,7,2021,10,467,466,933,2021-07-17 09:00:00,2021-07-17 00:00:00,LABORABLE
17,7,2021,11,490,598,1088,2021-07-17 10:00:00,2021-07-17 00:00:00,LABORABLE
17,7,2021,12,526,655,1181,2021-07-17 11:00:00,2021-07-17 00:00:00,LABORABLE
17,7,2021,13,606,688,1294,2021-07-17 12:00:00,2021-07-17 00:00:00,LABORABLE
17,7,2021,14,547,753,1300,2021-07-17 13:00:00,2021-07-17 00:00:00,LABORABLE
17,7,2021,15,564,700,1264,2021-07-17 14:00:00,2021-07-17 00:00:00,LABORABLE
17,7,2021,16,443,567,1010,2021-07-17 15:00:00,2021-07-17 00:00:00,LABORABLE
17,7,2021,17,452,651,1103,2021-07-17 16:00:00,2021-07-17 00:00:00,LABORABLE
17,7,2021,18,481,640,1121,2021-07-17 17:00:00,2021-07-17 00:00:00,LABORABLE
17,7,2021,19,536,645,1181,2021-07-17 18:00:00,2021-07-17 00:00:00,LABORABLE
17,7,2021,20,517,685,1202,2021-07-17 19:00:00,2021-07-17 00:00:00,LABORABLE
17,7,2021,21,486,700,1186,2021-07-17 20:00:00,2021-07-17 00:00:00,LABORABLE
17,7,2021,22,461,633,1094,2021-07-17 21:00:00,2021-07-17 00:00:00,LABORABLE
17,7,2021,23,474,562,1036,2021-07-17 22:00:00,2021-07-17 00:00:00,LABORABLE
17,7,2021,24,361,489,850,2021-07-17 23:00:00,2021-07-17 00:00:00,LABORABLE
18,7,2021,1,323,500,823,2021-07-18 00:00:00,2021-07-18 00:00:00,LABORABLE
18,7,2021,2,279,356,635,2021-07-18 01:00:00,2021-07-18 00:00:00,LABORABLE
18,7,2021,3,201,316,517,2021-07-18 02:00:00,2021-07-18 00:00:00,LABORABLE
18,7,2021,4,201,334,535,2021-07-18 03:00:00,2021-07-18 00:00:00,LABORABLE
18,7,2021,5,109,191,300,2021-07-18 04:00:00,2021-07-18 00:00:00,LABORABLE
18,7,2021,6,80,163,243,2021-07-18 05:00:00,2021-07-18 00:00:00,LABORABLE
18,7,2021,7,108,133,241,2021-07-18 06:00:00,2021-07-18 00:00:00,LABORABLE
18,7,2021,8,187,215,402,2021-07-18 07:00:00,2021-07-18 00:00:00,LABORABLE
18,7,2021,9,249,286,535,2021-07-18 08:00:00,2021-07-18 00:00:00,LABORABLE
18,7,2021,10,330,441,771,2021-07-18 09:00:00,2021-07-18 00:00:00,LABORABLE
18,7,2021,11,424,499,923,2021-07-18 10:00:00,2021-07-18 00:00:00,LABORABLE
18,7,2021,12,462,581,1043,2021-07-18 11:00:00,2021-07-18 00:00:00,LABORABLE
18,7,2021,13,487,570,1057,2021-07-18 12:00:00,2021-07-18 00:00:00,LABORABLE
18,7,2021,14,520,685,1205,2021-07-18 13:00:00,2021-07-18 00:00:00,LABORABLE
18,7,2021,15,470,553,1023,2021-07-18 14:00:00,2021-07-18 00:00:00,LABORABLE
18,7,2021,16,408,537,945,2021-07-18 15:00:00,2021-07-18 00:00:00,LABORABLE
18,7,2021,17,364,539,903,2021-07-18 16:00:00,2021-07-18 00:00:00,LABORABLE
18,7,2021,18,379,551,930,2021-07-18 17:00:00,2021-07-18 00:00:00,LABORABLE
18,7,2021,19,447,545,992,2021-07-18 18:00:00,2021-07-18 00:00:00,LABORABLE
18,7,2021,20,424,605,1029,2021-07-18 19:00:00,2021-07-18 00:00:00,LABORABLE
18,7,2021,21,430,570,1000,2021-07-18 20:00:00,2021-07-18 00:00:00,LABORABLE
18,7,2021,22,447,560,1007,2021-07-18 21:00:00,2021-07-18 00:00:00,LABORABLE
18,7,2021,23,438,552,990,2021-07-18 22:00:00,2021-07-18 00:00:00,LABORABLE
18,7,2021,24,347,426,773,2021-07-18 23:00:00,2021-07-18 00:00:00,LABORABLE
19,7,2021,1,249,317,566,2021-07-19 00:00:00,2021-07-19 00:00:00,LABORABLE
19,7,2021,2,137,216,353,2021-07-19 01:00:00,2021-07-19 00:00:00,LABORABLE
19,7,2021,3,103,167,270,2021-07-19 02:00:00,2021-07-19 00:00:00,LABORABLE
19,7,2021,4,109,146,255,2021-07-19 03:00:00,2021-07-19 00:00:00,LABORABLE
19,7,2021,5,81,94,175,2021-07-19 04:00:00,2021-07-19 00:00:00,LABORABLE
19,7,2021,6,164,141,305,2021-07-19 05:00:00,2021-07-19 00:00:00,LABORABLE
19,7,2021,7,412,332,744,2021-07-19 06:00:00,2021-07-19 00:00:00,LABORABLE
19,7,2021,8,620,540,1160,2021-07-19 07:00:00,2021-07-19 00:00:00,LABORABLE
19,7,2021,9,559,590,1149,2021-07-19 08:00:00,2021-07-19 00:00:00,LABORABLE
19,7,2021,10,168,661,829,2021-07-19 09:00:00,2021-07-19 00:00:00,LABORABLE
19,7,2021,11,0,626,626,2021-07-19 10:00:00,2021-07-19 00:00:00,LABORABLE
19,7,2021,12,426,701,1127,2021-07-19 11:00:00,2021-07-19 00:00:00,LABORABLE
19,7,2021,13,539,679,1218,2021-07-19 12:00:00,2021-07-19 00:00:00,LABORABLE
19,7,2021,14,564,747,1311,2021-07-19 13:00:00,2021-07-19 00:00:00,LABORABLE
19,7,2021,15,586,699,1285,2021-07-19 14:00:00,2021-07-19 00:00:00,LABORABLE
19,7,2021,16,627,625,1252,2021-07-19 15:00:00,2021-07-19 00:00:00,LABORABLE
19,7,2021,17,533,611,1144,2021-07-19 16:00:00,2021-07-19 00:00:00,LABORABLE
19,7,2021,18,593,678,1271,2021-07-19 17:00:00,2021-07-19 00:00:00,LABORABLE
19,7,2021,19,595,742,1337,2021-07-19 18:00:00,2021-07-19 00:00:00,LABORABLE
19,7,2021,20,575,762,1337,2021-07-19 19:00:00,2021-07-19 00:00:00,LABORABLE
19,7,2021,21,553,729,1282,2021-07-19 20:00:00,2021-07-19 00:00:00,LABORABLE
19,7,2021,22,434,608,1042,2021-07-19 21:00:00,2021-07-19 00:00:00,LABORABLE
19,7,2021,23,344,462,806,2021-07-19 22:00:00,2021-07-19 00:00:00,LABORABLE
19,7,2021,24,261,314,575,2021-07-19 23:00:00,2021-07-19 00:00:00,LABORABLE
20,7,2021,1,163,229,392,2021-07-20 00:00:00,2021-07-20 00:00:00,LABORABLE
20,7,2021,2,108,155,263,2021-07-20 01:00:00,2021-07-20 00:00:00,LABORABLE
20,7,2021,3,85,110,195,2021-07-20 02:00:00,2021-07-20 00:00:00,LABORABLE
20,7,2021,4,73,90,163,2021-07-20 03:00:00,2021-07-20 00:00:00,LABORABLE
20,7,2021,5,67,99,166,2021-07-20 04:00:00,2021-07-20 00:00:00,LABORABLE
20,7,2021,6,169,131,300,2021-07-20 05:00:00,2021-07-20 00:00:00,LABORABLE
20,7,2021,7,398,337,735,2021-07-20 06:00:00,2021-07-20 00:00:00,LABORABLE
20,7,2021,8,603,544,1147,2021-07-20 07:00:00,2021-07-20 00:00:00,LABORABLE
20,7,2021,9,550,600,1150,2021-07-20 08:00:00,2021-07-20 00:00:00,LABORABLE
20,7,2021,10,547,706,1253,2021-07-20 09:00:00,2021-07-20 00:00:00,LABORABLE
20,7,2021,11,575,598,1173,2021-07-20 10:00:00,2021-07-20 00:00:00,LABORABLE
20,7,2021,12,554,669,1223,2021-07-20 11:00:00,2021-07-20 00:00:00,LABORABLE
20,7,2021,13,549,677,1226,2021-07-20 12:00:00,2021-07-20 00:00:00,LABORABLE
20,7,2021,14,592,686,1278,2021-07-20 13:00:00,2021-07-20 00:00:00,LABORABLE
20,7,2021,15,608,681,1289,2021-07-20 14:00:00,2021-07-20 00:00:00,LABORABLE
20,7,2021,16,548,616,1164,2021-07-20 15:00:00,2021-07-20 00:00:00,LABORABLE
20,7,2021,17,575,654,1229,2021-07-20 16:00:00,2021-07-20 00:00:00,LABORABLE
20,7,2021,18,563,636,1199,2021-07-20 17:00:00,2021-07-20 00:00:00,LABORABLE
20,7,2021,19,588,732,1320,2021-07-20 18:00:00,2021-07-20 00:00:00,LABORABLE
20,7,2021,20,625,745,1370,2021-07-20 19:00:00,2021-07-20 00:00:00,LABORABLE
20,7,2021,21,520,771,1291,2021-07-20 20:00:00,2021-07-20 00:00:00,LABORABLE
20,7,2021,22,458,590,1048,2021-07-20 21:00:00,2021-07-20 00:00:00,LABORABLE
20,7,2021,23,401,464,865,2021-07-20 22:00:00,2021-07-20 00:00:00,LABORABLE
20,7,2021,24,268,332,600,2021-07-20 23:00:00,2021-07-20 00:00:00,LABORABLE
21,7,2021,1,181,243,424,2021-07-21 00:00:00,2021-07-21 00:00:00,LABORABLE
21,7,2021,2,117,139,256,2021-07-21 01:00:00,2021-07-21 00:00:00,LABORABLE
21,7,2021,3,72,106,178,2021-07-21 02:00:00,2021-07-21 00:00:00,LABORABLE
21,7,2021,4,62,96,158,2021-07-21 03:00:00,2021-07-21 00:00:00,LABORABLE
21,7,2021,5,57,94,151,2021-07-21 04:00:00,2021-07-21 00:00:00,LABORABLE
21,7,2021,6,182,147,329,2021-07-21 05:00:00,2021-07-21 00:00:00,LABORABLE
21,7,2021,7,408,357,765,2021-07-21 06:00:00,2021-07-21 00:00:00,LABORABLE
21,7,2021,8,606,552,1158,2021-07-21 07:00:00,2021-07-21 00:00:00,LABORABLE
21,7,2021,9,560,562,1122,2021-07-21 08:00:00,2021-07-21 00:00:00,LABORABLE
21,7,2021,10,568,652,1220,2021-07-21 09:00:00,2021-07-21 00:00:00,LABORABLE
21,7,2021,11,564,649,1213,2021-07-21 10:00:00,2021-07-21 00:00:00,LABORABLE
21,7,2021,12,551,710,1261,2021-07-21 11:00:00,2021-07-21 00:00:00,LABORABLE
21,7,2021,13,558,744,1302,2021-07-21 12:00:00,2021-07-21 00:00:00,LABORABLE
21,7,2021,14,599,718,1317,2021-07-21 13:00:00,2021-07-21 00:00:00,LABORABLE
21,7,2021,15,556,638,1194,2021-07-21 14:00:00,2021-07-21 00:00:00,LABORABLE
21,7,2021,16,543,640,1183,2021-07-21 15:00:00,2021-07-21 00:00:00,LABORABLE
21,7,2021,17,528,701,1229,2021-07-21 16:00:00,2021-07-21 00:00:00,LABORABLE
21,7,2021,18,571,709,1280,2021-07-21 17:00:00,2021-07-21 00:00:00,LABORABLE
21,7,2021,19,612,741,1353,2021-07-21 18:00:00,2021-07-21 00:00:00,LABORABLE
21,7,2021,20,609,754,1363,2021-07-21 19:00:00,2021-07-21 00:00:00,LABORABLE
21,7,2021,21,595,793,1388,2021-07-21 20:00:00,2021-07-21 00:00:00,LABORABLE
21,7,2021,22,513,556,1069,2021-07-21 21:00:00,2021-07-21 00:00:00,LABORABLE
21,7,2021,23,393,438,831,2021-07-21 22:00:00,2021-07-21 00:00:00,LABORABLE
21,7,2021,24,253,356,609,2021-07-21 23:00:00,2021-07-21 00:00:00,LABORABLE
22,7,2021,1,186,269,455,2021-07-22 00:00:00,2021-07-22 00:00:00,LABORABLE
22,7,2021,2,135,188,323,2021-07-22 01:00:00,2021-07-22 00:00:00,LABORABLE
22,7,2021,3,76,122,198,2021-07-22 02:00:00,2021-07-22 00:00:00,LABORABLE
22,7,2021,4,84,100,184,2021-07-22 03:00:00,2021-07-22 00:00:00,LABORABLE
22,7,2021,5,83,88,171,2021-07-22 04:00:00,2021-07-22 00:00:00,LABORABLE
22,7,2021,6,163,156,319,2021-07-22 05:00:00,2021-07-22 00:00:00,LABORABLE
22,7,2021,7,415,354,769,2021-07-22 06:00:00,2021-07-22 00:00:00,LABORABLE
22,7,2021,8,595,502,1097,2021-07-22 07:00:00,2021-07-22 00:00:00,LABORABLE
22,7,2021,9,576,805,1381,2021-07-22 08:00:00,2021-07-22 00:00:00,LABORABLE
22,7,2021,10,519,900,1419,2021-07-22 09:00:00,2021-07-22 00:00:00,LABORABLE
22,7,2021,11,528,405,933,2021-07-22 10:00:00,2021-07-22 00:00:00,LABORABLE
22,7,2021,12,604,435,1039,2021-07-22 11:00:00,2021-07-22 00:00:00,LABORABLE
22,7,2021,13,558,426,984,2021-07-22 12:00:00,2021-07-22 00:00:00,LABORABLE
22,7,2021,14,589,448,1037,2021-07-22 13:00:00,2021-07-22 00:00:00,LABORABLE
22,7,2021,15,570,443,1013,2021-07-22 14:00:00,2021-07-22 00:00:00,LABORABLE
22,7,2021,16,599,386,985,2021-07-22 15:00:00,2021-07-22 00:00:00,LABORABLE
22,7,2021,17,574,464,1038,2021-07-22 16:00:00,2021-07-22 00:00:00,LABORABLE
22,7,2021,18,572,437,1009,2021-07-22 17:00:00,2021-07-22 00:00:00,LABORABLE
22,7,2021,19,620,498,1118,2021-07-22 18:00:00,2021-07-22 00:00:00,LABORABLE
22,7,2021,20,623,495,1118,2021-07-22 19:00:00,2021-07-22 00:00:00,LABORABLE
22,7,2021,21,558,504,1062,2021-07-22 20:00:00,2021-07-22 00:00:00,LABORABLE
22,7,2021,22,508,425,933,2021-07-22 21:00:00,2021-07-22 00:00:00,LABORABLE
22,7,2021,23,423,593,1016,2021-07-22 22:00:00,2021-07-22 00:00:00,LABORABLE
22,7,2021,24,324,538,862,2021-07-22 23:00:00,2021-07-22 00:00:00,LABORABLE
23,7,2021,1,216,1101,1317,2021-07-23 00:00:00,2021-07-23 00:00:00,LABORABLE
23,7,2021,2,151,137,288,2021-07-23 01:00:00,2021-07-23 00:00:00,LABORABLE
23,7,2021,3,103,696,799,2021-07-23 02:00:00,2021-07-23 00:00:00,LABORABLE
23,7,2021,4,77,681,758,2021-07-23 03:00:00,2021-07-23 00:00:00,LABORABLE
23,7,2021,5,96,395,491,2021-07-23 04:00:00,2021-07-23 00:00:00,LABORABLE
23,7,2021,6,174,420,594,2021-07-23 05:00:00,2021-07-23 00:00:00,LABORABLE
23,7,2021,7,383,929,1312,2021-07-23 06:00:00,2021-07-23 00:00:00,LABORABLE
23,7,2021,8,613,1035,1648,2021-07-23 07:00:00,2021-07-23 00:00:00,LABORABLE
23,7,2021,10,599,1007,1606,2021-07-23 09:00:00,2021-07-23 00:00:00,LABORABLE
23,7,2021,11,423,1178,1601,2021-07-23 10:00:00,2021-07-23 00:00:00,LABORABLE
23,7,2021,12,606,1085,1691,2021-07-23 11:00:00,2021-07-23 00:00:00,LABORABLE
23,7,2021,13,591,1289,1880,2021-07-23 12:00:00,2021-07-23 00:00:00,LABORABLE
23,7,2021,14,563,1236,1799,2021-07-23 13:00:00,2021-07-23 00:00:00,LABORABLE
23,7,2021,15,611,1183,1794,2021-07-23 14:00:00,2021-07-23 00:00:00,LABORABLE
23,7,2021,16,600,771,1371,2021-07-23 15:00:00,2021-07-23 00:00:00,LABORABLE
23,7,2021,17,580,727,1307,2021-07-23 16:00:00,2021-07-23 00:00:00,LABORABLE
23,7,2021,18,581,466,1047,2021-07-23 17:00:00,2021-07-23 00:00:00,LABORABLE
23,7,2021,19,574,523,1097,2021-07-23 18:00:00,2021-07-23 00:00:00,LABORABLE
23,7,2021,20,657,505,1162,2021-07-23 19:00:00,2021-07-23 00:00:00,LABORABLE
23,7,2021,21,612,1262,1874,2021-07-23 20:00:00,2021-07-23 00:00:00,LABORABLE
23,7,2021,22,551,788,1339,2021-07-23 21:00:00,2021-07-23 00:00:00,LABORABLE
23,7,2021,23,498,678,1176,2021-07-23 22:00:00,2021-07-23 00:00:00,LABORABLE
23,7,2021,24,349,631,980,2021-07-23 23:00:00,2021-07-23 00:00:00,LABORABLE
24,7,2021,1,321,679,1000,2021-07-24 00:00:00,2021-07-24 00:00:00,LABORABLE
24,7,2021,2,205,457,662,2021-07-24 01:00:00,2021-07-24 00:00:00,LABORABLE
24,7,2021,3,171,850,1021,2021-07-24 02:00:00,2021-07-24 00:00:00,LABORABLE
24,7,2021,4,137,834,971,2021-07-24 03:00:00,2021-07-24 00:00:00,LABORABLE
24,7,2021,5,117,461,578,2021-07-24 04:00:00,2021-07-24 00:00:00,LABORABLE
24,7,2021,6,121,763,884,2021-07-24 05:00:00,2021-07-24 00:00:00,LABORABLE
24,7,2021,7,183,130,313,2021-07-24 06:00:00,2021-07-24 00:00:00,LABORABLE
24,7,2021,8,287,949,1236,2021-07-24 07:00:00,2021-07-24 00:00:00,LABORABLE
24,7,2021,9,380,858,1238,2021-07-24 08:00:00,2021-07-24 00:00:00,LABORABLE
24,7,2021,10,423,1373,1796,2021-07-24 09:00:00,2021-07-24 00:00:00,LABORABLE
24,7,2021,11,495,692,1187,2021-07-24 10:00:00,2021-07-24 00:00:00,LABORABLE
24,7,2021,12,578,772,1350,2021-07-24 11:00:00,2021-07-24 00:00:00,LABORABLE
24,7,2021,13,564,787,1351,2021-07-24 12:00:00,2021-07-24 00:00:00,LABORABLE
24,7,2021,14,563,1034,1597,2021-07-24 13:00:00,2021-07-24 00:00:00,LABORABLE
24,7,2021,15,510,918,1428,2021-07-24 14:00:00,2021-07-24 00:00:00,LABORABLE
24,7,2021,16,441,1407,1848,2021-07-24 15:00:00,2021-07-24 00:00:00,LABORABLE
24,7,2021,17,423,698,1121,2021-07-24 16:00:00,2021-07-24 00:00:00,LABORABLE
24,7,2021,18,454,757,1211,2021-07-24 17:00:00,2021-07-24 00:00:00,LABORABLE
24,7,2021,19,479,800,1279,2021-07-24 18:00:00,2021-07-24 00:00:00,LABORABLE
24,7,2021,20,550,1122,1672,2021-07-24 19:00:00,2021-07-24 00:00:00,LABORABLE
24,7,2021,21,487,769,1256,2021-07-24 20:00:00,2021-07-24 00:00:00,LABORABLE
24,7,2021,22,467,1052,1519,2021-07-24 21:00:00,2021-07-24 00:00:00,LABORABLE
24,7,2021,23,464,1290,1754,2021-07-24 22:00:00,2021-07-24 00:00:00,LABORABLE
24,7,2021,24,347,746,1093,2021-07-24 23:00:00,2021-07-24 00:00:00,LABORABLE
25,7,2021,1,302,609,911,2021-07-25 00:00:00,2021-07-25 00:00:00,LABORABLE
25,7,2021,2,253,953,1206,2021-07-25 01:00:00,2021-07-25 00:00:00,LABORABLE
25,7,2021,3,200,571,771,2021-07-25 02:00:00,2021-07-25 00:00:00,LABORABLE
25,7,2021,4,181,530,711,2021-07-25 03:00:00,2021-07-25 00:00:00,LABORABLE
25,7,2021,5,120,477,597,2021-07-25 04:00:00,2021-07-25 00:00:00,LABORABLE
25,7,2021,6,105,685,790,2021-07-25 05:00:00,2021-07-25 00:00:00,LABORABLE
25,7,2021,7,101,885,986,2021-07-25 06:00:00,2021-07-25 00:00:00,LABORABLE
25,7,2021,8,177,824,1001,2021-07-25 07:00:00,2021-07-25 00:00:00,LABORABLE
25,7,2021,9,231,521,752,2021-07-25 08:00:00,2021-07-25 00:00:00,LABORABLE
25,7,2021,10,287,1059,1346,2021-07-25 09:00:00,2021-07-25 00:00:00,LABORABLE
25,7,2021,11,402,875,1277,2021-07-25 10:00:00,2021-07-25 00:00:00,LABORABLE
25,7,2021,12,462,669,1131,2021-07-25 11:00:00,2021-07-25 00:00:00,LABORABLE
25,7,2021,13,466,567,1033,2021-07-25 12:00:00,2021-07-25 00:00:00,LABORABLE
25,7,2021,14,520,595,1115,2021-07-25 13:00:00,2021-07-25 00:00:00,LABORABLE
25,7,2021,15,470,639,1109,2021-07-25 14:00:00,2021-07-25 00:00:00,LABORABLE
25,7,2021,16,413,576,989,2021-07-25 15:00:00,2021-07-25 00:00:00,LABORABLE
25,7,2021,17,357,553,910,2021-07-25 16:00:00,2021-07-25 00:00:00,LABORABLE
25,7,2021,18,340,630,970,2021-07-25 17:00:00,2021-07-25 00:00:00,LABORABLE
25,7,2021,19,403,592,995,2021-07-25 18:00:00,2021-07-25 00:00:00,LABORABLE
25,7,2021,20,481,585,1066,2021-07-25 19:00:00,2021-07-25 00:00:00,LABORABLE
25,7,2021,21,420,602,1022,2021-07-25 20:00:00,2021-07-25 00:00:00,LABORABLE
25,7,2021,22,443,578,1021,2021-07-25 21:00:00,2021-07-25 00:00:00,LABORABLE
25,7,2021,23,419,486,905,2021-07-25 22:00:00,2021-07-25 00:00:00,LABORABLE
25,7,2021,24,300,408,708,2021-07-25 23:00:00,2021-07-25 00:00:00,LABORABLE
26,7,2021,1,219,312,531,2021-07-26 00:00:00,2021-07-26 00:00:00,LABORABLE
26,7,2021,2,131,204,335,2021-07-26 01:00:00,2021-07-26 00:00:00,LABORABLE
26,7,2021,3,97,149,246,2021-07-26 02:00:00,2021-07-26 00:00:00,LABORABLE
26,7,2021,4,89,156,245,2021-07-26 03:00:00,2021-07-26 00:00:00,LABORABLE
26,7,2021,5,59,89,148,2021-07-26 04:00:00,2021-07-26 00:00:00,LABORABLE
26,7,2021,6,180,134,314,2021-07-26 05:00:00,2021-07-26 00:00:00,LABORABLE
26,7,2021,7,402,314,716,2021-07-26 06:00:00,2021-07-26 00:00:00,LABORABLE
26,7,2021,8,621,485,1106,2021-07-26 07:00:00,2021-07-26 00:00:00,LABORABLE
26,7,2021,9,570,591,1161,2021-07-26 08:00:00,2021-07-26 00:00:00,LABORABLE
26,7,2021,10,565,633,1198,2021-07-26 09:00:00,2021-07-26 00:00:00,LABORABLE
26,7,2021,11,493,643,1136,2021-07-26 10:00:00,2021-07-26 00:00:00,LABORABLE
26,7,2021,12,538,721,1259,2021-07-26 11:00:00,2021-07-26 00:00:00,LABORABLE
26,7,2021,13,577,714,1291,2021-07-26 12:00:00,2021-07-26 00:00:00,LABORABLE
26,7,2021,14,577,751,1328,2021-07-26 13:00:00,2021-07-26 00:00:00,LABORABLE
26,7,2021,15,582,670,1252,2021-07-26 14:00:00,2021-07-26 00:00:00,LABORABLE
26,7,2021,16,560,613,1173,2021-07-26 15:00:00,2021-07-26 00:00:00,LABORABLE
26,7,2021,17,548,667,1215,2021-07-26 16:00:00,2021-07-26 00:00:00,LABORABLE
26,7,2021,18,605,662,1267,2021-07-26 17:00:00,2021-07-26 00:00:00,LABORABLE
26,7,2021,19,627,803,1430,2021-07-26 18:00:00,2021-07-26 00:00:00,LABORABLE
26,7,2021,20,569,788,1357,2021-07-26 19:00:00,2021-07-26 00:00:00,LABORABLE
26,7,2021,21,558,717,1275,2021-07-26 20:00:00,2021-07-26 00:00:00,LABORABLE
26,7,2021,22,437,604,1041,2021-07-26 21:00:00,2021-07-26 00:00:00,LABORABLE
26,7,2021,23,378,449,827,2021-07-26 22:00:00,2021-07-26 00:00:00,LABORABLE
26,7,2021,24,249,340,589,2021-07-26 23:00:00,2021-07-26 00:00:00,LABORABLE
27,7,2021,1,145,216,361,2021-07-27 00:00:00,2021-07-27 00:00:00,LABORABLE
27,7,2021,2,95,160,255,2021-07-27 01:00:00,2021-07-27 00:00:00,LABORABLE
27,7,2021,3,76,115,191,2021-07-27 02:00:00,2021-07-27 00:00:00,LABORABLE
27,7,2021,4,75,102,177,2021-07-27 03:00:00,2021-07-27 00:00:00,LABORABLE
27,7,2021,5,73,83,156,2021-07-27 04:00:00,2021-07-27 00:00:00,LABORABLE
27,7,2021,6,184,132,316,2021-07-27 05:00:00,2021-07-27 00:00:00,LABORABLE
27,7,2021,7,414,313,727,2021-07-27 06:00:00,2021-07-27 00:00:00,LABORABLE
27,7,2021,8,608,489,1097,2021-07-27 07:00:00,2021-07-27 00:00:00,LABORABLE
27,7,2021,9,587,623,1210,2021-07-27 08:00:00,2021-07-27 00:00:00,LABORABLE
27,7,2021,10,145,620,765,2021-07-27 09:00:00,2021-07-27 00:00:00,LABORABLE
27,7,2021,11,0,626,626,2021-07-27 10:00:00,2021-07-27 00:00:00,LABORABLE
27,7,2021,12,0,677,677,2021-07-27 11:00:00,2021-07-27 00:00:00,LABORABLE
27,7,2021,13,0,686,686,2021-07-27 12:00:00,2021-07-27 00:00:00,LABORABLE
27,7,2021,14,0,731,731,2021-07-27 13:00:00,2021-07-27 00:00:00,LABORABLE
27,7,2021,15,0,669,669,2021-07-27 14:00:00,2021-07-27 00:00:00,LABORABLE
27,7,2021,16,0,582,582,2021-07-27 15:00:00,2021-07-27 00:00:00,LABORABLE
27,7,2021,17,0,678,678,2021-07-27 16:00:00,2021-07-27 00:00:00,LABORABLE
27,7,2021,18,0,705,705,2021-07-27 17:00:00,2021-07-27 00:00:00,LABORABLE
27,7,2021,19,0,814,814,2021-07-27 18:00:00,2021-07-27 00:00:00,LABORABLE
27,7,2021,20,0,766,766,2021-07-27 19:00:00,2021-07-27 00:00:00,LABORABLE
27,7,2021,21,0,724,724,2021-07-27 20:00:00,2021-07-27 00:00:00,LABORABLE
27,7,2021,22,0,625,625,2021-07-27 21:00:00,2021-07-27 00:00:00,LABORABLE
27,7,2021,23,0,465,465,2021-07-27 22:00:00,2021-07-27 00:00:00,LABORABLE
27,7,2021,24,0,341,341,2021-07-27 23:00:00,2021-07-27 00:00:00,LABORABLE
28,7,2021,1,0,234,234,2021-07-28 00:00:00,2021-07-28 00:00:00,LABORABLE
28,7,2021,2,0,164,164,2021-07-28 01:00:00,2021-07-28 00:00:00,LABORABLE
28,7,2021,3,0,146,146,2021-07-28 02:00:00,2021-07-28 00:00:00,LABORABLE
28,7,2021,4,0,95,95,2021-07-28 03:00:00,2021-07-28 00:00:00,LABORABLE
28,7,2021,5,0,77,77,2021-07-28 04:00:00,2021-07-28 00:00:00,LABORABLE
28,7,2021,6,0,144,144,2021-07-28 05:00:00,2021-07-28 00:00:00,LABORABLE
28,7,2021,7,0,356,356,2021-07-28 06:00:00,2021-07-28 00:00:00,LABORABLE
28,7,2021,8,484,500,984,2021-07-28 07:00:00,2021-07-28 00:00:00,LABORABLE
28,7,2021,9,553,580,1133,2021-07-28 08:00:00,2021-07-28 00:00:00,LABORABLE
28,7,2021,10,589,651,1240,2021-07-28 09:00:00,2021-07-28 00:00:00,LABORABLE
28,7,2021,11,536,629,1165,2021-07-28 10:00:00,2021-07-28 00:00:00,LABORABLE
28,7,2021,12,567,721,1288,2021-07-28 11:00:00,2021-07-28 00:00:00,LABORABLE
28,7,2021,13,523,756,1279,2021-07-28 12:00:00,2021-07-28 00:00:00,LABORABLE
28,7,2021,14,553,668,1221,2021-07-28 13:00:00,2021-07-28 00:00:00,LABORABLE
28,7,2021,15,612,681,1293,2021-07-28 14:00:00,2021-07-28 00:00:00,LABORABLE
28,7,2021,16,557,615,1172,2021-07-28 15:00:00,2021-07-28 00:00:00,LABORABLE
28,7,2021,17,555,639,1194,2021-07-28 16:00:00,2021-07-28 00:00:00,LABORABLE
28,7,2021,18,592,683,1275,2021-07-28 17:00:00,2021-07-28 00:00:00,LABORABLE
28,7,2021,19,682,699,1381,2021-07-28 18:00:00,2021-07-28 00:00:00,LABORABLE
28,7,2021,20,655,792,1447,2021-07-28 19:00:00,2021-07-28 00:00:00,LABORABLE
28,7,2021,21,592,744,1336,2021-07-28 20:00:00,2021-07-28 00:00:00,LABORABLE
28,7,2021,22,488,590,1078,2021-07-28 21:00:00,2021-07-28 00:00:00,LABORABLE
28,7,2021,23,411,510,921,2021-07-28 22:00:00,2021-07-28 00:00:00,LABORABLE
28,7,2021,24,294,347,641,2021-07-28 23:00:00,2021-07-28 00:00:00,LABORABLE
29,7,2021,1,209,272,481,2021-07-29 00:00:00,2021-07-29 00:00:00,LABORABLE
29,7,2021,2,121,172,293,2021-07-29 01:00:00,2021-07-29 00:00:00,LABORABLE
29,7,2021,3,87,135,222,2021-07-29 02:00:00,2021-07-29 00:00:00,LABORABLE
29,7,2021,4,92,104,196,2021-07-29 03:00:00,2021-07-29 00:00:00,LABORABLE
29,7,2021,5,79,84,163,2021-07-29 04:00:00,2021-07-29 00:00:00,LABORABLE
29,7,2021,6,171,127,298,2021-07-29 05:00:00,2021-07-29 00:00:00,LABORABLE
29,7,2021,7,417,328,745,2021-07-29 06:00:00,2021-07-29 00:00:00,LABORABLE
29,7,2021,8,589,565,1154,2021-07-29 07:00:00,2021-07-29 00:00:00,LABORABLE
29,7,2021,9,571,615,1186,2021-07-29 08:00:00,2021-07-29 00:00:00,LABORABLE
29,7,2021,10,512,623,1135,2021-07-29 09:00:00,2021-07-29 00:00:00,LABORABLE
29,7,2021,11,583,667,1250,2021-07-29 10:00:00,2021-07-29 00:00:00,LABORABLE
29,7,2021,12,578,702,1280,2021-07-29 11:00:00,2021-07-29 00:00:00,LABORABLE
29,7,2021,13,556,715,1271,2021-07-29 12:00:00,2021-07-29 00:00:00,LABORABLE
29,7,2021,14,620,738,1358,2021-07-29 13:00:00,2021-07-29 00:00:00,LABORABLE
29,7,2021,15,530,568,1098,2021-07-29 14:00:00,2021-07-29 00:00:00,LABORABLE
29,7,2021,16,548,661,1209,2021-07-29 15:00:00,2021-07-29 00:00:00,LABORABLE
29,7,2021,17,569,651,1220,2021-07-29 16:00:00,2021-07-29 00:00:00,LABORABLE
29,7,2021,18,590,648,1238,2021-07-29 17:00:00,2021-07-29 00:00:00,LABORABLE
29,7,2021,19,615,729,1344,2021-07-29 18:00:00,2021-07-29 00:00:00,LABORABLE
29,7,2021,20,617,800,1417,2021-07-29 19:00:00,2021-07-29 00:00:00,LABORABLE
29,7,2021,21,650,756,1406,2021-07-29 20:00:00,2021-07-29 00:00:00,LABORABLE
29,7,2021,22,473,626,1099,2021-07-29 21:00:00,2021-07-29 00:00:00,LABORABLE
29,7,2021,23,425,567,992,2021-07-29 22:00:00,2021-07-29 00:00:00,LABORABLE
29,7,2021,24,282,395,677,2021-07-29 23:00:00,2021-07-29 00:00:00,LABORABLE
30,7,2021,1,217,305,522,2021-07-30 00:00:00,2021-07-30 00:00:00,LABORABLE
30,7,2021,2,133,204,337,2021-07-30 01:00:00,2021-07-30 00:00:00,LABORABLE
30,7,2021,3,102,145,247,2021-07-30 02:00:00,2021-07-30 00:00:00,LABORABLE
30,7,2021,4,111,128,239,2021-07-30 03:00:00,2021-07-30 00:00:00,LABORABLE
30,7,2021,5,97,96,193,2021-07-30 04:00:00,2021-07-30 00:00:00,LABORABLE
30,7,2021,6,176,151,327,2021-07-30 05:00:00,2021-07-30 00:00:00,LABORABLE
30,7,2021,7,380,323,703,2021-07-30 06:00:00,2021-07-30 00:00:00,LABORABLE
30,7,2021,8,567,487,1054,2021-07-30 07:00:00,2021-07-30 00:00:00,LABORABLE
30,7,2021,9,564,639,1203,2021-07-30 08:00:00,2021-07-30 00:00:00,LABORABLE
30,7,2021,10,515,672,1187,2021-07-30 09:00:00,2021-07-30 00:00:00,LABORABLE
30,7,2021,11,534,612,1146,2021-07-30 10:00:00,2021-07-30 00:00:00,LABORABLE
30,7,2021,12,617,697,1314,2021-07-30 11:00:00,2021-07-30 00:00:00,LABORABLE
30,7,2021,13,615,797,1412,2021-07-30 12:00:00,2021-07-30 00:00:00,LABORABLE
30,7,2021,14,639,726,1365,2021-07-30 13:00:00,2021-07-30 00:00:00,LABORABLE
30,7,2021,15,620,747,1367,2021-07-30 14:00:00,2021-07-30 00:00:00,LABORABLE
30,7,2021,16,590,698,1288,2021-07-30 15:00:00,2021-07-30 00:00:00,LABORABLE
30,7,2021,17,568,660,1228,2021-07-30 16:00:00,2021-07-30 00:00:00,LABORABLE
30,7,2021,18,604,759,1363,2021-07-30 17:00:00,2021-07-30 00:00:00,LABORABLE
30,7,2021,19,634,767,1401,2021-07-30 18:00:00,2021-07-30 00:00:00,LABORABLE
30,7,2021,20,657,775,1432,2021-07-30 19:00:00,2021-07-30 00:00:00,LABORABLE
30,7,2021,21,667,777,1444,2021-07-30 20:00:00,2021-07-30 00:00:00,LABORABLE
30,7,2021,22,536,713,1249,2021-07-30 21:00:00,2021-07-30 00:00:00,LABORABLE
30,7,2021,23,490,610,1100,2021-07-30 22:00:00,2021-07-30 00:00:00,LABORABLE
30,7,2021,24,342,561,903,2021-07-30 23:00:00,2021-07-30 00:00:00,LABORABLE
31,7,2021,1,303,424,727,2021-07-31 00:00:00,2021-07-31 00:00:00,LABORABLE
31,7,2021,2,249,370,619,2021-07-31 01:00:00,2021-07-31 00:00:00,LABORABLE
31,7,2021,3,183,262,445,2021-07-31 02:00:00,2021-07-31 00:00:00,LABORABLE
31,7,2021,4,156,254,410,2021-07-31 03:00:00,2021-07-31 00:00:00,LABORABLE
31,7,2021,5,102,166,268,2021-07-31 04:00:00,2021-07-31 00:00:00,LABORABLE
31,7,2021,6,131,146,277,2021-07-31 05:00:00,2021-07-31 00:00:00,LABORABLE
31,7,2021,7,197,204,401,2021-07-31 06:00:00,2021-07-31 00:00:00,LABORABLE
31,7,2021,8,286,322,608,2021-07-31 07:00:00,2021-07-31 00:00:00,LABORABLE
31,7,2021,9,363,404,767,2021-07-31 08:00:00,2021-07-31 00:00:00,LABORABLE
31,7,2021,10,436,498,934,2021-07-31 09:00:00,2021-07-31 00:00:00,LABORABLE
31,7,2021,11,479,545,1024,2021-07-31 10:00:00,2021-07-31 00:00:00,LABORABLE
31,7,2021,12,560,656,1216,2021-07-31 11:00:00,2021-07-31 00:00:00,LABORABLE
31,7,2021,13,607,763,1370,2021-07-31 12:00:00,2021-07-31 00:00:00,LABORABLE
31,7,2021,14,631,747,1378,2021-07-31 13:00:00,2021-07-31 00:00:00,LABORABLE
31,7,2021,15,566,803,1369,2021-07-31 14:00:00,2021-07-31 00:00:00,LABORABLE
31,7,2021,16,482,619,1101,2021-07-31 15:00:00,2021-07-31 00:00:00,LABORABLE
31,7,2021,17,429,650,1079,2021-07-31 16:00:00,2021-07-31 00:00:00,LABORABLE
31,7,2021,18,501,666,1167,2021-07-31 17:00:00,2021-07-31 00:00:00,LABORABLE
31,7,2021,19,511,691,1202,2021-07-31 18:00:00,2021-07-31 00:00:00,LABORABLE
31,7,2021,20,531,698,1229,2021-07-31 19:00:00,2021-07-31 00:00:00,LABORABLE
31,7,2021,21,531,680,1211,2021-07-31 20:00:00,2021-07-31 00:00:00,LABORABLE
31,7,2021,22,484,654,1138,2021-07-31 21:00:00,2021-07-31 00:00:00,LABORABLE
31,7,2021,23,484,580,1064,2021-07-31 22:00:00,2021-07-31 00:00:00,LABORABLE
31,7,2021,24,345,494,839,2021-07-31 23:00:00,2021-07-31 00:00:00,LABORABLE
